"Stunden","FR.stadteinwärts","FR.stadtauswärts","Temperatur...C.","Windstärke..km.h.","Wetter","noOfBikes","location"
"1/1/2016 0:00",30,59,3,9,"Klarer Himmel",89,"wolbecker"
"1/1/2016 1:00",73,91,3,7,"Klarer Himmel",164,"wolbecker"
"1/1/2016 2:00",101,87,3,9,"Klarer Himmel",188,"wolbecker"
"1/1/2016 3:00",103,83,3,9,"teilweise bewölkt",186,"wolbecker"
"1/1/2016 4:00",82,59,2,6,"wolkig",141,"wolbecker"
"1/1/2016 5:00",37,29,3,6,"Regen",66,"wolbecker"
"1/1/2016 6:00",32,22,3,7,NA,54,"wolbecker"
"1/1/2016 7:00",25,22,2,4,NA,47,"wolbecker"
"1/1/2016 8:00",17,10,0,2,"Nebel",27,"wolbecker"
"1/1/2016 9:00",18,12,1,4,"wolkig",30,"wolbecker"
"1/1/2016 10:00",26,37,4,6,"Nebel",63,"wolbecker"
"1/1/2016 11:00",28,30,5,6,"wolkig",58,"wolbecker"
"1/1/2016 12:00",62,83,6,4,"wolkig",145,"wolbecker"
"1/1/2016 13:00",97,56,7,4,"wolkig",153,"wolbecker"
"1/1/2016 14:00",106,52,7,4,"wolkig",158,"wolbecker"
"1/1/2016 15:00",98,76,6,4,"Nebel",174,"wolbecker"
"1/1/2016 16:00",74,82,6,6,"Nebel",156,"wolbecker"
"1/1/2016 17:00",69,72,5,4,"Nebel",141,"wolbecker"
"1/1/2016 18:00",58,60,4,4,"Nebel",118,"wolbecker"
"1/1/2016 19:00",52,52,5,7,NA,104,"wolbecker"
"1/1/2016 20:00",37,28,4,9,"wolkig",65,"wolbecker"
"1/1/2016 21:00",25,22,4,9,"wolkig",47,"wolbecker"
"1/1/2016 22:00",38,32,4,9,"Klarer Himmel",70,"wolbecker"
"1/1/2016 23:00",12,15,4,7,"Klarer Himmel",27,"wolbecker"
"1/2/2016 0:00",14,13,4,9,"teilweise bewölkt",27,"wolbecker"
"1/2/2016 1:00",15,8,5,9,"wolkig",23,"wolbecker"
"1/2/2016 2:00",6,4,4,11,"Klarer Himmel",10,"wolbecker"
"1/2/2016 3:00",4,1,4,13,"Klarer Himmel",5,"wolbecker"
"1/2/2016 4:00",1,0,4,13,"Klarer Himmel",1,"wolbecker"
"1/2/2016 5:00",13,9,4,17,"Klarer Himmel",22,"wolbecker"
"1/2/2016 6:00",21,13,4,17,"Klarer Himmel",34,"wolbecker"
"1/2/2016 7:00",31,26,4,13,"Klarer Himmel",57,"wolbecker"
"1/2/2016 8:00",49,31,4,15,"Klarer Himmel",80,"wolbecker"
"1/2/2016 9:00",179,65,4,15,"wolkig",244,"wolbecker"
"1/2/2016 10:00",200,108,4,15,"Regen",308,"wolbecker"
"1/2/2016 11:00",202,132,3,15,"wolkig",334,"wolbecker"
"1/2/2016 12:00",198,174,3,15,"Regen",372,"wolbecker"
"1/2/2016 13:00",205,190,3,15,"Regen",395,"wolbecker"
"1/2/2016 14:00",184,217,3,13,"wolkig",401,"wolbecker"
"1/2/2016 15:00",142,207,3,13,"Regen",349,"wolbecker"
"1/2/2016 16:00",125,157,3,15,"Regen",282,"wolbecker"
"1/2/2016 17:00",108,165,3,13,"Regen",273,"wolbecker"
"1/2/2016 18:00",92,119,2,17,"Regen",211,"wolbecker"
"1/2/2016 19:00",83,116,2,13,"Regen",199,"wolbecker"
"1/2/2016 20:00",77,93,2,13,"wolkig",170,"wolbecker"
"1/2/2016 21:00",45,57,2,15,"wolkig",102,"wolbecker"
"1/2/2016 22:00",51,41,2,13,"wolkig",92,"wolbecker"
"1/2/2016 23:00",39,52,2,13,"wolkig",91,"wolbecker"
"1/3/2016 0:00",37,39,2,13,"wolkig",76,"wolbecker"
"1/3/2016 1:00",36,22,2,11,"teilweise bewölkt",58,"wolbecker"
"1/3/2016 2:00",24,12,2,15,"wolkig",36,"wolbecker"
"1/3/2016 3:00",17,13,2,11,"Regen",30,"wolbecker"
"1/3/2016 4:00",15,10,3,15,"wolkig",25,"wolbecker"
"1/3/2016 5:00",8,3,3,15,"wolkig",11,"wolbecker"
"1/3/2016 6:00",7,9,2,17,"Regen",16,"wolbecker"
"1/3/2016 7:00",16,11,2,13,"Regen",27,"wolbecker"
"1/3/2016 8:00",12,14,2,17,"Regen",26,"wolbecker"
"1/3/2016 9:00",31,25,2,15,"Regen",56,"wolbecker"
"1/3/2016 10:00",41,50,2,15,"Regen",91,"wolbecker"
"1/3/2016 11:00",52,44,3,11,"Regen",96,"wolbecker"
"1/3/2016 12:00",52,66,3,13,"Regen",118,"wolbecker"
"1/3/2016 13:00",57,59,3,11,"Regen",116,"wolbecker"
"1/3/2016 14:00",72,71,3,9,"Regen",143,"wolbecker"
"1/3/2016 15:00",101,66,3,13,"wolkig",167,"wolbecker"
"1/3/2016 16:00",114,92,3,11,"wolkig",206,"wolbecker"
"1/3/2016 17:00",107,100,3,13,"teilweise bewölkt",207,"wolbecker"
"1/3/2016 18:00",71,78,3,11,"teilweise bewölkt",149,"wolbecker"
"1/3/2016 19:00",101,71,2,11,"wolkig",172,"wolbecker"
"1/3/2016 20:00",66,57,2,15,"wolkig",123,"wolbecker"
"1/3/2016 21:00",55,50,2,15,"wolkig",105,"wolbecker"
"1/3/2016 22:00",58,38,2,17,"wolkig",96,"wolbecker"
"1/3/2016 23:00",31,32,2,15,"wolkig",63,"wolbecker"
"1/4/2016 0:00",15,24,2,15,"Regen",39,"wolbecker"
"1/4/2016 1:00",7,8,2,15,"Schnee",15,"wolbecker"
"1/4/2016 2:00",3,3,1,13,"Schnee",6,"wolbecker"
"1/4/2016 3:00",2,3,1,13,"Schnee",5,"wolbecker"
"1/4/2016 4:00",6,9,1,13,"Regen",15,"wolbecker"
"1/4/2016 5:00",32,31,1,13,"Schnee",63,"wolbecker"
"1/4/2016 6:00",90,89,1,11,"Schnee",179,"wolbecker"
"1/4/2016 7:00",247,151,1,13,"Schnee",398,"wolbecker"
"1/4/2016 8:00",297,134,1,9,"Schnee",431,"wolbecker"
"1/4/2016 9:00",226,97,0,9,"Schnee",323,"wolbecker"
"1/4/2016 10:00",160,117,0,9,"Schnee",277,"wolbecker"
"1/4/2016 11:00",141,96,0,7,"Schnee",237,"wolbecker"
"1/4/2016 12:00",151,155,0,9,"Schnee",306,"wolbecker"
"1/4/2016 13:00",193,151,0,7,"Schnee",344,"wolbecker"
"1/4/2016 14:00",196,180,0,7,"wolkig",376,"wolbecker"
"1/4/2016 15:00",200,214,1,6,"Schnee",414,"wolbecker"
"1/4/2016 16:00",263,336,0,7,"wolkig",599,"wolbecker"
"1/4/2016 17:00",277,353,-1,9,"wolkig",630,"wolbecker"
"1/4/2016 18:00",239,328,-1,11,"wolkig",567,"wolbecker"
"1/4/2016 19:00",152,261,-1,9,"Regen",413,"wolbecker"
"1/4/2016 20:00",112,135,-1,6,"Regen",247,"wolbecker"
"1/4/2016 21:00",69,67,-1,6,"Schneeregen",136,"wolbecker"
"1/4/2016 22:00",65,43,0,4,"wolkig",108,"wolbecker"
"1/4/2016 23:00",52,44,0,6,"Schnee",96,"wolbecker"
"1/5/2016 0:00",32,16,0,4,"Schnee",48,"wolbecker"
"1/5/2016 1:00",10,7,1,6,"wolkig",17,"wolbecker"
"1/5/2016 2:00",7,6,1,4,"wolkig",13,"wolbecker"
"1/5/2016 3:00",2,5,1,4,"wolkig",7,"wolbecker"
"1/5/2016 4:00",5,10,1,4,"wolkig",15,"wolbecker"
"1/5/2016 5:00",34,26,NA,NA,NA,60,"wolbecker"
"1/5/2016 6:00",106,99,NA,NA,NA,205,"wolbecker"
"1/5/2016 7:00",257,180,NA,NA,NA,437,"wolbecker"
"1/5/2016 8:00",392,167,3,4,"wolkig",559,"wolbecker"
"1/5/2016 9:00",328,141,3,7,"wolkig",469,"wolbecker"
"1/5/2016 10:00",269,164,4,6,"wolkig",433,"wolbecker"
"1/5/2016 11:00",248,205,4,7,"wolkig",453,"wolbecker"
"1/5/2016 12:00",263,217,5,7,"wolkig",480,"wolbecker"
"1/5/2016 13:00",257,248,5,7,"wolkig",505,"wolbecker"
"1/5/2016 14:00",281,282,4,7,"wolkig",563,"wolbecker"
"1/5/2016 15:00",297,320,2,11,"wolkig",617,"wolbecker"
"1/5/2016 16:00",297,396,1,13,"wolkig",693,"wolbecker"
"1/5/2016 17:00",341,442,0,11,"wolkig",783,"wolbecker"
"1/5/2016 18:00",287,380,0,9,"wolkig",667,"wolbecker"
"1/5/2016 19:00",221,278,-1,13,"Schneeregen",499,"wolbecker"
"1/5/2016 20:00",123,192,-1,13,"wolkig",315,"wolbecker"
"1/5/2016 21:00",94,92,-1,11,"wolkig",186,"wolbecker"
"1/5/2016 22:00",96,91,-2,13,"wolkig",187,"wolbecker"
"1/5/2016 23:00",53,39,-2,11,"wolkig",92,"wolbecker"
"1/6/2016 0:00",23,23,-2,15,"wolkig",46,"wolbecker"
"1/6/2016 1:00",10,15,-2,13,"wolkig",25,"wolbecker"
"1/6/2016 2:00",10,8,-2,9,"Schneeregen",18,"wolbecker"
"1/6/2016 3:00",6,3,-2,11,"wolkig",9,"wolbecker"
"1/6/2016 4:00",8,6,-2,11,"wolkig",14,"wolbecker"
"1/6/2016 5:00",27,32,-2,13,"wolkig",59,"wolbecker"
"1/6/2016 6:00",109,102,-2,13,"Schneeregen",211,"wolbecker"
"1/6/2016 7:00",292,180,-2,11,"Schneeregen",472,"wolbecker"
"1/6/2016 8:00",381,163,-2,11,"Schneeregen",544,"wolbecker"
"1/6/2016 9:00",327,135,-2,11,"Schneeregen",462,"wolbecker"
"1/6/2016 10:00",290,150,-2,11,"Schneeregen",440,"wolbecker"
"1/6/2016 11:00",259,171,-2,11,"Schneeregen",430,"wolbecker"
"1/6/2016 12:00",274,259,-2,11,"Schneeregen",533,"wolbecker"
"1/6/2016 13:00",303,222,-2,11,"wolkig",525,"wolbecker"
"1/6/2016 14:00",236,285,-2,15,"wolkig",521,"wolbecker"
"1/6/2016 15:00",235,295,-2,9,"wolkig",530,"wolbecker"
"1/6/2016 16:00",282,377,-2,9,"wolkig",659,"wolbecker"
"1/6/2016 17:00",345,389,-2,7,"wolkig",734,"wolbecker"
"1/6/2016 18:00",289,407,-2,9,"wolkig",696,"wolbecker"
"1/6/2016 19:00",189,303,-2,6,"wolkig",492,"wolbecker"
"1/6/2016 20:00",144,198,-2,7,"wolkig",342,"wolbecker"
"1/6/2016 21:00",124,101,-2,7,"wolkig",225,"wolbecker"
"1/6/2016 22:00",119,88,-2,6,"wolkig",207,"wolbecker"
"1/6/2016 23:00",58,47,-1,6,"wolkig",105,"wolbecker"
"1/7/2016 0:00",28,27,-1,6,"wolkig",55,"wolbecker"
"1/7/2016 1:00",9,11,-1,6,"wolkig",20,"wolbecker"
"1/7/2016 2:00",9,11,0,2,"wolkig",20,"wolbecker"
"1/7/2016 3:00",3,7,0,4,"wolkig",10,"wolbecker"
"1/7/2016 4:00",9,12,0,6,"wolkig",21,"wolbecker"
"1/7/2016 5:00",26,35,1,6,"wolkig",61,"wolbecker"
"1/7/2016 6:00",109,147,1,7,"wolkig",256,"wolbecker"
"1/7/2016 7:00",584,256,2,11,"Nebel",840,"wolbecker"
"1/7/2016 8:00",489,218,2,7,"Nebel",707,"wolbecker"
"1/7/2016 9:00",425,172,3,13,"Nebel",597,"wolbecker"
"1/7/2016 10:00",287,185,3,9,NA,472,"wolbecker"
"1/7/2016 11:00",344,218,5,9,NA,562,"wolbecker"
"1/7/2016 12:00",254,273,5,9,"Klarer Himmel",527,"wolbecker"
"1/7/2016 13:00",328,312,6,9,"Klarer Himmel",640,"wolbecker"
"1/7/2016 14:00",307,336,6,17,"Klarer Himmel",643,"wolbecker"
"1/7/2016 15:00",323,406,6,15,"wolkig",729,"wolbecker"
"1/7/2016 16:00",310,459,5,17,"Regen",769,"wolbecker"
"1/7/2016 17:00",324,379,5,15,"Regen",703,"wolbecker"
"1/7/2016 18:00",226,346,5,24,"Regen",572,"wolbecker"
"1/7/2016 19:00",230,280,5,20,"Regen",510,"wolbecker"
"1/7/2016 20:00",100,171,5,19,"Regen",271,"wolbecker"
"1/7/2016 21:00",88,116,7,43,"Regen",204,"wolbecker"
"1/7/2016 22:00",78,85,6,35,"Regen",163,"wolbecker"
"1/7/2016 23:00",47,61,6,28,"teilweise bewölkt",108,"wolbecker"
"1/8/2016 0:00",25,18,6,30,"teilweise bewölkt",43,"wolbecker"
"1/8/2016 1:00",12,13,5,32,"teilweise bewölkt",25,"wolbecker"
"1/8/2016 2:00",1,3,5,28,"wolkig",4,"wolbecker"
"1/8/2016 3:00",2,11,5,33,"Klarer Himmel",13,"wolbecker"
"1/8/2016 4:00",6,8,5,32,"Klarer Himmel",14,"wolbecker"
"1/8/2016 5:00",28,31,5,32,"Klarer Himmel",59,"wolbecker"
"1/8/2016 6:00",100,133,5,32,"Klarer Himmel",233,"wolbecker"
"1/8/2016 7:00",514,259,5,28,"teilweise bewölkt",773,"wolbecker"
"1/8/2016 8:00",477,202,4,28,"teilweise bewölkt",679,"wolbecker"
"1/8/2016 9:00",404,176,4,26,"teilweise bewölkt",580,"wolbecker"
"1/8/2016 10:00",342,161,5,28,"teilweise bewölkt",503,"wolbecker"
"1/8/2016 11:00",317,236,6,26,"teilweise bewölkt",553,"wolbecker"
"1/8/2016 12:00",330,333,7,24,"teilweise bewölkt",663,"wolbecker"
"1/8/2016 13:00",371,448,7,24,"teilweise bewölkt",819,"wolbecker"
"1/8/2016 14:00",409,400,8,19,"teilweise bewölkt",809,"wolbecker"
"1/8/2016 15:00",356,460,7,17,"teilweise bewölkt",816,"wolbecker"
"1/8/2016 16:00",344,446,7,13,"wolkig",790,"wolbecker"
"1/8/2016 17:00",350,417,7,15,"wolkig",767,"wolbecker"
"1/8/2016 18:00",285,377,6,13,"teilweise bewölkt",662,"wolbecker"
"1/8/2016 19:00",275,301,5,9,"Klarer Himmel",576,"wolbecker"
"1/8/2016 20:00",163,215,4,11,"Klarer Himmel",378,"wolbecker"
"1/8/2016 21:00",131,152,4,11,"Klarer Himmel",283,"wolbecker"
"1/8/2016 22:00",123,140,2,7,"Klarer Himmel",263,"wolbecker"
"1/8/2016 23:00",97,120,2,7,"Klarer Himmel",217,"wolbecker"
"1/9/2016 0:00",86,100,1,6,"Klarer Himmel",186,"wolbecker"
"1/9/2016 1:00",60,96,1,6,"Klarer Himmel",156,"wolbecker"
"1/9/2016 2:00",43,54,0,6,"Klarer Himmel",97,"wolbecker"
"1/9/2016 3:00",20,28,1,7,"wolkig",48,"wolbecker"
"1/9/2016 4:00",22,22,1,9,"wolkig",44,"wolbecker"
"1/9/2016 5:00",29,19,1,7,"Schnee",48,"wolbecker"
"1/9/2016 6:00",25,18,1,9,"wolkig",43,"wolbecker"
"1/9/2016 7:00",61,49,1,9,"teilweise bewölkt",110,"wolbecker"
"1/9/2016 8:00",113,84,1,9,"teilweise bewölkt",197,"wolbecker"
"1/9/2016 9:00",261,113,2,9,"Klarer Himmel",374,"wolbecker"
"1/9/2016 10:00",357,167,4,9,"Klarer Himmel",524,"wolbecker"
"1/9/2016 11:00",396,248,6,13,"Klarer Himmel",644,"wolbecker"
"1/9/2016 12:00",418,297,6,7,"Klarer Himmel",715,"wolbecker"
"1/9/2016 13:00",398,346,7,11,"Klarer Himmel",744,"wolbecker"
"1/9/2016 14:00",318,418,7,9,"Klarer Himmel",736,"wolbecker"
"1/9/2016 15:00",303,376,7,7,"Klarer Himmel",679,"wolbecker"
"1/9/2016 16:00",204,346,7,9,"Klarer Himmel",550,"wolbecker"
"1/9/2016 17:00",222,300,7,9,"Klarer Himmel",522,"wolbecker"
"1/9/2016 18:00",194,296,6,13,"Klarer Himmel",490,"wolbecker"
"1/9/2016 19:00",194,232,5,20,"Klarer Himmel",426,"wolbecker"
"1/9/2016 20:00",168,150,5,15,"wolkig",318,"wolbecker"
"1/9/2016 21:00",106,109,4,13,"teilweise bewölkt",215,"wolbecker"
"1/9/2016 22:00",123,95,3,13,"teilweise bewölkt",218,"wolbecker"
"1/9/2016 23:00",67,101,3,13,"teilweise bewölkt",168,"wolbecker"
"1/10/2016 0:00",84,115,2,9,"Klarer Himmel",199,"wolbecker"
"1/10/2016 1:00",66,80,3,15,"teilweise bewölkt",146,"wolbecker"
"1/10/2016 2:00",54,43,3,15,"Klarer Himmel",97,"wolbecker"
"1/10/2016 3:00",35,31,4,13,"wolkig",66,"wolbecker"
"1/10/2016 4:00",26,23,4,13,"Regen",49,"wolbecker"
"1/10/2016 5:00",24,11,5,13,"wolkig",35,"wolbecker"
"1/10/2016 6:00",15,18,5,13,"wolkig",33,"wolbecker"
"1/10/2016 7:00",15,25,6,9,"Regen",40,"wolbecker"
"1/10/2016 8:00",36,26,6,13,"Regen",62,"wolbecker"
"1/10/2016 9:00",72,42,6,15,"wolkig",114,"wolbecker"
"1/10/2016 10:00",119,88,7,19,"wolkig",207,"wolbecker"
"1/10/2016 11:00",126,92,8,22,"teilweise bewölkt",218,"wolbecker"
"1/10/2016 12:00",125,120,8,20,"teilweise bewölkt",245,"wolbecker"
"1/10/2016 13:00",196,153,9,22,"teilweise bewölkt",349,"wolbecker"
"1/10/2016 14:00",253,172,9,19,"teilweise bewölkt",425,"wolbecker"
"1/10/2016 15:00",186,186,8,17,"teilweise bewölkt",372,"wolbecker"
"1/10/2016 16:00",203,221,7,11,"Klarer Himmel",424,"wolbecker"
"1/10/2016 17:00",163,168,7,15,"Klarer Himmel",331,"wolbecker"
"1/10/2016 18:00",182,175,7,11,"wolkig",357,"wolbecker"
"1/10/2016 19:00",164,103,6,11,"Regen",267,"wolbecker"
"1/10/2016 20:00",93,82,5,6,"wolkig",175,"wolbecker"
"1/10/2016 21:00",64,54,5,7,"wolkig",118,"wolbecker"
"1/10/2016 22:00",73,44,5,9,"wolkig",117,"wolbecker"
"1/10/2016 23:00",18,26,5,13,"wolkig",44,"wolbecker"
"1/11/2016 0:00",17,10,5,9,"wolkig",27,"wolbecker"
"1/11/2016 1:00",3,4,5,11,"wolkig",7,"wolbecker"
"1/11/2016 2:00",1,3,6,9,"wolkig",4,"wolbecker"
"1/11/2016 3:00",0,3,6,11,"wolkig",3,"wolbecker"
"1/11/2016 4:00",4,6,4,6,"wolkig",10,"wolbecker"
"1/11/2016 5:00",32,43,3,9,"teilweise bewölkt",75,"wolbecker"
"1/11/2016 6:00",113,148,3,7,"teilweise bewölkt",261,"wolbecker"
"1/11/2016 7:00",593,303,3,7,"teilweise bewölkt",896,"wolbecker"
"1/11/2016 8:00",575,231,3,7,"Klarer Himmel",806,"wolbecker"
"1/11/2016 9:00",530,153,3,9,"Klarer Himmel",683,"wolbecker"
"1/11/2016 10:00",322,190,3,9,"Klarer Himmel",512,"wolbecker"
"1/11/2016 11:00",305,218,4,7,"wolkig",523,"wolbecker"
"1/11/2016 12:00",273,322,5,9,"Regen",595,"wolbecker"
"1/11/2016 13:00",274,274,5,13,"Regen",548,"wolbecker"
"1/11/2016 14:00",222,261,5,7,"Regen",483,"wolbecker"
"1/11/2016 15:00",270,340,5,9,"Regen",610,"wolbecker"
"1/11/2016 16:00",316,455,5,7,"Regen",771,"wolbecker"
"1/11/2016 17:00",370,479,5,9,"wolkig",849,"wolbecker"
"1/11/2016 18:00",302,472,5,6,"wolkig",774,"wolbecker"
"1/11/2016 19:00",222,356,5,7,"Regen",578,"wolbecker"
"1/11/2016 20:00",124,192,5,7,"wolkig",316,"wolbecker"
"1/11/2016 21:00",120,138,6,13,"wolkig",258,"wolbecker"
"1/11/2016 22:00",85,94,6,13,"Regen",179,"wolbecker"
"1/11/2016 23:00",50,44,6,11,"Regen",94,"wolbecker"
"1/12/2016 0:00",16,24,6,17,"Regen",40,"wolbecker"
"1/12/2016 1:00",14,8,6,17,"Regen",22,"wolbecker"
"1/12/2016 2:00",2,7,6,13,"Regen",9,"wolbecker"
"1/12/2016 3:00",4,2,6,15,"wolkig",6,"wolbecker"
"1/12/2016 4:00",9,4,6,15,"wolkig",13,"wolbecker"
"1/12/2016 5:00",27,42,5,20,"wolkig",69,"wolbecker"
"1/12/2016 6:00",127,155,5,20,"wolkig",282,"wolbecker"
"1/12/2016 7:00",604,301,6,22,"wolkig",905,"wolbecker"
"1/12/2016 8:00",573,223,5,19,"wolkig",796,"wolbecker"
"1/12/2016 9:00",501,183,6,20,"wolkig",684,"wolbecker"
"1/12/2016 10:00",331,169,6,19,"wolkig",500,"wolbecker"
"1/12/2016 11:00",299,215,6,26,"wolkig",514,"wolbecker"
"1/12/2016 12:00",281,273,6,22,"Regen",554,"wolbecker"
"1/12/2016 13:00",303,345,7,22,"wolkig",648,"wolbecker"
"1/12/2016 14:00",277,340,6,20,"Regen",617,"wolbecker"
"1/12/2016 15:00",344,389,6,20,"wolkig",733,"wolbecker"
"1/12/2016 16:00",372,517,7,17,"wolkig",889,"wolbecker"
"1/12/2016 17:00",447,509,7,17,"wolkig",956,"wolbecker"
"1/12/2016 18:00",368,515,6,17,"wolkig",883,"wolbecker"
"1/12/2016 19:00",351,397,6,17,"wolkig",748,"wolbecker"
"1/12/2016 20:00",162,257,6,20,"wolkig",419,"wolbecker"
"1/12/2016 21:00",110,175,6,24,"wolkig",285,"wolbecker"
"1/12/2016 22:00",144,144,5,22,"wolkig",288,"wolbecker"
"1/12/2016 23:00",73,77,5,20,"Regen",150,"wolbecker"
"1/13/2016 0:00",32,25,4,20,"Regen",57,"wolbecker"
"1/13/2016 1:00",14,13,4,15,"wolkig",27,"wolbecker"
"1/13/2016 2:00",3,3,4,17,"Regen",6,"wolbecker"
"1/13/2016 3:00",2,2,4,17,"Regen",4,"wolbecker"
"1/13/2016 4:00",5,7,5,19,"wolkig",12,"wolbecker"
"1/13/2016 5:00",26,40,5,20,"wolkig",66,"wolbecker"
"1/13/2016 6:00",117,173,5,22,"wolkig",290,"wolbecker"
"1/13/2016 7:00",570,286,5,24,"Regen",856,"wolbecker"
"1/13/2016 8:00",584,246,5,24,"wolkig",830,"wolbecker"
"1/13/2016 9:00",505,177,5,17,"wolkig",682,"wolbecker"
"1/13/2016 10:00",357,201,5,19,"wolkig",558,"wolbecker"
"1/13/2016 11:00",293,234,6,17,"wolkig",527,"wolbecker"
"1/13/2016 12:00",307,325,6,17,"wolkig",632,"wolbecker"
"1/13/2016 13:00",358,397,6,13,"wolkig",755,"wolbecker"
"1/13/2016 14:00",307,355,6,19,"wolkig",662,"wolbecker"
"1/13/2016 15:00",327,393,6,7,"wolkig",720,"wolbecker"
"1/13/2016 16:00",309,480,5,28,"Regen",789,"wolbecker"
"1/13/2016 17:00",402,458,4,15,"wolkig",860,"wolbecker"
"1/13/2016 18:00",318,426,4,13,"wolkig",744,"wolbecker"
"1/13/2016 19:00",266,364,5,20,"wolkig",630,"wolbecker"
"1/13/2016 20:00",168,228,4,20,"teilweise bewölkt",396,"wolbecker"
"1/13/2016 21:00",128,174,3,17,"teilweise bewölkt",302,"wolbecker"
"1/13/2016 22:00",128,130,3,11,"teilweise bewölkt",258,"wolbecker"
"1/13/2016 23:00",87,67,3,11,"teilweise bewölkt",154,"wolbecker"
"1/14/2016 0:00",30,53,3,15,"teilweise bewölkt",83,"wolbecker"
"1/14/2016 1:00",24,20,2,13,"teilweise bewölkt",44,"wolbecker"
"1/14/2016 2:00",8,15,1,9,"teilweise bewölkt",23,"wolbecker"
"1/14/2016 3:00",1,6,1,9,"wolkig",7,"wolbecker"
"1/14/2016 4:00",9,9,1,9,"teilweise bewölkt",18,"wolbecker"
"1/14/2016 5:00",25,36,1,13,"wolkig",61,"wolbecker"
"1/14/2016 6:00",104,140,1,13,"wolkig",244,"wolbecker"
"1/14/2016 7:00",575,276,1,13,"wolkig",851,"wolbecker"
"1/14/2016 8:00",550,242,2,17,"Klarer Himmel",792,"wolbecker"
"1/14/2016 9:00",479,173,2,19,"Klarer Himmel",652,"wolbecker"
"1/14/2016 10:00",306,173,4,22,"wolkig",479,"wolbecker"
"1/14/2016 11:00",287,243,4,22,"Regen",530,"wolbecker"
"1/14/2016 12:00",258,245,4,28,"Regen",503,"wolbecker"
"1/14/2016 13:00",248,293,4,20,"Regen",541,"wolbecker"
"1/14/2016 14:00",258,281,3,22,"Regen",539,"wolbecker"
"1/14/2016 15:00",261,331,2,19,"Regen",592,"wolbecker"
"1/14/2016 16:00",327,439,3,15,"wolkig",766,"wolbecker"
"1/14/2016 17:00",384,454,3,15,"wolkig",838,"wolbecker"
"1/14/2016 18:00",354,492,3,15,"teilweise bewölkt",846,"wolbecker"
"1/14/2016 19:00",242,344,3,17,"Regen",586,"wolbecker"
"1/14/2016 20:00",148,239,2,17,"wolkig",387,"wolbecker"
"1/14/2016 21:00",112,140,3,17,"Regen",252,"wolbecker"
"1/14/2016 22:00",109,122,3,17,"Regen",231,"wolbecker"
"1/14/2016 23:00",69,71,3,15,"Regen",140,"wolbecker"
"1/15/2016 0:00",36,39,3,15,"wolkig",75,"wolbecker"
"1/15/2016 1:00",12,16,3,15,"Regen",28,"wolbecker"
"1/15/2016 2:00",11,4,2,15,"Regen",15,"wolbecker"
"1/15/2016 3:00",6,11,2,15,"Schnee",17,"wolbecker"
"1/15/2016 4:00",8,6,2,13,"Schnee",14,"wolbecker"
"1/15/2016 5:00",21,37,1,7,"Schnee",58,"wolbecker"
"1/15/2016 6:00",94,128,2,6,"Schnee",222,"wolbecker"
"1/15/2016 7:00",506,251,2,7,"wolkig",757,"wolbecker"
"1/15/2016 8:00",487,217,1,13,"wolkig",704,"wolbecker"
"1/15/2016 9:00",397,155,2,9,"wolkig",552,"wolbecker"
"1/15/2016 10:00",323,161,2,9,"wolkig",484,"wolbecker"
"1/15/2016 11:00",280,241,3,11,"wolkig",521,"wolbecker"
"1/15/2016 12:00",299,327,3,17,"wolkig",626,"wolbecker"
"1/15/2016 13:00",319,445,2,13,"wolkig",764,"wolbecker"
"1/15/2016 14:00",336,382,3,13,"wolkig",718,"wolbecker"
"1/15/2016 15:00",318,363,2,20,"wolkig",681,"wolbecker"
"1/15/2016 16:00",300,408,2,15,"wolkig",708,"wolbecker"
"1/15/2016 17:00",301,396,2,9,"wolkig",697,"wolbecker"
"1/15/2016 18:00",258,370,2,11,"wolkig",628,"wolbecker"
"1/15/2016 19:00",245,312,2,9,"wolkig",557,"wolbecker"
"1/15/2016 20:00",158,199,1,9,"wolkig",357,"wolbecker"
"1/15/2016 21:00",124,136,2,9,"wolkig",260,"wolbecker"
"1/15/2016 22:00",129,117,2,7,"wolkig",246,"wolbecker"
"1/15/2016 23:00",82,95,0,4,"wolkig",177,"wolbecker"
"1/16/2016 0:00",76,91,0,4,"wolkig",167,"wolbecker"
"1/16/2016 1:00",52,95,0,7,"wolkig",147,"wolbecker"
"1/16/2016 2:00",48,40,1,7,"wolkig",88,"wolbecker"
"1/16/2016 3:00",30,37,1,9,"teilweise bewölkt",67,"wolbecker"
"1/16/2016 4:00",39,19,1,9,"teilweise bewölkt",58,"wolbecker"
"1/16/2016 5:00",23,20,0,9,"teilweise bewölkt",43,"wolbecker"
"1/16/2016 6:00",25,27,0,13,"wolkig",52,"wolbecker"
"1/16/2016 7:00",58,45,1,20,"Schnee",103,"wolbecker"
"1/16/2016 8:00",111,85,1,20,"Schnee",196,"wolbecker"
"1/16/2016 9:00",233,107,2,22,"Schnee",340,"wolbecker"
"1/16/2016 10:00",244,123,2,20,"Regen",367,"wolbecker"
"1/16/2016 11:00",249,168,2,32,"Regen",417,"wolbecker"
"1/16/2016 12:00",199,193,1,26,"Schnee",392,"wolbecker"
"1/16/2016 13:00",232,193,1,30,"wolkig",425,"wolbecker"
"1/16/2016 14:00",217,256,2,24,"wolkig",473,"wolbecker"
"1/16/2016 15:00",199,235,1,17,"Schnee",434,"wolbecker"
"1/16/2016 16:00",179,273,1,13,"Schnee",452,"wolbecker"
"1/16/2016 17:00",140,221,1,11,"teilweise bewölkt",361,"wolbecker"
"1/16/2016 18:00",170,240,0,9,"wolkig",410,"wolbecker"
"1/16/2016 19:00",146,183,0,17,"Schnee",329,"wolbecker"
"1/16/2016 20:00",114,150,0,9,"teilweise bewölkt",264,"wolbecker"
"1/16/2016 21:00",95,107,-1,11,"teilweise bewölkt",202,"wolbecker"
"1/16/2016 22:00",108,90,0,17,"Schnee",198,"wolbecker"
"1/16/2016 23:00",85,67,0,17,"teilweise bewölkt",152,"wolbecker"
"1/17/2016 0:00",81,70,0,17,"wolkig",151,"wolbecker"
"1/17/2016 1:00",72,53,-1,13,"wolkig",125,"wolbecker"
"1/17/2016 2:00",41,46,-1,13,"Klarer Himmel",87,"wolbecker"
"1/17/2016 3:00",34,18,-1,17,"wolkig",52,"wolbecker"
"1/17/2016 4:00",42,15,0,13,"wolkig",57,"wolbecker"
"1/17/2016 5:00",18,14,-1,19,"wolkig",32,"wolbecker"
"1/17/2016 6:00",15,11,-1,15,"wolkig",26,"wolbecker"
"1/17/2016 7:00",22,22,-1,13,"wolkig",44,"wolbecker"
"1/17/2016 8:00",24,28,-1,13,"wolkig",52,"wolbecker"
"1/17/2016 9:00",62,37,-1,9,"wolkig",99,"wolbecker"
"1/17/2016 10:00",98,69,0,7,"wolkig",167,"wolbecker"
"1/17/2016 11:00",115,79,0,11,"wolkig",194,"wolbecker"
"1/17/2016 12:00",131,102,0,11,"wolkig",233,"wolbecker"
"1/17/2016 13:00",131,111,0,11,"wolkig",242,"wolbecker"
"1/17/2016 14:00",123,117,0,9,"Schnee",240,"wolbecker"
"1/17/2016 15:00",131,132,0,11,"wolkig",263,"wolbecker"
"1/17/2016 16:00",146,132,-1,9,"teilweise bewölkt",278,"wolbecker"
"1/17/2016 17:00",132,126,-2,2,"teilweise bewölkt",258,"wolbecker"
"1/17/2016 18:00",147,143,-3,2,"Klarer Himmel",290,"wolbecker"
"1/17/2016 19:00",124,149,-4,4,"Klarer Himmel",273,"wolbecker"
"1/17/2016 20:00",97,84,-5,2,"Klarer Himmel",181,"wolbecker"
"1/17/2016 21:00",69,52,-5,4,"Nebel",121,"wolbecker"
"1/17/2016 22:00",89,47,-6,2,"Nebel",136,"wolbecker"
"1/17/2016 23:00",39,32,-7,2,"Klarer Himmel",71,"wolbecker"
"1/18/2016 0:00",32,15,-6,2,"Nebel",47,"wolbecker"
"1/18/2016 1:00",3,6,-7,0,"Klarer Himmel",9,"wolbecker"
"1/18/2016 2:00",1,3,-7,0,"Klarer Himmel",4,"wolbecker"
"1/18/2016 3:00",1,1,-7,2,NA,2,"wolbecker"
"1/18/2016 4:00",6,4,-7,6,"Klarer Himmel",10,"wolbecker"
"1/18/2016 5:00",32,34,-7,2,NA,66,"wolbecker"
"1/18/2016 6:00",105,132,-7,2,NA,237,"wolbecker"
"1/18/2016 7:00",470,257,-7,4,NA,727,"wolbecker"
"1/18/2016 8:00",501,205,-6,6,"Nebel",706,"wolbecker"
"1/18/2016 9:00",435,148,-5,6,"Nebel",583,"wolbecker"
"1/18/2016 10:00",331,149,-4,6,NA,480,"wolbecker"
"1/18/2016 11:00",279,189,-3,6,NA,468,"wolbecker"
"1/18/2016 12:00",272,244,-2,7,"Klarer Himmel",516,"wolbecker"
"1/18/2016 13:00",320,311,-1,7,"teilweise bewölkt",631,"wolbecker"
"1/18/2016 14:00",294,300,-1,9,"teilweise bewölkt",594,"wolbecker"
"1/18/2016 15:00",321,355,-1,6,"Klarer Himmel",676,"wolbecker"
"1/18/2016 16:00",365,445,-2,6,"Klarer Himmel",810,"wolbecker"
"1/18/2016 17:00",361,523,-3,6,"Klarer Himmel",884,"wolbecker"
"1/18/2016 18:00",301,461,-3,4,"Klarer Himmel",762,"wolbecker"
"1/18/2016 19:00",258,344,-3,4,"Klarer Himmel",602,"wolbecker"
"1/18/2016 20:00",135,199,-4,7,"Klarer Himmel",334,"wolbecker"
"1/18/2016 21:00",90,151,-4,9,"Klarer Himmel",241,"wolbecker"
"1/18/2016 22:00",101,108,-5,6,"Klarer Himmel",209,"wolbecker"
"1/18/2016 23:00",55,55,-5,4,"Klarer Himmel",110,"wolbecker"
"1/19/2016 0:00",27,22,-5,6,"Klarer Himmel",49,"wolbecker"
"1/19/2016 1:00",10,10,-6,9,"Klarer Himmel",20,"wolbecker"
"1/19/2016 2:00",2,3,-7,4,"Klarer Himmel",5,"wolbecker"
"1/19/2016 3:00",1,3,-8,2,"Klarer Himmel",4,"wolbecker"
"1/19/2016 4:00",6,10,-8,2,"Klarer Himmel",16,"wolbecker"
"1/19/2016 5:00",31,38,-7,4,"Klarer Himmel",69,"wolbecker"
"1/19/2016 6:00",106,134,-8,4,"Klarer Himmel",240,"wolbecker"
"1/19/2016 7:00",544,275,-8,7,"Klarer Himmel",819,"wolbecker"
"1/19/2016 8:00",524,223,-8,6,"Klarer Himmel",747,"wolbecker"
"1/19/2016 9:00",444,174,-7,6,"Klarer Himmel",618,"wolbecker"
"1/19/2016 10:00",306,170,-4,6,"Klarer Himmel",476,"wolbecker"
"1/19/2016 11:00",288,171,-3,13,"Klarer Himmel",459,"wolbecker"
"1/19/2016 12:00",274,281,-2,13,"Klarer Himmel",555,"wolbecker"
"1/19/2016 13:00",299,347,-1,13,"Klarer Himmel",646,"wolbecker"
"1/19/2016 14:00",290,300,-1,11,"Klarer Himmel",590,"wolbecker"
"1/19/2016 15:00",339,347,-1,11,NA,686,"wolbecker"
"1/19/2016 16:00",380,464,-1,11,"wolkig",844,"wolbecker"
"1/19/2016 17:00",392,491,-1,9,"wolkig",883,"wolbecker"
"1/19/2016 18:00",344,480,-2,17,"Schnee",824,"wolbecker"
"1/19/2016 19:00",262,381,-2,9,"Schnee",643,"wolbecker"
"1/19/2016 20:00",165,213,-2,15,"Schnee",378,"wolbecker"
"1/19/2016 21:00",116,161,-1,11,"wolkig",277,"wolbecker"
"1/19/2016 22:00",137,113,-1,9,"wolkig",250,"wolbecker"
"1/19/2016 23:00",54,55,-1,13,"Klarer Himmel",109,"wolbecker"
"1/20/2016 0:00",29,24,-1,9,"wolkig",53,"wolbecker"
"1/20/2016 1:00",7,12,-1,9,"wolkig",19,"wolbecker"
"1/20/2016 2:00",5,4,-1,9,"wolkig",9,"wolbecker"
"1/20/2016 3:00",1,4,-1,9,"Schnee",5,"wolbecker"
"1/20/2016 4:00",7,8,-1,13,"wolkig",15,"wolbecker"
"1/20/2016 5:00",33,37,-1,13,"wolkig",70,"wolbecker"
"1/20/2016 6:00",119,138,0,13,"wolkig",257,"wolbecker"
"1/20/2016 7:00",506,284,-1,13,"Schnee",790,"wolbecker"
"1/20/2016 8:00",533,232,0,15,"wolkig",765,"wolbecker"
"1/20/2016 9:00",410,151,0,17,"wolkig",561,"wolbecker"
"1/20/2016 10:00",279,165,1,17,"wolkig",444,"wolbecker"
"1/20/2016 11:00",288,176,1,15,"Schnee",464,"wolbecker"
"1/20/2016 12:00",273,272,2,19,"wolkig",545,"wolbecker"
"1/20/2016 13:00",297,296,3,15,"wolkig",593,"wolbecker"
"1/20/2016 14:00",276,342,2,15,"wolkig",618,"wolbecker"
"1/20/2016 15:00",280,342,2,11,"wolkig",622,"wolbecker"
"1/20/2016 16:00",325,457,2,11,"wolkig",782,"wolbecker"
"1/20/2016 17:00",371,419,1,9,"wolkig",790,"wolbecker"
"1/20/2016 18:00",308,430,1,6,"wolkig",738,"wolbecker"
"1/20/2016 19:00",296,346,1,6,"wolkig",642,"wolbecker"
"1/20/2016 20:00",166,236,1,4,"wolkig",402,"wolbecker"
"1/20/2016 21:00",140,153,1,4,"wolkig",293,"wolbecker"
"1/20/2016 22:00",118,149,1,4,"wolkig",267,"wolbecker"
"1/20/2016 23:00",70,88,1,4,"wolkig",158,"wolbecker"
"1/21/2016 0:00",32,45,0,4,"wolkig",77,"wolbecker"
"1/21/2016 1:00",13,34,-2,2,"teilweise bewölkt",47,"wolbecker"
"1/21/2016 2:00",6,13,-3,4,"Nebel",19,"wolbecker"
"1/21/2016 3:00",6,10,-4,2,"Nebel",16,"wolbecker"
"1/21/2016 4:00",5,12,-5,4,"Nebel",17,"wolbecker"
"1/21/2016 5:00",33,29,-4,4,"Nebel",62,"wolbecker"
"1/21/2016 6:00",100,138,-4,2,"Nebel",238,"wolbecker"
"1/21/2016 7:00",479,263,-3,4,"wolkig",742,"wolbecker"
"1/21/2016 8:00",532,207,-3,2,"Nebel",739,"wolbecker"
"1/21/2016 9:00",412,172,-3,4,"wolkig",584,"wolbecker"
"1/21/2016 10:00",331,145,-2,4,"teilweise bewölkt",476,"wolbecker"
"1/21/2016 11:00",302,215,-2,6,"Nebel",517,"wolbecker"
"1/21/2016 12:00",253,305,-3,7,"Nebel",558,"wolbecker"
"1/21/2016 13:00",276,303,-3,7,"Nebel",579,"wolbecker"
"1/21/2016 14:00",276,325,-3,6,"Nebel",601,"wolbecker"
"1/21/2016 15:00",334,355,-3,6,"Nebel",689,"wolbecker"
"1/21/2016 16:00",302,436,-2,4,"Nebel",738,"wolbecker"
"1/21/2016 17:00",361,469,-2,7,"Nebel",830,"wolbecker"
"1/21/2016 18:00",307,432,-3,6,"Nebel",739,"wolbecker"
"1/21/2016 19:00",288,352,-3,6,"Nebel",640,"wolbecker"
"1/21/2016 20:00",156,227,-4,6,"Nebel",383,"wolbecker"
"1/21/2016 21:00",128,145,-5,4,"wolkig",273,"wolbecker"
"1/21/2016 22:00",87,115,-5,4,"Nebel",202,"wolbecker"
"1/21/2016 23:00",70,79,-6,2,NA,149,"wolbecker"
"1/22/2016 0:00",38,38,-6,6,NA,76,"wolbecker"
"1/22/2016 1:00",18,23,-6,6,NA,41,"wolbecker"
"1/22/2016 2:00",6,10,-6,6,NA,16,"wolbecker"
"1/22/2016 3:00",2,4,-6,6,NA,6,"wolbecker"
"1/22/2016 4:00",12,7,-6,6,NA,19,"wolbecker"
"1/22/2016 5:00",36,30,-6,7,NA,66,"wolbecker"
"1/22/2016 6:00",97,131,-6,7,NA,228,"wolbecker"
"1/22/2016 7:00",483,232,-6,7,NA,715,"wolbecker"
"1/22/2016 8:00",436,225,-6,9,NA,661,"wolbecker"
"1/22/2016 9:00",403,147,-5,9,NA,550,"wolbecker"
"1/22/2016 10:00",304,155,-3,9,NA,459,"wolbecker"
"1/22/2016 11:00",298,208,-2,11,NA,506,"wolbecker"
"1/22/2016 12:00",301,336,-1,15,"Klarer Himmel",637,"wolbecker"
"1/22/2016 13:00",348,414,0,15,"Klarer Himmel",762,"wolbecker"
"1/22/2016 14:00",317,395,1,13,"Klarer Himmel",712,"wolbecker"
"1/22/2016 15:00",332,411,1,11,"Klarer Himmel",743,"wolbecker"
"1/22/2016 16:00",302,429,0,9,"Klarer Himmel",731,"wolbecker"
"1/22/2016 17:00",289,393,0,13,"Klarer Himmel",682,"wolbecker"
"1/22/2016 18:00",235,352,0,13,"Klarer Himmel",587,"wolbecker"
"1/22/2016 19:00",249,278,1,13,"Klarer Himmel",527,"wolbecker"
"1/22/2016 20:00",167,185,0,11,"Klarer Himmel",352,"wolbecker"
"1/22/2016 21:00",101,115,0,9,"Regen",216,"wolbecker"
"1/22/2016 22:00",110,95,0,11,"Regen",205,"wolbecker"
"1/22/2016 23:00",74,83,0,9,"Regen",157,"wolbecker"
"1/23/2016 0:00",56,64,1,9,"Regen",120,"wolbecker"
"1/23/2016 1:00",43,63,2,9,"Regen",106,"wolbecker"
"1/23/2016 2:00",23,34,3,11,"Regen",57,"wolbecker"
"1/23/2016 3:00",15,25,3,20,"wolkig",40,"wolbecker"
"1/23/2016 4:00",13,6,4,19,"Regen",19,"wolbecker"
"1/23/2016 5:00",24,19,4,17,"wolkig",43,"wolbecker"
"1/23/2016 6:00",24,26,5,9,"wolkig",50,"wolbecker"
"1/23/2016 7:00",45,28,5,13,"wolkig",73,"wolbecker"
"1/23/2016 8:00",98,76,5,15,"wolkig",174,"wolbecker"
"1/23/2016 9:00",250,121,6,22,"wolkig",371,"wolbecker"
"1/23/2016 10:00",318,144,6,15,"wolkig",462,"wolbecker"
"1/23/2016 11:00",321,205,6,15,"wolkig",526,"wolbecker"
"1/23/2016 12:00",316,247,7,17,"wolkig",563,"wolbecker"
"1/23/2016 13:00",314,299,7,24,"wolkig",613,"wolbecker"
"1/23/2016 14:00",258,331,6,17,"wolkig",589,"wolbecker"
"1/23/2016 15:00",207,299,6,17,"wolkig",506,"wolbecker"
"1/23/2016 16:00",180,267,6,11,"wolkig",447,"wolbecker"
"1/23/2016 17:00",182,298,6,13,"Regen",480,"wolbecker"
"1/23/2016 18:00",169,232,6,13,"Regen",401,"wolbecker"
"1/23/2016 19:00",153,229,6,13,"wolkig",382,"wolbecker"
"1/23/2016 20:00",144,171,6,11,"wolkig",315,"wolbecker"
"1/23/2016 21:00",121,103,6,9,"wolkig",224,"wolbecker"
"1/23/2016 22:00",106,67,6,11,"wolkig",173,"wolbecker"
"1/23/2016 23:00",74,86,6,9,"wolkig",160,"wolbecker"
"1/24/2016 0:00",93,88,5,7,"wolkig",181,"wolbecker"
"1/24/2016 1:00",73,95,5,9,"wolkig",168,"wolbecker"
"1/24/2016 2:00",52,49,5,6,NA,101,"wolbecker"
"1/24/2016 3:00",36,36,4,6,"Klarer Himmel",72,"wolbecker"
"1/24/2016 4:00",41,26,4,7,"Klarer Himmel",67,"wolbecker"
"1/24/2016 5:00",22,4,5,9,"Klarer Himmel",26,"wolbecker"
"1/24/2016 6:00",18,13,4,9,"Klarer Himmel",31,"wolbecker"
"1/24/2016 7:00",14,20,4,7,"wolkig",34,"wolbecker"
"1/24/2016 8:00",28,27,4,7,"Klarer Himmel",55,"wolbecker"
"1/24/2016 9:00",89,61,4,11,"Regen",150,"wolbecker"
"1/24/2016 10:00",119,75,6,13,"wolkig",194,"wolbecker"
"1/24/2016 11:00",88,106,6,13,"wolkig",194,"wolbecker"
"1/24/2016 12:00",117,94,7,15,"wolkig",211,"wolbecker"
"1/24/2016 13:00",104,118,6,13,"wolkig",222,"wolbecker"
"1/24/2016 14:00",137,151,7,15,"Regen",288,"wolbecker"
"1/24/2016 15:00",138,106,7,13,"Regen",244,"wolbecker"
"1/24/2016 16:00",149,134,7,11,"Regen",283,"wolbecker"
"1/24/2016 17:00",135,127,7,7,"Regen",262,"wolbecker"
"1/24/2016 18:00",154,138,7,9,"Regen",292,"wolbecker"
"1/24/2016 19:00",143,101,7,9,"Regen",244,"wolbecker"
"1/24/2016 20:00",86,92,8,11,"Regen",178,"wolbecker"
"1/24/2016 21:00",74,38,8,13,"wolkig",112,"wolbecker"
"1/24/2016 22:00",73,50,9,17,"wolkig",123,"wolbecker"
"1/24/2016 23:00",36,31,9,15,"wolkig",67,"wolbecker"
"1/25/2016 0:00",19,7,9,15,"wolkig",26,"wolbecker"
"1/25/2016 1:00",11,6,9,15,"wolkig",17,"wolbecker"
"1/25/2016 2:00",3,3,9,15,"wolkig",6,"wolbecker"
"1/25/2016 3:00",3,2,9,15,"wolkig",5,"wolbecker"
"1/25/2016 4:00",8,8,9,15,"wolkig",16,"wolbecker"
"1/25/2016 5:00",41,34,9,11,"wolkig",75,"wolbecker"
"1/25/2016 6:00",142,153,9,11,"wolkig",295,"wolbecker"
"1/25/2016 7:00",508,282,9,6,"wolkig",790,"wolbecker"
"1/25/2016 8:00",569,236,9,4,"wolkig",805,"wolbecker"
"1/25/2016 9:00",497,165,10,6,"wolkig",662,"wolbecker"
"1/25/2016 10:00",336,181,10,9,"wolkig",517,"wolbecker"
"1/25/2016 11:00",315,219,12,13,"wolkig",534,"wolbecker"
"1/25/2016 12:00",314,298,13,15,"wolkig",612,"wolbecker"
"1/25/2016 13:00",376,306,13,19,"wolkig",682,"wolbecker"
"1/25/2016 14:00",342,329,13,17,"wolkig",671,"wolbecker"
"1/25/2016 15:00",392,393,13,17,"Klarer Himmel",785,"wolbecker"
"1/25/2016 16:00",384,502,12,13,"Klarer Himmel",886,"wolbecker"
"1/25/2016 17:00",428,570,11,13,"Klarer Himmel",998,"wolbecker"
"1/25/2016 18:00",332,540,10,11,"Klarer Himmel",872,"wolbecker"
"1/25/2016 19:00",271,360,8,9,"Klarer Himmel",631,"wolbecker"
"1/25/2016 20:00",177,238,9,9,"Klarer Himmel",415,"wolbecker"
"1/25/2016 21:00",119,164,11,15,"Klarer Himmel",283,"wolbecker"
"1/25/2016 22:00",106,134,11,24,"wolkig",240,"wolbecker"
"1/25/2016 23:00",41,53,11,17,"wolkig",94,"wolbecker"
"1/26/2016 0:00",23,29,11,17,"wolkig",52,"wolbecker"
"1/26/2016 1:00",12,16,11,20,"wolkig",28,"wolbecker"
"1/26/2016 2:00",8,2,11,20,"wolkig",10,"wolbecker"
"1/26/2016 3:00",4,8,10,20,"wolkig",12,"wolbecker"
"1/26/2016 4:00",9,6,10,20,"wolkig",15,"wolbecker"
"1/26/2016 5:00",40,38,10,20,"wolkig",78,"wolbecker"
"1/26/2016 6:00",154,157,9,17,"wolkig",311,"wolbecker"
"1/26/2016 7:00",627,316,9,13,"teilweise bewölkt",943,"wolbecker"
"1/26/2016 8:00",560,216,9,11,"Klarer Himmel",776,"wolbecker"
"1/26/2016 9:00",544,183,9,7,"wolkig",727,"wolbecker"
"1/26/2016 10:00",342,201,10,15,"wolkig",543,"wolbecker"
"1/26/2016 11:00",349,244,10,20,"wolkig",593,"wolbecker"
"1/26/2016 12:00",298,382,11,19,"wolkig",680,"wolbecker"
"1/26/2016 13:00",298,353,10,17,"Regen",651,"wolbecker"
"1/26/2016 14:00",273,322,11,19,"wolkig",595,"wolbecker"
"1/26/2016 15:00",326,363,11,26,"wolkig",689,"wolbecker"
"1/26/2016 16:00",419,503,11,26,"wolkig",922,"wolbecker"
"1/26/2016 17:00",407,509,11,22,"wolkig",916,"wolbecker"
"1/26/2016 18:00",374,540,10,28,"Klarer Himmel",914,"wolbecker"
"1/26/2016 19:00",359,418,10,30,"wolkig",777,"wolbecker"
"1/26/2016 20:00",152,238,9,30,"Regen",390,"wolbecker"
"1/26/2016 21:00",137,185,9,28,"Regen",322,"wolbecker"
"1/26/2016 22:00",160,127,9,32,"Regen",287,"wolbecker"
"1/26/2016 23:00",51,63,9,33,"Regen",114,"wolbecker"
"1/27/2016 0:00",24,26,9,32,"Regen",50,"wolbecker"
"1/27/2016 1:00",14,12,9,28,"wolkig",26,"wolbecker"
"1/27/2016 2:00",4,7,10,24,"wolkig",11,"wolbecker"
"1/27/2016 3:00",3,5,10,28,"wolkig",8,"wolbecker"
"1/27/2016 4:00",4,4,10,30,"wolkig",8,"wolbecker"
"1/27/2016 5:00",35,33,10,32,"wolkig",68,"wolbecker"
"1/27/2016 6:00",141,161,11,33,"wolkig",302,"wolbecker"
"1/27/2016 7:00",560,278,11,30,"wolkig",838,"wolbecker"
"1/27/2016 8:00",611,249,11,30,"wolkig",860,"wolbecker"
"1/27/2016 9:00",466,175,11,28,"wolkig",641,"wolbecker"
"1/27/2016 10:00",277,189,10,32,"Regen",466,"wolbecker"
"1/27/2016 11:00",217,185,10,26,"Regen",402,"wolbecker"
"1/27/2016 12:00",252,248,10,30,"wolkig",500,"wolbecker"
"1/27/2016 13:00",292,299,11,28,"wolkig",591,"wolbecker"
"1/27/2016 14:00",299,324,11,28,"wolkig",623,"wolbecker"
"1/27/2016 15:00",290,375,12,26,"wolkig",665,"wolbecker"
"1/27/2016 16:00",338,454,12,26,"wolkig",792,"wolbecker"
"1/27/2016 17:00",382,490,12,32,"wolkig",872,"wolbecker"
"1/27/2016 18:00",331,443,12,28,"wolkig",774,"wolbecker"
"1/27/2016 19:00",299,362,11,26,"wolkig",661,"wolbecker"
"1/27/2016 20:00",172,236,10,24,"Regen",408,"wolbecker"
"1/27/2016 21:00",115,153,10,28,"Regen",268,"wolbecker"
"1/27/2016 22:00",144,142,10,28,"Regen",286,"wolbecker"
"1/27/2016 23:00",81,59,10,26,"Regen",140,"wolbecker"
"1/28/2016 0:00",30,35,10,26,"Regen",65,"wolbecker"
"1/28/2016 1:00",19,28,10,26,"Regen",47,"wolbecker"
"1/28/2016 2:00",2,12,8,24,"Regen",14,"wolbecker"
"1/28/2016 3:00",5,9,8,22,"Regen",14,"wolbecker"
"1/28/2016 4:00",6,9,7,19,"wolkig",15,"wolbecker"
"1/28/2016 5:00",36,26,7,22,"wolkig",62,"wolbecker"
"1/28/2016 6:00",128,141,7,20,"wolkig",269,"wolbecker"
"1/28/2016 7:00",543,277,6,19,"teilweise bewölkt",820,"wolbecker"
"1/28/2016 8:00",561,215,5,17,"teilweise bewölkt",776,"wolbecker"
"1/28/2016 9:00",473,177,6,19,"teilweise bewölkt",650,"wolbecker"
"1/28/2016 10:00",340,185,7,28,"teilweise bewölkt",525,"wolbecker"
"1/28/2016 11:00",334,260,7,30,"teilweise bewölkt",594,"wolbecker"
"1/28/2016 12:00",267,268,8,24,"teilweise bewölkt",535,"wolbecker"
"1/28/2016 13:00",343,350,8,26,"teilweise bewölkt",693,"wolbecker"
"1/28/2016 14:00",328,351,8,22,"teilweise bewölkt",679,"wolbecker"
"1/28/2016 15:00",404,413,8,20,"teilweise bewölkt",817,"wolbecker"
"1/28/2016 16:00",407,531,7,17,"teilweise bewölkt",938,"wolbecker"
"1/28/2016 17:00",427,543,6,13,"Klarer Himmel",970,"wolbecker"
"1/28/2016 18:00",365,499,5,11,"Klarer Himmel",864,"wolbecker"
"1/28/2016 19:00",279,357,5,13,"Klarer Himmel",636,"wolbecker"
"1/28/2016 20:00",165,256,5,15,"Klarer Himmel",421,"wolbecker"
"1/28/2016 21:00",131,174,4,13,"Klarer Himmel",305,"wolbecker"
"1/28/2016 22:00",125,138,4,11,"Klarer Himmel",263,"wolbecker"
"1/28/2016 23:00",71,64,4,15,"Klarer Himmel",135,"wolbecker"
"1/29/2016 0:00",33,41,4,13,"Klarer Himmel",74,"wolbecker"
"1/29/2016 1:00",17,28,4,17,"Klarer Himmel",45,"wolbecker"
"1/29/2016 2:00",2,9,4,20,"Klarer Himmel",11,"wolbecker"
"1/29/2016 3:00",3,8,5,20,"Klarer Himmel",11,"wolbecker"
"1/29/2016 4:00",7,9,5,28,"wolkig",16,"wolbecker"
"1/29/2016 5:00",26,30,5,22,"wolkig",56,"wolbecker"
"1/29/2016 6:00",105,126,6,24,"wolkig",231,"wolbecker"
"1/29/2016 7:00",550,253,6,28,"wolkig",803,"wolbecker"
"1/29/2016 8:00",510,197,6,26,"wolkig",707,"wolbecker"
"1/29/2016 9:00",448,178,7,28,"wolkig",626,"wolbecker"
"1/29/2016 10:00",360,249,7,30,"wolkig",609,"wolbecker"
"1/29/2016 11:00",325,280,8,33,"wolkig",605,"wolbecker"
"1/29/2016 12:00",298,382,8,32,"wolkig",680,"wolbecker"
"1/29/2016 13:00",344,370,9,33,"wolkig",714,"wolbecker"
"1/29/2016 14:00",301,395,9,32,"wolkig",696,"wolbecker"
"1/29/2016 15:00",307,410,9,39,"wolkig",717,"wolbecker"
"1/29/2016 16:00",274,381,9,33,"wolkig",655,"wolbecker"
"1/29/2016 17:00",286,395,9,33,"wolkig",681,"wolbecker"
"1/29/2016 18:00",221,353,9,33,"wolkig",574,"wolbecker"
"1/29/2016 19:00",212,271,9,30,"wolkig",483,"wolbecker"
"1/29/2016 20:00",158,194,8,32,"wolkig",352,"wolbecker"
"1/29/2016 21:00",122,124,9,32,"Regen",246,"wolbecker"
"1/29/2016 22:00",106,101,9,30,"wolkig",207,"wolbecker"
"1/29/2016 23:00",103,87,9,33,"Regen",190,"wolbecker"
"1/30/2016 0:00",77,76,9,32,"Regen",153,"wolbecker"
"1/30/2016 1:00",78,60,9,35,"Regen",138,"wolbecker"
"1/30/2016 2:00",35,44,9,35,"wolkig",79,"wolbecker"
"1/30/2016 3:00",37,30,9,41,"wolkig",67,"wolbecker"
"1/30/2016 4:00",22,13,8,32,"Regen",35,"wolbecker"
"1/30/2016 5:00",26,13,8,28,"Regen",39,"wolbecker"
"1/30/2016 6:00",20,15,8,32,"Regen",35,"wolbecker"
"1/30/2016 7:00",43,33,8,37,"Regen",76,"wolbecker"
"1/30/2016 8:00",94,66,9,33,"Regen",160,"wolbecker"
"1/30/2016 9:00",177,85,9,33,"Regen",262,"wolbecker"
"1/30/2016 10:00",149,84,9,33,"Regen",233,"wolbecker"
"1/30/2016 11:00",133,100,8,33,"Regen",233,"wolbecker"
"1/30/2016 12:00",138,137,8,24,"Regen",275,"wolbecker"
"1/30/2016 13:00",119,121,7,17,"Regen",240,"wolbecker"
"1/30/2016 14:00",111,141,7,32,"Regen",252,"wolbecker"
"1/30/2016 15:00",101,117,7,19,"Regen",218,"wolbecker"
"1/30/2016 16:00",114,134,6,19,"wolkig",248,"wolbecker"
"1/30/2016 17:00",102,151,6,20,"wolkig",253,"wolbecker"
"1/30/2016 18:00",123,145,5,20,"wolkig",268,"wolbecker"
"1/30/2016 19:00",136,162,4,22,"teilweise bewölkt",298,"wolbecker"
"1/30/2016 20:00",130,126,4,19,"Klarer Himmel",256,"wolbecker"
"1/30/2016 21:00",88,82,4,22,"teilweise bewölkt",170,"wolbecker"
"1/30/2016 22:00",78,69,4,22,"Klarer Himmel",147,"wolbecker"
"1/30/2016 23:00",64,53,4,30,"teilweise bewölkt",117,"wolbecker"
"1/31/2016 0:00",53,55,3,22,"teilweise bewölkt",108,"wolbecker"
"1/31/2016 1:00",55,51,3,22,"teilweise bewölkt",106,"wolbecker"
"1/31/2016 2:00",42,39,3,24,"Klarer Himmel",81,"wolbecker"
"1/31/2016 3:00",24,21,3,24,"Klarer Himmel",45,"wolbecker"
"1/31/2016 4:00",21,13,3,24,"Klarer Himmel",34,"wolbecker"
"1/31/2016 5:00",18,7,3,28,"teilweise bewölkt",25,"wolbecker"
"1/31/2016 6:00",11,11,3,22,"Klarer Himmel",22,"wolbecker"
"1/31/2016 7:00",14,21,3,22,"Klarer Himmel",35,"wolbecker"
"1/31/2016 8:00",27,30,3,26,"Klarer Himmel",57,"wolbecker"
"1/31/2016 9:00",92,51,4,22,"Klarer Himmel",143,"wolbecker"
"1/31/2016 10:00",115,73,4,22,"Klarer Himmel",188,"wolbecker"
"1/31/2016 11:00",90,100,5,24,"Klarer Himmel",190,"wolbecker"
"1/31/2016 12:00",111,103,6,24,"wolkig",214,"wolbecker"
"1/31/2016 13:00",150,122,5,20,"wolkig",272,"wolbecker"
"1/31/2016 14:00",137,140,6,20,"Regen",277,"wolbecker"
"1/31/2016 15:00",131,107,5,15,"Regen",238,"wolbecker"
"1/31/2016 16:00",127,115,5,11,"Regen",242,"wolbecker"
"1/31/2016 17:00",153,128,5,9,"Regen",281,"wolbecker"
"1/31/2016 18:00",103,100,5,9,"Regen",203,"wolbecker"
"1/31/2016 19:00",133,111,5,9,"Regen",244,"wolbecker"
"1/31/2016 20:00",102,85,6,7,"Regen",187,"wolbecker"
"1/31/2016 21:00",64,62,6,9,"wolkig",126,"wolbecker"
"1/31/2016 22:00",69,40,8,22,"wolkig",109,"wolbecker"
"1/31/2016 23:00",29,24,9,19,"Regen",53,"wolbecker"
"2/1/2016 0:00",18,10,9,20,"wolkig",28,"wolbecker"
"2/1/2016 1:00",7,3,9,13,"Regen",10,"wolbecker"
"2/1/2016 2:00",1,0,9,15,"wolkig",1,"wolbecker"
"2/1/2016 3:00",1,2,10,17,"Regen",3,"wolbecker"
"2/1/2016 4:00",5,6,10,20,"Regen",11,"wolbecker"
"2/1/2016 5:00",28,34,11,28,"Regen",62,"wolbecker"
"2/1/2016 6:00",112,132,11,28,"wolkig",244,"wolbecker"
"2/1/2016 7:00",480,260,11,26,"Regen",740,"wolbecker"
"2/1/2016 8:00",481,190,11,33,"Regen",671,"wolbecker"
"2/1/2016 9:00",434,129,11,28,"Regen",563,"wolbecker"
"2/1/2016 10:00",259,143,11,32,"Regen",402,"wolbecker"
"2/1/2016 11:00",250,176,11,30,"Regen",426,"wolbecker"
"2/1/2016 12:00",220,280,11,39,"wolkig",500,"wolbecker"
"2/1/2016 13:00",263,262,11,37,"wolkig",525,"wolbecker"
"2/1/2016 14:00",279,259,11,44,"wolkig",538,"wolbecker"
"2/1/2016 15:00",297,312,12,39,"wolkig",609,"wolbecker"
"2/1/2016 16:00",367,438,11,35,"wolkig",805,"wolbecker"
"2/1/2016 17:00",350,483,11,33,"Regen",833,"wolbecker"
"2/1/2016 18:00",313,416,11,30,"wolkig",729,"wolbecker"
"2/1/2016 19:00",269,343,11,33,"wolkig",612,"wolbecker"
"2/1/2016 20:00",149,189,11,32,"wolkig",338,"wolbecker"
"2/1/2016 21:00",115,143,11,37,"wolkig",258,"wolbecker"
"2/1/2016 22:00",117,104,11,37,"Regen",221,"wolbecker"
"2/1/2016 23:00",44,58,12,35,"wolkig",102,"wolbecker"
"2/2/2016 0:00",24,21,10,37,"Regen",45,"wolbecker"
"2/2/2016 1:00",18,12,11,33,"Regen",30,"wolbecker"
"2/2/2016 2:00",7,3,11,32,"wolkig",10,"wolbecker"
"2/2/2016 3:00",1,4,10,33,"wolkig",5,"wolbecker"
"2/2/2016 4:00",10,6,10,43,"teilweise bewölkt",16,"wolbecker"
"2/2/2016 5:00",29,37,10,26,"wolkig",66,"wolbecker"
"2/2/2016 6:00",126,159,10,33,"wolkig",285,"wolbecker"
"2/2/2016 7:00",555,276,9,33,"wolkig",831,"wolbecker"
"2/2/2016 8:00",545,234,10,41,"wolkig",779,"wolbecker"
"2/2/2016 9:00",474,169,10,32,"wolkig",643,"wolbecker"
"2/2/2016 10:00",312,152,10,33,"wolkig",464,"wolbecker"
"2/2/2016 11:00",277,185,10,35,"Regen",462,"wolbecker"
"2/2/2016 12:00",269,279,8,50,"Regen",548,"wolbecker"
"2/2/2016 13:00",190,301,7,39,"Regen",491,"wolbecker"
"2/2/2016 14:00",249,291,8,32,"Regen",540,"wolbecker"
"2/2/2016 15:00",249,313,6,24,"Regen",562,"wolbecker"
"2/2/2016 16:00",329,399,7,20,"teilweise bewölkt",728,"wolbecker"
"2/2/2016 17:00",388,498,7,28,"wolkig",886,"wolbecker"
"2/2/2016 18:00",341,471,7,28,"wolkig",812,"wolbecker"
"2/2/2016 19:00",247,385,7,37,"teilweise bewölkt",632,"wolbecker"
"2/2/2016 20:00",159,227,7,33,"teilweise bewölkt",386,"wolbecker"
"2/2/2016 21:00",112,165,7,33,"wolkig",277,"wolbecker"
"2/2/2016 22:00",120,115,7,33,"Klarer Himmel",235,"wolbecker"
"2/2/2016 23:00",58,54,7,30,"Klarer Himmel",112,"wolbecker"
"2/3/2016 0:00",31,14,6,30,"teilweise bewölkt",45,"wolbecker"
"2/3/2016 1:00",11,6,6,28,"Klarer Himmel",17,"wolbecker"
"2/3/2016 2:00",4,6,5,24,"Klarer Himmel",10,"wolbecker"
"2/3/2016 3:00",0,4,5,22,"teilweise bewölkt",4,"wolbecker"
"2/3/2016 4:00",7,6,4,20,"teilweise bewölkt",13,"wolbecker"
"2/3/2016 5:00",34,37,4,22,"wolkig",71,"wolbecker"
"2/3/2016 6:00",110,156,4,20,"teilweise bewölkt",266,"wolbecker"
"2/3/2016 7:00",564,255,4,17,"teilweise bewölkt",819,"wolbecker"
"2/3/2016 8:00",599,255,4,15,"teilweise bewölkt",854,"wolbecker"
"2/3/2016 9:00",481,167,4,26,"wolkig",648,"wolbecker"
"2/3/2016 10:00",355,206,5,28,"wolkig",561,"wolbecker"
"2/3/2016 11:00",375,227,6,32,"wolkig",602,"wolbecker"
"2/3/2016 12:00",336,338,7,33,"teilweise bewölkt",674,"wolbecker"
"2/3/2016 13:00",362,401,7,32,"teilweise bewölkt",763,"wolbecker"
"2/3/2016 14:00",306,406,6,24,"teilweise bewölkt",712,"wolbecker"
"2/3/2016 15:00",333,372,5,30,"teilweise bewölkt",705,"wolbecker"
"2/3/2016 16:00",349,528,4,24,"wolkig",877,"wolbecker"
"2/3/2016 17:00",403,509,4,28,"wolkig",912,"wolbecker"
"2/3/2016 18:00",378,474,5,26,"wolkig",852,"wolbecker"
"2/3/2016 19:00",261,391,4,26,"wolkig",652,"wolbecker"
"2/3/2016 20:00",172,216,4,26,"wolkig",388,"wolbecker"
"2/3/2016 21:00",125,167,3,17,"teilweise bewölkt",292,"wolbecker"
"2/3/2016 22:00",130,137,3,17,"teilweise bewölkt",267,"wolbecker"
"2/3/2016 23:00",103,75,2,19,"teilweise bewölkt",178,"wolbecker"
"2/4/2016 0:00",42,47,3,19,"teilweise bewölkt",89,"wolbecker"
"2/4/2016 1:00",14,20,3,15,"teilweise bewölkt",34,"wolbecker"
"2/4/2016 2:00",4,12,2,19,"teilweise bewölkt",16,"wolbecker"
"2/4/2016 3:00",6,17,3,19,"wolkig",23,"wolbecker"
"2/4/2016 4:00",3,11,3,15,"Klarer Himmel",14,"wolbecker"
"2/4/2016 5:00",37,43,3,19,"wolkig",80,"wolbecker"
"2/4/2016 6:00",97,146,3,19,"wolkig",243,"wolbecker"
"2/4/2016 7:00",509,258,3,17,"wolkig",767,"wolbecker"
"2/4/2016 8:00",484,220,4,17,"Regen",704,"wolbecker"
"2/4/2016 9:00",397,146,3,19,"Regen",543,"wolbecker"
"2/4/2016 10:00",220,148,3,15,"Regen",368,"wolbecker"
"2/4/2016 11:00",234,165,4,15,"Regen",399,"wolbecker"
"2/4/2016 12:00",221,224,4,19,"Regen",445,"wolbecker"
"2/4/2016 13:00",211,260,3,13,"Regen",471,"wolbecker"
"2/4/2016 14:00",199,286,3,9,"Regen",485,"wolbecker"
"2/4/2016 15:00",288,316,3,6,"Regen",604,"wolbecker"
"2/4/2016 16:00",317,367,4,4,"wolkig",684,"wolbecker"
"2/4/2016 17:00",337,391,3,6,"wolkig",728,"wolbecker"
"2/4/2016 18:00",271,376,3,9,"wolkig",647,"wolbecker"
"2/4/2016 19:00",243,302,3,11,"wolkig",545,"wolbecker"
"2/4/2016 20:00",156,233,3,11,"wolkig",389,"wolbecker"
"2/4/2016 21:00",111,169,4,11,"wolkig",280,"wolbecker"
"2/4/2016 22:00",103,123,4,11,"wolkig",226,"wolbecker"
"2/4/2016 23:00",64,77,4,11,"wolkig",141,"wolbecker"
"2/5/2016 0:00",42,59,4,7,"wolkig",101,"wolbecker"
"2/5/2016 1:00",9,36,4,11,"wolkig",45,"wolbecker"
"2/5/2016 2:00",13,13,4,7,"wolkig",26,"wolbecker"
"2/5/2016 3:00",4,10,4,9,"wolkig",14,"wolbecker"
"2/5/2016 4:00",5,12,4,11,"wolkig",17,"wolbecker"
"2/5/2016 5:00",29,24,4,11,"Regen",53,"wolbecker"
"2/5/2016 6:00",96,115,4,11,"Regen",211,"wolbecker"
"2/5/2016 7:00",446,224,4,15,"Regen",670,"wolbecker"
"2/5/2016 8:00",424,168,4,13,"Regen",592,"wolbecker"
"2/5/2016 9:00",346,158,5,13,"wolkig",504,"wolbecker"
"2/5/2016 10:00",271,159,6,15,"Regen",430,"wolbecker"
"2/5/2016 11:00",228,182,6,13,"wolkig",410,"wolbecker"
"2/5/2016 12:00",224,262,8,17,"wolkig",486,"wolbecker"
"2/5/2016 13:00",280,328,8,15,"wolkig",608,"wolbecker"
"2/5/2016 14:00",283,358,10,15,"wolkig",641,"wolbecker"
"2/5/2016 15:00",291,363,10,15,"wolkig",654,"wolbecker"
"2/5/2016 16:00",292,378,10,15,"wolkig",670,"wolbecker"
"2/5/2016 17:00",297,366,9,15,"wolkig",663,"wolbecker"
"2/5/2016 18:00",218,337,10,17,"wolkig",555,"wolbecker"
"2/5/2016 19:00",196,280,9,13,"wolkig",476,"wolbecker"
"2/5/2016 20:00",153,178,9,13,"Regen",331,"wolbecker"
"2/5/2016 21:00",96,131,9,15,"wolkig",227,"wolbecker"
"2/5/2016 22:00",115,78,9,11,"Regen",193,"wolbecker"
"2/5/2016 23:00",94,88,9,13,"wolkig",182,"wolbecker"
"2/6/2016 0:00",57,65,10,15,"wolkig",122,"wolbecker"
"2/6/2016 1:00",52,57,9,13,"wolkig",109,"wolbecker"
"2/6/2016 2:00",25,29,10,15,"wolkig",54,"wolbecker"
"2/6/2016 3:00",18,23,9,11,"wolkig",41,"wolbecker"
"2/6/2016 4:00",14,13,9,13,"wolkig",27,"wolbecker"
"2/6/2016 5:00",23,17,8,11,"teilweise bewölkt",40,"wolbecker"
"2/6/2016 6:00",28,37,8,9,"wolkig",65,"wolbecker"
"2/6/2016 7:00",79,38,7,11,"wolkig",117,"wolbecker"
"2/6/2016 8:00",120,70,8,19,"wolkig",190,"wolbecker"
"2/6/2016 9:00",254,105,8,17,"wolkig",359,"wolbecker"
"2/6/2016 10:00",376,155,9,19,"wolkig",531,"wolbecker"
"2/6/2016 11:00",354,249,9,19,"wolkig",603,"wolbecker"
"2/6/2016 12:00",358,282,10,15,"wolkig",640,"wolbecker"
"2/6/2016 13:00",308,312,10,24,"wolkig",620,"wolbecker"
"2/6/2016 14:00",276,366,10,17,"wolkig",642,"wolbecker"
"2/6/2016 15:00",260,322,11,15,"wolkig",582,"wolbecker"
"2/6/2016 16:00",231,281,11,19,"wolkig",512,"wolbecker"
"2/6/2016 17:00",222,300,10,13,"Klarer Himmel",522,"wolbecker"
"2/6/2016 18:00",164,276,9,13,"Klarer Himmel",440,"wolbecker"
"2/6/2016 19:00",176,247,9,15,"Klarer Himmel",423,"wolbecker"
"2/6/2016 20:00",129,180,9,17,"Klarer Himmel",309,"wolbecker"
"2/6/2016 21:00",87,93,8,11,"Klarer Himmel",180,"wolbecker"
"2/6/2016 22:00",108,96,9,11,"Klarer Himmel",204,"wolbecker"
"2/6/2016 23:00",100,98,8,15,"Klarer Himmel",198,"wolbecker"
"2/7/2016 0:00",71,78,8,17,"Klarer Himmel",149,"wolbecker"
"2/7/2016 1:00",72,59,8,17,"Klarer Himmel",131,"wolbecker"
"2/7/2016 2:00",49,48,9,15,"Klarer Himmel",97,"wolbecker"
"2/7/2016 3:00",25,23,9,19,"Klarer Himmel",48,"wolbecker"
"2/7/2016 4:00",21,23,9,17,"Klarer Himmel",44,"wolbecker"
"2/7/2016 5:00",15,13,10,19,"Klarer Himmel",28,"wolbecker"
"2/7/2016 6:00",12,12,10,20,"Klarer Himmel",24,"wolbecker"
"2/7/2016 7:00",16,20,10,20,"Regen",36,"wolbecker"
"2/7/2016 8:00",29,30,11,20,"wolkig",59,"wolbecker"
"2/7/2016 9:00",91,65,11,24,"Regen",156,"wolbecker"
"2/7/2016 10:00",85,83,9,19,"wolkig",168,"wolbecker"
"2/7/2016 11:00",114,74,10,22,"wolkig",188,"wolbecker"
"2/7/2016 12:00",155,100,10,32,"wolkig",255,"wolbecker"
"2/7/2016 13:00",160,99,10,28,"wolkig",259,"wolbecker"
"2/7/2016 14:00",158,130,10,28,"wolkig",288,"wolbecker"
"2/7/2016 15:00",147,135,9,22,"wolkig",282,"wolbecker"
"2/7/2016 16:00",141,134,9,24,"wolkig",275,"wolbecker"
"2/7/2016 17:00",162,186,9,22,"teilweise bewölkt",348,"wolbecker"
"2/7/2016 18:00",135,152,8,24,"teilweise bewölkt",287,"wolbecker"
"2/7/2016 19:00",142,118,8,24,"Klarer Himmel",260,"wolbecker"
"2/7/2016 20:00",94,100,8,20,"Klarer Himmel",194,"wolbecker"
"2/7/2016 21:00",72,71,7,20,"Klarer Himmel",143,"wolbecker"
"2/7/2016 22:00",81,61,7,22,"Klarer Himmel",142,"wolbecker"
"2/7/2016 23:00",40,37,7,26,"Klarer Himmel",77,"wolbecker"
"2/8/2016 0:00",36,16,6,24,"Klarer Himmel",52,"wolbecker"
"2/8/2016 1:00",21,13,7,26,"Klarer Himmel",34,"wolbecker"
"2/8/2016 2:00",10,10,7,26,"teilweise bewölkt",20,"wolbecker"
"2/8/2016 3:00",6,6,8,28,"wolkig",12,"wolbecker"
"2/8/2016 4:00",34,28,8,32,"wolkig",62,"wolbecker"
"2/8/2016 5:00",20,14,8,33,"Regen",34,"wolbecker"
"2/8/2016 6:00",33,54,8,35,"Regen",87,"wolbecker"
"2/8/2016 7:00",64,79,7,28,"Regen",143,"wolbecker"
"2/8/2016 8:00",115,93,8,30,"wolkig",208,"wolbecker"
"2/8/2016 9:00",89,65,9,26,"wolkig",154,"wolbecker"
"2/8/2016 10:00",123,89,9,24,"Regen",212,"wolbecker"
"2/8/2016 11:00",129,114,10,39,"Regen",243,"wolbecker"
"2/8/2016 12:00",165,124,10,35,"wolkig",289,"wolbecker"
"2/8/2016 13:00",134,126,9,39,"Regen",260,"wolbecker"
"2/8/2016 14:00",141,114,9,33,"wolkig",255,"wolbecker"
"2/8/2016 15:00",138,145,9,39,"wolkig",283,"wolbecker"
"2/8/2016 16:00",180,135,9,39,"wolkig",315,"wolbecker"
"2/8/2016 17:00",160,175,9,37,"wolkig",335,"wolbecker"
"2/8/2016 18:00",147,155,8,39,"Regen",302,"wolbecker"
"2/8/2016 19:00",119,108,7,39,"Regen",227,"wolbecker"
"2/8/2016 20:00",84,81,7,43,"Regen",165,"wolbecker"
"2/8/2016 21:00",74,62,8,46,"Regen",136,"wolbecker"
"2/8/2016 22:00",80,50,7,41,"Regen",130,"wolbecker"
"2/8/2016 23:00",23,40,7,43,"Regen",63,"wolbecker"
"2/9/2016 0:00",19,21,7,43,"Regen",40,"wolbecker"
"2/9/2016 1:00",7,6,7,41,"Regen",13,"wolbecker"
"2/9/2016 2:00",4,2,7,35,"wolkig",6,"wolbecker"
"2/9/2016 3:00",5,4,7,39,"wolkig",9,"wolbecker"
"2/9/2016 4:00",4,7,6,32,"Regen",11,"wolbecker"
"2/9/2016 5:00",25,27,7,30,"teilweise bewölkt",52,"wolbecker"
"2/9/2016 6:00",88,94,7,32,"wolkig",182,"wolbecker"
"2/9/2016 7:00",311,206,7,30,NA,517,"wolbecker"
"2/9/2016 8:00",429,179,6,24,"Regen",608,"wolbecker"
"2/9/2016 9:00",417,156,7,15,"wolkig",573,"wolbecker"
"2/9/2016 10:00",283,177,7,19,"wolkig",460,"wolbecker"
"2/9/2016 11:00",299,187,8,17,"wolkig",486,"wolbecker"
"2/9/2016 12:00",252,247,8,13,"wolkig",499,"wolbecker"
"2/9/2016 13:00",165,201,6,19,"Regen",366,"wolbecker"
"2/9/2016 14:00",153,194,4,13,"Regen",347,"wolbecker"
"2/9/2016 15:00",155,215,5,11,"Regen",370,"wolbecker"
"2/9/2016 16:00",208,249,5,11,"Regen",457,"wolbecker"
"2/9/2016 17:00",289,362,6,13,"wolkig",651,"wolbecker"
"2/9/2016 18:00",245,366,8,33,"Regen",611,"wolbecker"
"2/9/2016 19:00",183,288,1,37,"Schnee",471,"wolbecker"
"2/9/2016 20:00",111,154,0,32,"Schnee",265,"wolbecker"
"2/9/2016 21:00",86,101,1,22,"Schnee",187,"wolbecker"
"2/9/2016 22:00",73,80,2,26,"teilweise bewölkt",153,"wolbecker"
"2/9/2016 23:00",58,52,3,22,"wolkig",110,"wolbecker"
"2/10/2016 0:00",21,14,4,24,"teilweise bewölkt",35,"wolbecker"
"2/10/2016 1:00",7,13,4,24,"teilweise bewölkt",20,"wolbecker"
"2/10/2016 2:00",6,4,3,19,"teilweise bewölkt",10,"wolbecker"
"2/10/2016 3:00",4,1,4,22,"wolkig",5,"wolbecker"
"2/10/2016 4:00",5,5,4,20,"wolkig",10,"wolbecker"
"2/10/2016 5:00",33,22,4,17,"wolkig",55,"wolbecker"
"2/10/2016 6:00",89,116,1,19,"Schnee",205,"wolbecker"
"2/10/2016 7:00",362,196,1,15,"Schnee",558,"wolbecker"
"2/10/2016 8:00",426,197,2,11,"wolkig",623,"wolbecker"
"2/10/2016 9:00",345,148,3,17,"wolkig",493,"wolbecker"
"2/10/2016 10:00",303,154,4,17,"wolkig",457,"wolbecker"
"2/10/2016 11:00",275,213,4,17,"Regen",488,"wolbecker"
"2/10/2016 12:00",266,252,5,20,"wolkig",518,"wolbecker"
"2/10/2016 13:00",297,260,5,24,"wolkig",557,"wolbecker"
"2/10/2016 14:00",254,253,6,24,"wolkig",507,"wolbecker"
"2/10/2016 15:00",281,328,6,17,"wolkig",609,"wolbecker"
"2/10/2016 16:00",310,433,6,19,"Regen",743,"wolbecker"
"2/10/2016 17:00",322,406,5,19,"Regen",728,"wolbecker"
"2/10/2016 18:00",265,381,5,20,"Regen",646,"wolbecker"
"2/10/2016 19:00",221,309,5,20,"wolkig",530,"wolbecker"
"2/10/2016 20:00",129,211,5,20,"wolkig",340,"wolbecker"
"2/10/2016 21:00",92,137,5,26,"wolkig",229,"wolbecker"
"2/10/2016 22:00",134,125,4,20,"wolkig",259,"wolbecker"
"2/10/2016 23:00",54,70,3,20,"teilweise bewölkt",124,"wolbecker"
"2/11/2016 0:00",30,28,4,20,"teilweise bewölkt",58,"wolbecker"
"2/11/2016 1:00",14,19,4,20,"wolkig",33,"wolbecker"
"2/11/2016 2:00",9,7,4,19,"Klarer Himmel",16,"wolbecker"
"2/11/2016 3:00",1,8,4,17,"Klarer Himmel",9,"wolbecker"
"2/11/2016 4:00",4,10,3,17,"wolkig",14,"wolbecker"
"2/11/2016 5:00",34,34,3,17,"wolkig",68,"wolbecker"
"2/11/2016 6:00",106,152,3,20,"wolkig",258,"wolbecker"
"2/11/2016 7:00",489,259,3,17,"wolkig",748,"wolbecker"
"2/11/2016 8:00",485,201,4,17,"teilweise bewölkt",686,"wolbecker"
"2/11/2016 9:00",474,169,4,17,"teilweise bewölkt",643,"wolbecker"
"2/11/2016 10:00",332,168,5,20,"teilweise bewölkt",500,"wolbecker"
"2/11/2016 11:00",302,256,6,19,"teilweise bewölkt",558,"wolbecker"
"2/11/2016 12:00",318,310,6,26,"teilweise bewölkt",628,"wolbecker"
"2/11/2016 13:00",327,345,6,28,"teilweise bewölkt",672,"wolbecker"
"2/11/2016 14:00",327,365,7,24,"teilweise bewölkt",692,"wolbecker"
"2/11/2016 15:00",335,416,7,24,"teilweise bewölkt",751,"wolbecker"
"2/11/2016 16:00",385,480,6,15,"teilweise bewölkt",865,"wolbecker"
"2/11/2016 17:00",414,500,6,9,"wolkig",914,"wolbecker"
"2/11/2016 18:00",326,464,4,7,"wolkig",790,"wolbecker"
"2/11/2016 19:00",276,374,4,7,"wolkig",650,"wolbecker"
"2/11/2016 20:00",176,214,4,7,"wolkig",390,"wolbecker"
"2/11/2016 21:00",126,163,3,6,"wolkig",289,"wolbecker"
"2/11/2016 22:00",132,108,2,4,"wolkig",240,"wolbecker"
"2/11/2016 23:00",72,80,4,6,"wolkig",152,"wolbecker"
"2/12/2016 0:00",44,35,3,4,"wolkig",79,"wolbecker"
"2/12/2016 1:00",13,8,3,7,"wolkig",21,"wolbecker"
"2/12/2016 2:00",6,9,1,4,"teilweise bewölkt",15,"wolbecker"
"2/12/2016 3:00",4,9,2,6,"wolkig",13,"wolbecker"
"2/12/2016 4:00",5,4,2,6,"Nebel",9,"wolbecker"
"2/12/2016 5:00",24,35,1,4,"wolkig",59,"wolbecker"
"2/12/2016 6:00",108,135,1,4,"wolkig",243,"wolbecker"
"2/12/2016 7:00",514,246,1,4,"Nebel",760,"wolbecker"
"2/12/2016 8:00",460,203,2,6,"wolkig",663,"wolbecker"
"2/12/2016 9:00",403,178,2,6,"wolkig",581,"wolbecker"
"2/12/2016 10:00",320,169,3,6,"wolkig",489,"wolbecker"
"2/12/2016 11:00",302,219,4,15,"wolkig",521,"wolbecker"
"2/12/2016 12:00",301,314,5,9,"wolkig",615,"wolbecker"
"2/12/2016 13:00",387,407,6,11,"wolkig",794,"wolbecker"
"2/12/2016 14:00",406,413,6,11,"wolkig",819,"wolbecker"
"2/12/2016 15:00",385,429,6,7,"wolkig",814,"wolbecker"
"2/12/2016 16:00",361,462,5,6,"teilweise bewölkt",823,"wolbecker"
"2/12/2016 17:00",348,405,4,6,"wolkig",753,"wolbecker"
"2/12/2016 18:00",225,408,3,6,"teilweise bewölkt",633,"wolbecker"
"2/12/2016 19:00",231,317,2,7,"teilweise bewölkt",548,"wolbecker"
"2/12/2016 20:00",169,219,1,6,"Klarer Himmel",388,"wolbecker"
"2/12/2016 21:00",133,156,1,7,"Klarer Himmel",289,"wolbecker"
"2/12/2016 22:00",133,139,0,6,"Klarer Himmel",272,"wolbecker"
"2/12/2016 23:00",103,118,0,6,"Klarer Himmel",221,"wolbecker"
"2/13/2016 0:00",90,75,0,7,"Klarer Himmel",165,"wolbecker"
"2/13/2016 1:00",62,66,-1,4,"Klarer Himmel",128,"wolbecker"
"2/13/2016 2:00",50,29,-2,4,"Klarer Himmel",79,"wolbecker"
"2/13/2016 3:00",34,27,-1,6,"Klarer Himmel",61,"wolbecker"
"2/13/2016 4:00",27,10,-2,4,"Klarer Himmel",37,"wolbecker"
"2/13/2016 5:00",30,16,-2,6,"Nebel",46,"wolbecker"
"2/13/2016 6:00",30,24,-2,6,"Nebel",54,"wolbecker"
"2/13/2016 7:00",64,41,-2,6,"Klarer Himmel",105,"wolbecker"
"2/13/2016 8:00",124,87,-1,7,"Klarer Himmel",211,"wolbecker"
"2/13/2016 9:00",259,107,1,9,"Klarer Himmel",366,"wolbecker"
"2/13/2016 10:00",353,176,4,7,"Klarer Himmel",529,"wolbecker"
"2/13/2016 11:00",320,247,4,11,"Klarer Himmel",567,"wolbecker"
"2/13/2016 12:00",389,299,5,9,"Klarer Himmel",688,"wolbecker"
"2/13/2016 13:00",392,323,7,13,"Klarer Himmel",715,"wolbecker"
"2/13/2016 14:00",295,347,7,15,"Klarer Himmel",642,"wolbecker"
"2/13/2016 15:00",254,359,6,13,"Klarer Himmel",613,"wolbecker"
"2/13/2016 16:00",236,315,6,9,"Klarer Himmel",551,"wolbecker"
"2/13/2016 17:00",214,299,5,7,"Klarer Himmel",513,"wolbecker"
"2/13/2016 18:00",193,281,5,6,"wolkig",474,"wolbecker"
"2/13/2016 19:00",161,251,5,9,"wolkig",412,"wolbecker"
"2/13/2016 20:00",133,174,4,9,"wolkig",307,"wolbecker"
"2/13/2016 21:00",111,91,4,9,"Regen",202,"wolbecker"
"2/13/2016 22:00",111,60,4,9,"Regen",171,"wolbecker"
"2/13/2016 23:00",65,90,3,9,"Schnee",155,"wolbecker"
"2/14/2016 0:00",73,76,3,9,"Schnee",149,"wolbecker"
"2/14/2016 1:00",44,76,2,11,"Schnee",120,"wolbecker"
"2/14/2016 2:00",37,34,2,13,"Schnee",71,"wolbecker"
"2/14/2016 3:00",33,28,2,15,"Schnee",61,"wolbecker"
"2/14/2016 4:00",16,14,2,15,"Schnee",30,"wolbecker"
"2/14/2016 5:00",19,14,1,11,"Schnee",33,"wolbecker"
"2/14/2016 6:00",21,16,2,9,"Schnee",37,"wolbecker"
"2/14/2016 7:00",8,14,2,13,"Schnee",22,"wolbecker"
"2/14/2016 8:00",24,21,2,13,"Schnee",45,"wolbecker"
"2/14/2016 9:00",96,47,2,17,"Schnee",143,"wolbecker"
"2/14/2016 10:00",79,65,2,15,"Schnee",144,"wolbecker"
"2/14/2016 11:00",58,77,2,17,"Schnee",135,"wolbecker"
"2/14/2016 12:00",99,91,2,13,"Schnee",190,"wolbecker"
"2/14/2016 13:00",134,87,2,13,"Regen",221,"wolbecker"
"2/14/2016 14:00",117,108,2,6,"Schnee",225,"wolbecker"
"2/14/2016 15:00",126,93,1,7,"Regen",219,"wolbecker"
"2/14/2016 16:00",107,104,0,4,"Schnee",211,"wolbecker"
"2/14/2016 17:00",144,119,0,6,"Schnee",263,"wolbecker"
"2/14/2016 18:00",114,112,0,6,"Schnee",226,"wolbecker"
"2/14/2016 19:00",111,80,0,6,"Schnee",191,"wolbecker"
"2/14/2016 20:00",77,80,0,6,"Schnee",157,"wolbecker"
"2/14/2016 21:00",59,64,1,7,"Schnee",123,"wolbecker"
"2/14/2016 22:00",65,61,0,11,"Schnee",126,"wolbecker"
"2/14/2016 23:00",28,16,1,11,"Schnee",44,"wolbecker"
"2/15/2016 0:00",10,10,1,9,"Schnee",20,"wolbecker"
"2/15/2016 1:00",3,5,1,9,"Schnee",8,"wolbecker"
"2/15/2016 2:00",2,0,1,17,"Schnee",2,"wolbecker"
"2/15/2016 3:00",1,3,1,17,"Schnee",4,"wolbecker"
"2/15/2016 4:00",5,6,1,17,"Schnee",11,"wolbecker"
"2/15/2016 5:00",25,29,1,17,"Schnee",54,"wolbecker"
"2/15/2016 6:00",95,99,0,19,"Schnee",194,"wolbecker"
"2/15/2016 7:00",451,228,0,19,"Schnee",679,"wolbecker"
"2/15/2016 8:00",381,179,1,19,"Schnee",560,"wolbecker"
"2/15/2016 9:00",282,104,1,19,"Schnee",386,"wolbecker"
"2/15/2016 10:00",189,95,1,22,"wolkig",284,"wolbecker"
"2/15/2016 11:00",216,148,1,20,"wolkig",364,"wolbecker"
"2/15/2016 12:00",219,210,1,19,"wolkig",429,"wolbecker"
"2/15/2016 13:00",237,209,1,22,"wolkig",446,"wolbecker"
"2/15/2016 14:00",241,237,1,22,"wolkig",478,"wolbecker"
"2/15/2016 15:00",258,297,1,20,"wolkig",555,"wolbecker"
"2/15/2016 16:00",291,363,1,15,"wolkig",654,"wolbecker"
"2/15/2016 17:00",341,376,0,7,"teilweise bewölkt",717,"wolbecker"
"2/15/2016 18:00",262,404,0,15,"teilweise bewölkt",666,"wolbecker"
"2/15/2016 19:00",222,297,0,11,"wolkig",519,"wolbecker"
"2/15/2016 20:00",144,179,-1,6,"teilweise bewölkt",323,"wolbecker"
"2/15/2016 21:00",107,89,-2,2,"wolkig",196,"wolbecker"
"2/15/2016 22:00",79,95,-2,4,"wolkig",174,"wolbecker"
"2/15/2016 23:00",64,63,-3,2,"wolkig",127,"wolbecker"
"2/16/2016 0:00",25,15,-3,6,"wolkig",40,"wolbecker"
"2/16/2016 1:00",25,13,-2,2,"wolkig",38,"wolbecker"
"2/16/2016 2:00",3,5,-3,4,"teilweise bewölkt",8,"wolbecker"
"2/16/2016 3:00",3,6,-3,2,"wolkig",9,"wolbecker"
"2/16/2016 4:00",6,6,-5,2,"Nebel",12,"wolbecker"
"2/16/2016 5:00",28,33,-5,2,"Nebel",61,"wolbecker"
"2/16/2016 6:00",122,146,-5,2,"Nebel",268,"wolbecker"
"2/16/2016 7:00",502,282,-6,2,"Nebel",784,"wolbecker"
"2/16/2016 8:00",485,230,-4,2,"Nebel",715,"wolbecker"
"2/16/2016 9:00",376,145,-2,2,NA,521,"wolbecker"
"2/16/2016 10:00",267,158,1,2,"Klarer Himmel",425,"wolbecker"
"2/16/2016 11:00",229,191,2,4,"teilweise bewölkt",420,"wolbecker"
"2/16/2016 12:00",286,250,2,9,"teilweise bewölkt",536,"wolbecker"
"2/16/2016 13:00",269,312,4,4,"teilweise bewölkt",581,"wolbecker"
"2/16/2016 14:00",334,340,3,7,"Klarer Himmel",674,"wolbecker"
"2/16/2016 15:00",312,352,3,6,"Klarer Himmel",664,"wolbecker"
"2/16/2016 16:00",350,421,2,7,"Klarer Himmel",771,"wolbecker"
"2/16/2016 17:00",388,491,1,6,NA,879,"wolbecker"
"2/16/2016 18:00",343,419,0,6,"Klarer Himmel",762,"wolbecker"
"2/16/2016 19:00",279,393,-1,6,"Klarer Himmel",672,"wolbecker"
"2/16/2016 20:00",127,207,-1,6,"Klarer Himmel",334,"wolbecker"
"2/16/2016 21:00",140,141,-2,6,"Klarer Himmel",281,"wolbecker"
"2/16/2016 22:00",157,104,-2,9,"Klarer Himmel",261,"wolbecker"
"2/16/2016 23:00",61,55,-2,7,"Klarer Himmel",116,"wolbecker"
"2/17/2016 0:00",36,22,-2,6,"Klarer Himmel",58,"wolbecker"
"2/17/2016 1:00",18,15,-3,4,"Klarer Himmel",33,"wolbecker"
"2/17/2016 2:00",4,7,-3,4,"Klarer Himmel",11,"wolbecker"
"2/17/2016 3:00",3,6,-4,6,"Klarer Himmel",9,"wolbecker"
"2/17/2016 4:00",8,6,-4,11,"Klarer Himmel",14,"wolbecker"
"2/17/2016 5:00",37,30,-3,7,"Klarer Himmel",67,"wolbecker"
"2/17/2016 6:00",108,138,-3,11,"Klarer Himmel",246,"wolbecker"
"2/17/2016 7:00",536,273,-3,4,"Klarer Himmel",809,"wolbecker"
"2/17/2016 8:00",468,222,-2,7,"Klarer Himmel",690,"wolbecker"
"2/17/2016 9:00",379,153,0,9,"Klarer Himmel",532,"wolbecker"
"2/17/2016 10:00",316,185,1,13,"Klarer Himmel",501,"wolbecker"
"2/17/2016 11:00",265,202,2,15,"teilweise bewölkt",467,"wolbecker"
"2/17/2016 12:00",302,282,3,11,"teilweise bewölkt",584,"wolbecker"
"2/17/2016 13:00",268,323,2,9,"wolkig",591,"wolbecker"
"2/17/2016 14:00",269,306,3,9,"teilweise bewölkt",575,"wolbecker"
"2/17/2016 15:00",293,359,3,11,"wolkig",652,"wolbecker"
"2/17/2016 16:00",341,424,2,9,"teilweise bewölkt",765,"wolbecker"
"2/17/2016 17:00",433,466,1,4,"teilweise bewölkt",899,"wolbecker"
"2/17/2016 18:00",303,440,-1,2,"teilweise bewölkt",743,"wolbecker"
"2/17/2016 19:00",238,327,-2,4,"teilweise bewölkt",565,"wolbecker"
"2/17/2016 20:00",164,237,-3,0,"Klarer Himmel",401,"wolbecker"
"2/17/2016 21:00",106,141,-3,0,"Nebel",247,"wolbecker"
"2/17/2016 22:00",153,125,-4,0,"Nebel",278,"wolbecker"
"2/17/2016 23:00",77,52,-3,4,"Nebel",129,"wolbecker"
"2/18/2016 0:00",39,28,-4,0,"Nebel",67,"wolbecker"
"2/18/2016 1:00",18,13,-2,6,NA,31,"wolbecker"
"2/18/2016 2:00",7,19,-2,2,"wolkig",26,"wolbecker"
"2/18/2016 3:00",3,14,-1,4,"wolkig",17,"wolbecker"
"2/18/2016 4:00",6,13,-1,4,"wolkig",19,"wolbecker"
"2/18/2016 5:00",29,34,-1,2,"wolkig",63,"wolbecker"
"2/18/2016 6:00",129,133,0,7,"Schnee",262,"wolbecker"
"2/18/2016 7:00",510,266,0,7,"Schnee",776,"wolbecker"
"2/18/2016 8:00",473,243,1,9,"Schnee",716,"wolbecker"
"2/18/2016 9:00",358,146,1,7,"wolkig",504,"wolbecker"
"2/18/2016 10:00",251,136,2,6,"wolkig",387,"wolbecker"
"2/18/2016 11:00",256,200,3,15,"Klarer Himmel",456,"wolbecker"
"2/18/2016 12:00",278,276,4,11,"wolkig",554,"wolbecker"
"2/18/2016 13:00",278,310,4,17,"wolkig",588,"wolbecker"
"2/18/2016 14:00",277,313,5,19,"wolkig",590,"wolbecker"
"2/18/2016 15:00",312,375,5,11,"wolkig",687,"wolbecker"
"2/18/2016 16:00",342,443,4,9,"wolkig",785,"wolbecker"
"2/18/2016 17:00",427,444,2,2,"Klarer Himmel",871,"wolbecker"
"2/18/2016 18:00",360,405,0,2,"Klarer Himmel",765,"wolbecker"
"2/18/2016 19:00",244,329,0,4,"wolkig",573,"wolbecker"
"2/18/2016 20:00",130,202,0,4,"wolkig",332,"wolbecker"
"2/18/2016 21:00",117,160,0,2,"wolkig",277,"wolbecker"
"2/18/2016 22:00",126,123,0,6,"wolkig",249,"wolbecker"
"2/18/2016 23:00",82,79,0,2,"wolkig",161,"wolbecker"
"2/19/2016 0:00",33,27,0,2,"Klarer Himmel",60,"wolbecker"
"2/19/2016 1:00",7,11,0,2,"wolkig",18,"wolbecker"
"2/19/2016 2:00",7,6,0,2,"wolkig",13,"wolbecker"
"2/19/2016 3:00",3,8,0,6,"Klarer Himmel",11,"wolbecker"
"2/19/2016 4:00",6,5,0,2,"Klarer Himmel",11,"wolbecker"
"2/19/2016 5:00",33,37,0,2,"wolkig",70,"wolbecker"
"2/19/2016 6:00",100,135,0,4,"wolkig",235,"wolbecker"
"2/19/2016 7:00",520,232,1,4,"Schnee",752,"wolbecker"
"2/19/2016 8:00",434,207,1,6,"Schnee",641,"wolbecker"
"2/19/2016 9:00",319,130,2,9,NA,449,"wolbecker"
"2/19/2016 10:00",284,163,2,9,"wolkig",447,"wolbecker"
"2/19/2016 11:00",257,193,3,11,"wolkig",450,"wolbecker"
"2/19/2016 12:00",284,301,3,19,"Regen",585,"wolbecker"
"2/19/2016 13:00",312,414,3,13,"Regen",726,"wolbecker"
"2/19/2016 14:00",320,363,3,9,"wolkig",683,"wolbecker"
"2/19/2016 15:00",302,372,3,13,"wolkig",674,"wolbecker"
"2/19/2016 16:00",297,343,3,9,"wolkig",640,"wolbecker"
"2/19/2016 17:00",301,353,3,7,"wolkig",654,"wolbecker"
"2/19/2016 18:00",259,352,1,6,NA,611,"wolbecker"
"2/19/2016 19:00",179,305,2,11,NA,484,"wolbecker"
"2/19/2016 20:00",146,186,1,13,NA,332,"wolbecker"
"2/19/2016 21:00",109,123,1,13,NA,232,"wolbecker"
"2/19/2016 22:00",104,111,1,13,"Klarer Himmel",215,"wolbecker"
"2/19/2016 23:00",96,76,2,15,"Klarer Himmel",172,"wolbecker"
"2/20/2016 0:00",76,82,2,17,"Klarer Himmel",158,"wolbecker"
"2/20/2016 1:00",71,61,3,20,"Klarer Himmel",132,"wolbecker"
"2/20/2016 2:00",34,28,4,20,"Klarer Himmel",62,"wolbecker"
"2/20/2016 3:00",28,31,4,22,"Regen",59,"wolbecker"
"2/20/2016 4:00",20,15,4,26,"Regen",35,"wolbecker"
"2/20/2016 5:00",34,19,5,30,"wolkig",53,"wolbecker"
"2/20/2016 6:00",17,15,4,26,"Regen",32,"wolbecker"
"2/20/2016 7:00",58,41,4,24,"Regen",99,"wolbecker"
"2/20/2016 8:00",122,66,5,24,"Regen",188,"wolbecker"
"2/20/2016 9:00",174,73,5,22,"Regen",247,"wolbecker"
"2/20/2016 10:00",181,108,6,20,"Regen",289,"wolbecker"
"2/20/2016 11:00",197,127,7,24,"Regen",324,"wolbecker"
"2/20/2016 12:00",192,170,8,22,"wolkig",362,"wolbecker"
"2/20/2016 13:00",186,203,8,22,"wolkig",389,"wolbecker"
"2/20/2016 14:00",176,197,9,28,"wolkig",373,"wolbecker"
"2/20/2016 15:00",181,181,9,24,"wolkig",362,"wolbecker"
"2/20/2016 16:00",137,187,9,24,"Regen",324,"wolbecker"
"2/20/2016 17:00",108,178,8,30,"Regen",286,"wolbecker"
"2/20/2016 18:00",131,185,7,19,"Regen",316,"wolbecker"
"2/20/2016 19:00",120,141,8,20,"wolkig",261,"wolbecker"
"2/20/2016 20:00",103,113,7,15,"Regen",216,"wolbecker"
"2/20/2016 21:00",71,82,9,28,"Regen",153,"wolbecker"
"2/20/2016 22:00",77,69,9,30,"Regen",146,"wolbecker"
"2/20/2016 23:00",55,43,10,35,"Regen",98,"wolbecker"
"2/21/2016 0:00",61,49,10,39,"Regen",110,"wolbecker"
"2/21/2016 1:00",57,53,10,30,"Regen",110,"wolbecker"
"2/21/2016 2:00",37,37,8,26,"Regen",74,"wolbecker"
"2/21/2016 3:00",26,31,8,24,"Regen",57,"wolbecker"
"2/21/2016 4:00",32,20,8,24,"Regen",52,"wolbecker"
"2/21/2016 5:00",23,4,8,20,"wolkig",27,"wolbecker"
"2/21/2016 6:00",13,12,8,28,"wolkig",25,"wolbecker"
"2/21/2016 7:00",13,18,8,19,"Regen",31,"wolbecker"
"2/21/2016 8:00",24,23,8,17,"Regen",47,"wolbecker"
"2/21/2016 9:00",48,38,8,11,"Regen",86,"wolbecker"
"2/21/2016 10:00",63,57,8,11,"Regen",120,"wolbecker"
"2/21/2016 11:00",64,56,11,30,"Regen",120,"wolbecker"
"2/21/2016 12:00",73,76,11,32,"Regen",149,"wolbecker"
"2/21/2016 13:00",86,79,11,37,"Regen",165,"wolbecker"
"2/21/2016 14:00",108,93,11,37,"Regen",201,"wolbecker"
"2/21/2016 15:00",98,75,11,37,"Regen",173,"wolbecker"
"2/21/2016 16:00",112,77,11,30,"Regen",189,"wolbecker"
"2/21/2016 17:00",115,105,12,39,"wolkig",220,"wolbecker"
"2/21/2016 18:00",85,112,12,35,"Regen",197,"wolbecker"
"2/21/2016 19:00",107,87,12,41,"Regen",194,"wolbecker"
"2/21/2016 20:00",92,66,11,33,"Regen",158,"wolbecker"
"2/21/2016 21:00",58,46,12,44,"Regen",104,"wolbecker"
"2/21/2016 22:00",68,37,11,44,"Regen",105,"wolbecker"
"2/21/2016 23:00",32,18,11,41,"Regen",50,"wolbecker"
"2/22/2016 0:00",15,8,11,43,"Regen",23,"wolbecker"
"2/22/2016 1:00",8,6,11,43,"wolkig",14,"wolbecker"
"2/22/2016 2:00",1,1,10,39,"Regen",2,"wolbecker"
"2/22/2016 3:00",1,4,10,41,"Regen",5,"wolbecker"
"2/22/2016 4:00",4,8,10,28,"Regen",12,"wolbecker"
"2/22/2016 5:00",32,32,10,26,"Regen",64,"wolbecker"
"2/22/2016 6:00",99,112,9,30,"Regen",211,"wolbecker"
"2/22/2016 7:00",395,221,9,20,"Regen",616,"wolbecker"
"2/22/2016 8:00",327,168,7,7,"Regen",495,"wolbecker"
"2/22/2016 9:00",275,104,7,11,"Regen",379,"wolbecker"
"2/22/2016 10:00",166,116,6,17,"Regen",282,"wolbecker"
"2/22/2016 11:00",139,137,6,13,"Regen",276,"wolbecker"
"2/22/2016 12:00",164,165,6,13,"Regen",329,"wolbecker"
"2/22/2016 13:00",193,193,6,17,"Regen",386,"wolbecker"
"2/22/2016 14:00",206,171,5,19,"Regen",377,"wolbecker"
"2/22/2016 15:00",166,222,5,26,"Regen",388,"wolbecker"
"2/22/2016 16:00",239,309,5,15,"wolkig",548,"wolbecker"
"2/22/2016 17:00",298,338,5,15,"Regen",636,"wolbecker"
"2/22/2016 18:00",253,329,5,17,"Regen",582,"wolbecker"
"2/22/2016 19:00",202,230,5,17,"Regen",432,"wolbecker"
"2/22/2016 20:00",117,157,4,19,"wolkig",274,"wolbecker"
"2/22/2016 21:00",87,120,4,15,"wolkig",207,"wolbecker"
"2/22/2016 22:00",100,98,4,17,"wolkig",198,"wolbecker"
"2/22/2016 23:00",42,34,4,15,"wolkig",76,"wolbecker"
"2/23/2016 0:00",23,22,4,15,"wolkig",45,"wolbecker"
"2/23/2016 1:00",11,9,4,15,"wolkig",20,"wolbecker"
"2/23/2016 2:00",4,5,4,15,"wolkig",9,"wolbecker"
"2/23/2016 3:00",3,4,4,15,"wolkig",7,"wolbecker"
"2/23/2016 4:00",6,10,4,9,"wolkig",16,"wolbecker"
"2/23/2016 5:00",33,34,3,11,"wolkig",67,"wolbecker"
"2/23/2016 6:00",125,171,3,11,"wolkig",296,"wolbecker"
"2/23/2016 7:00",502,305,3,11,"teilweise bewölkt",807,"wolbecker"
"2/23/2016 8:00",467,215,4,7,"teilweise bewölkt",682,"wolbecker"
"2/23/2016 9:00",411,167,5,19,"teilweise bewölkt",578,"wolbecker"
"2/23/2016 10:00",249,203,6,17,"teilweise bewölkt",452,"wolbecker"
"2/23/2016 11:00",272,190,6,20,"teilweise bewölkt",462,"wolbecker"
"2/23/2016 12:00",298,293,8,20,"teilweise bewölkt",591,"wolbecker"
"2/23/2016 13:00",304,331,8,22,"wolkig",635,"wolbecker"
"2/23/2016 14:00",316,272,7,19,"Regen",588,"wolbecker"
"2/23/2016 15:00",296,330,6,13,"wolkig",626,"wolbecker"
"2/23/2016 16:00",368,418,6,20,"teilweise bewölkt",786,"wolbecker"
"2/23/2016 17:00",426,499,5,17,"teilweise bewölkt",925,"wolbecker"
"2/23/2016 18:00",348,451,4,17,"teilweise bewölkt",799,"wolbecker"
"2/23/2016 19:00",271,325,4,17,"wolkig",596,"wolbecker"
"2/23/2016 20:00",146,212,4,15,"wolkig",358,"wolbecker"
"2/23/2016 21:00",121,146,3,15,"teilweise bewölkt",267,"wolbecker"
"2/23/2016 22:00",108,145,2,13,"teilweise bewölkt",253,"wolbecker"
"2/23/2016 23:00",50,54,2,15,"teilweise bewölkt",104,"wolbecker"
"2/24/2016 0:00",27,30,1,13,"Klarer Himmel",57,"wolbecker"
"2/24/2016 1:00",12,10,1,13,"Klarer Himmel",22,"wolbecker"
"2/24/2016 2:00",5,4,1,13,"Klarer Himmel",9,"wolbecker"
"2/24/2016 3:00",4,6,1,9,"teilweise bewölkt",10,"wolbecker"
"2/24/2016 4:00",4,18,1,13,"teilweise bewölkt",22,"wolbecker"
"2/24/2016 5:00",39,41,0,7,"wolkig",80,"wolbecker"
"2/24/2016 6:00",139,148,0,9,NA,287,"wolbecker"
"2/24/2016 7:00",525,307,0,9,"Nebel",832,"wolbecker"
"2/24/2016 8:00",517,222,1,9,NA,739,"wolbecker"
"2/24/2016 9:00",366,184,3,13,"Klarer Himmel",550,"wolbecker"
"2/24/2016 10:00",339,183,4,17,"teilweise bewölkt",522,"wolbecker"
"2/24/2016 11:00",316,224,5,19,"teilweise bewölkt",540,"wolbecker"
"2/24/2016 12:00",329,271,7,19,"teilweise bewölkt",600,"wolbecker"
"2/24/2016 13:00",319,375,7,19,"teilweise bewölkt",694,"wolbecker"
"2/24/2016 14:00",293,336,5,15,"Klarer Himmel",629,"wolbecker"
"2/24/2016 15:00",319,366,6,20,"Klarer Himmel",685,"wolbecker"
"2/24/2016 16:00",324,442,5,9,"Klarer Himmel",766,"wolbecker"
"2/24/2016 17:00",434,435,4,9,"Klarer Himmel",869,"wolbecker"
"2/24/2016 18:00",334,407,3,6,"Klarer Himmel",741,"wolbecker"
"2/24/2016 19:00",252,380,4,6,"wolkig",632,"wolbecker"
"2/24/2016 20:00",151,204,2,6,"wolkig",355,"wolbecker"
"2/24/2016 21:00",124,169,2,7,"wolkig",293,"wolbecker"
"2/24/2016 22:00",148,143,2,7,"Klarer Himmel",291,"wolbecker"
"2/24/2016 23:00",91,69,1,6,"Klarer Himmel",160,"wolbecker"
"2/25/2016 0:00",38,41,0,7,"Klarer Himmel",79,"wolbecker"
"2/25/2016 1:00",20,37,0,7,"Klarer Himmel",57,"wolbecker"
"2/25/2016 2:00",21,9,0,9,"Klarer Himmel",30,"wolbecker"
"2/25/2016 3:00",25,9,-1,4,"Klarer Himmel",34,"wolbecker"
"2/25/2016 4:00",27,15,-2,4,"Nebel",42,"wolbecker"
"2/25/2016 5:00",40,51,-2,4,"Nebel",91,"wolbecker"
"2/25/2016 6:00",129,155,-1,9,"Nebel",284,"wolbecker"
"2/25/2016 7:00",520,285,-1,7,"Nebel",805,"wolbecker"
"2/25/2016 8:00",484,241,0,9,"teilweise bewölkt",725,"wolbecker"
"2/25/2016 9:00",403,152,2,15,"teilweise bewölkt",555,"wolbecker"
"2/25/2016 10:00",244,156,3,17,"teilweise bewölkt",400,"wolbecker"
"2/25/2016 11:00",254,197,5,22,"teilweise bewölkt",451,"wolbecker"
"2/25/2016 12:00",263,284,5,24,"teilweise bewölkt",547,"wolbecker"
"2/25/2016 13:00",301,332,4,26,"teilweise bewölkt",633,"wolbecker"
"2/25/2016 14:00",332,318,6,19,"teilweise bewölkt",650,"wolbecker"
"2/25/2016 15:00",290,389,4,19,"Regen",679,"wolbecker"
"2/25/2016 16:00",350,405,3,19,"teilweise bewölkt",755,"wolbecker"
"2/25/2016 17:00",396,431,2,13,"Regen",827,"wolbecker"
"2/25/2016 18:00",320,394,2,15,"teilweise bewölkt",714,"wolbecker"
"2/25/2016 19:00",230,297,1,11,"Klarer Himmel",527,"wolbecker"
"2/25/2016 20:00",154,185,1,11,"Klarer Himmel",339,"wolbecker"
"2/25/2016 21:00",89,142,0,9,"Klarer Himmel",231,"wolbecker"
"2/25/2016 22:00",100,122,0,7,"teilweise bewölkt",222,"wolbecker"
"2/25/2016 23:00",61,76,0,9,"wolkig",137,"wolbecker"
"2/26/2016 0:00",30,23,0,9,"teilweise bewölkt",53,"wolbecker"
"2/26/2016 1:00",21,12,0,9,"Nebel",33,"wolbecker"
"2/26/2016 2:00",6,7,-1,9,"Nebel",13,"wolbecker"
"2/26/2016 3:00",2,9,-1,7,"Nebel",11,"wolbecker"
"2/26/2016 4:00",7,10,-1,7,"teilweise bewölkt",17,"wolbecker"
"2/26/2016 5:00",33,41,-1,9,"Nebel",74,"wolbecker"
"2/26/2016 6:00",109,133,-1,9,"wolkig",242,"wolbecker"
"2/26/2016 7:00",504,253,-1,9,"wolkig",757,"wolbecker"
"2/26/2016 8:00",428,193,-1,7,"wolkig",621,"wolbecker"
"2/26/2016 9:00",359,133,0,6,"wolkig",492,"wolbecker"
"2/26/2016 10:00",248,147,0,7,"wolkig",395,"wolbecker"
"2/26/2016 11:00",266,208,1,9,"wolkig",474,"wolbecker"
"2/26/2016 12:00",295,326,2,7,"wolkig",621,"wolbecker"
"2/26/2016 13:00",329,380,3,7,"teilweise bewölkt",709,"wolbecker"
"2/26/2016 14:00",351,403,4,4,"teilweise bewölkt",754,"wolbecker"
"2/26/2016 15:00",355,392,4,2,"wolkig",747,"wolbecker"
"2/26/2016 16:00",306,391,4,4,"wolkig",697,"wolbecker"
"2/26/2016 17:00",319,363,3,6,"Klarer Himmel",682,"wolbecker"
"2/26/2016 18:00",262,335,2,4,"Klarer Himmel",597,"wolbecker"
"2/26/2016 19:00",225,264,1,4,"Klarer Himmel",489,"wolbecker"
"2/26/2016 20:00",160,148,1,4,"Klarer Himmel",308,"wolbecker"
"2/26/2016 21:00",100,147,1,4,"Klarer Himmel",247,"wolbecker"
"2/26/2016 22:00",117,108,1,4,"Klarer Himmel",225,"wolbecker"
"2/26/2016 23:00",85,102,0,6,"wolkig",187,"wolbecker"
"2/27/2016 0:00",60,77,-1,4,NA,137,"wolbecker"
"2/27/2016 1:00",37,60,-1,4,NA,97,"wolbecker"
"2/27/2016 2:00",37,31,0,4,"Klarer Himmel",68,"wolbecker"
"2/27/2016 3:00",33,22,-1,6,"Klarer Himmel",55,"wolbecker"
"2/27/2016 4:00",30,9,-1,6,"Klarer Himmel",39,"wolbecker"
"2/27/2016 5:00",27,12,-1,6,"Klarer Himmel",39,"wolbecker"
"2/27/2016 6:00",26,22,-1,4,"Klarer Himmel",48,"wolbecker"
"2/27/2016 7:00",60,44,-2,6,"Klarer Himmel",104,"wolbecker"
"2/27/2016 8:00",108,75,0,7,"Klarer Himmel",183,"wolbecker"
"2/27/2016 9:00",282,129,2,11,"Klarer Himmel",411,"wolbecker"
"2/27/2016 10:00",328,181,4,13,"Klarer Himmel",509,"wolbecker"
"2/27/2016 11:00",386,186,4,17,"Klarer Himmel",572,"wolbecker"
"2/27/2016 12:00",400,292,5,22,"teilweise bewölkt",692,"wolbecker"
"2/27/2016 13:00",309,351,6,22,"teilweise bewölkt",660,"wolbecker"
"2/27/2016 14:00",302,354,5,22,"teilweise bewölkt",656,"wolbecker"
"2/27/2016 15:00",255,331,5,20,"teilweise bewölkt",586,"wolbecker"
"2/27/2016 16:00",222,285,5,15,"teilweise bewölkt",507,"wolbecker"
"2/27/2016 17:00",173,262,4,15,"teilweise bewölkt",435,"wolbecker"
"2/27/2016 18:00",187,273,1,9,"Klarer Himmel",460,"wolbecker"
"2/27/2016 19:00",184,215,0,9,"Klarer Himmel",399,"wolbecker"
"2/27/2016 20:00",123,147,0,11,"Klarer Himmel",270,"wolbecker"
"2/27/2016 21:00",104,102,1,13,"Klarer Himmel",206,"wolbecker"
"2/27/2016 22:00",88,94,0,11,"Klarer Himmel",182,"wolbecker"
"2/27/2016 23:00",79,96,0,15,"Klarer Himmel",175,"wolbecker"
"2/28/2016 0:00",109,98,0,11,"Klarer Himmel",207,"wolbecker"
"2/28/2016 1:00",62,92,-2,9,"Klarer Himmel",154,"wolbecker"
"2/28/2016 2:00",53,36,-2,11,"Klarer Himmel",89,"wolbecker"
"2/28/2016 3:00",39,29,-2,9,"Klarer Himmel",68,"wolbecker"
"2/28/2016 4:00",27,15,-3,9,"Klarer Himmel",42,"wolbecker"
"2/28/2016 5:00",35,16,-3,11,"Klarer Himmel",51,"wolbecker"
"2/28/2016 6:00",18,15,-3,7,"Klarer Himmel",33,"wolbecker"
"2/28/2016 7:00",27,22,-2,9,"Klarer Himmel",49,"wolbecker"
"2/28/2016 8:00",29,29,0,13,"Klarer Himmel",58,"wolbecker"
"2/28/2016 9:00",96,63,1,17,"Klarer Himmel",159,"wolbecker"
"2/28/2016 10:00",115,98,3,20,"Klarer Himmel",213,"wolbecker"
"2/28/2016 11:00",114,91,4,20,"Klarer Himmel",205,"wolbecker"
"2/28/2016 12:00",143,127,5,28,"Klarer Himmel",270,"wolbecker"
"2/28/2016 13:00",168,142,6,19,"teilweise bewölkt",310,"wolbecker"
"2/28/2016 14:00",197,173,6,20,"Klarer Himmel",370,"wolbecker"
"2/28/2016 15:00",180,168,5,26,"Klarer Himmel",348,"wolbecker"
"2/28/2016 16:00",151,123,5,17,"Klarer Himmel",274,"wolbecker"
"2/28/2016 17:00",182,160,4,17,"Klarer Himmel",342,"wolbecker"
"2/28/2016 18:00",153,143,3,17,"Klarer Himmel",296,"wolbecker"
"2/28/2016 19:00",134,107,2,7,"Klarer Himmel",241,"wolbecker"
"2/28/2016 20:00",84,84,-1,7,"Klarer Himmel",168,"wolbecker"
"2/28/2016 21:00",91,62,1,15,"Klarer Himmel",153,"wolbecker"
"2/28/2016 22:00",79,47,0,7,"Klarer Himmel",126,"wolbecker"
"2/28/2016 23:00",27,33,-1,9,"Klarer Himmel",60,"wolbecker"
"2/29/2016 0:00",19,8,0,13,"Klarer Himmel",27,"wolbecker"
"2/29/2016 1:00",7,10,-1,11,"Klarer Himmel",17,"wolbecker"
"2/29/2016 2:00",1,3,-1,15,"Klarer Himmel",4,"wolbecker"
"2/29/2016 3:00",1,6,-2,11,"Klarer Himmel",7,"wolbecker"
"2/29/2016 4:00",6,12,-2,9,"Klarer Himmel",18,"wolbecker"
"2/29/2016 5:00",35,34,-2,11,"Klarer Himmel",69,"wolbecker"
"2/29/2016 6:00",133,152,-2,13,"Klarer Himmel",285,"wolbecker"
"2/29/2016 7:00",535,281,-2,13,"Klarer Himmel",816,"wolbecker"
"2/29/2016 8:00",497,233,0,15,"Klarer Himmel",730,"wolbecker"
"2/29/2016 9:00",402,155,1,19,"Klarer Himmel",557,"wolbecker"
"2/29/2016 10:00",292,146,3,19,"Klarer Himmel",438,"wolbecker"
"2/29/2016 11:00",260,223,4,20,"Klarer Himmel",483,"wolbecker"
"2/29/2016 12:00",314,303,4,22,"Klarer Himmel",617,"wolbecker"
"2/29/2016 13:00",275,311,5,19,"teilweise bewölkt",586,"wolbecker"
"2/29/2016 14:00",329,326,5,19,"Klarer Himmel",655,"wolbecker"
"2/29/2016 15:00",334,390,5,20,"Klarer Himmel",724,"wolbecker"
"2/29/2016 16:00",331,451,4,20,"teilweise bewölkt",782,"wolbecker"
"2/29/2016 17:00",413,480,2,17,"Klarer Himmel",893,"wolbecker"
"2/29/2016 18:00",328,422,1,13,"Klarer Himmel",750,"wolbecker"
"2/29/2016 19:00",235,306,0,11,"Klarer Himmel",541,"wolbecker"
"2/29/2016 20:00",154,232,0,13,"Klarer Himmel",386,"wolbecker"
"2/29/2016 21:00",115,131,-1,7,"Klarer Himmel",246,"wolbecker"
"2/29/2016 22:00",110,109,-2,4,"Klarer Himmel",219,"wolbecker"
"2/29/2016 23:00",60,51,-3,2,NA,111,"wolbecker"
"3/1/2016 0:00",33,20,-3,0,NA,53,"wolbecker"
"3/1/2016 1:00",10,7,-4,4,NA,17,"wolbecker"
"3/1/2016 2:00",3,4,-5,2,NA,7,"wolbecker"
"3/1/2016 3:00",2,6,-5,2,"Nebel",8,"wolbecker"
"3/1/2016 4:00",7,10,-5,2,"Nebel",17,"wolbecker"
"3/1/2016 5:00",30,41,-6,2,"Nebel",71,"wolbecker"
"3/1/2016 6:00",136,159,-5,0,"Nebel",295,"wolbecker"
"3/1/2016 7:00",514,288,-5,4,"Nebel",802,"wolbecker"
"3/1/2016 8:00",515,216,-3,6,NA,731,"wolbecker"
"3/1/2016 9:00",394,154,-1,9,NA,548,"wolbecker"
"3/1/2016 10:00",274,174,1,13,NA,448,"wolbecker"
"3/1/2016 11:00",246,180,2,13,"Klarer Himmel",426,"wolbecker"
"3/1/2016 12:00",271,268,3,17,"Klarer Himmel",539,"wolbecker"
"3/1/2016 13:00",247,309,4,20,"wolkig",556,"wolbecker"
"3/1/2016 14:00",286,328,4,17,"wolkig",614,"wolbecker"
"3/1/2016 15:00",272,324,4,20,"Regen",596,"wolbecker"
"3/1/2016 16:00",354,423,3,20,"Regen",777,"wolbecker"
"3/1/2016 17:00",316,455,2,17,"Regen",771,"wolbecker"
"3/1/2016 18:00",301,379,2,17,"Regen",680,"wolbecker"
"3/1/2016 19:00",236,304,3,20,"Regen",540,"wolbecker"
"3/1/2016 20:00",127,146,3,19,"Regen",273,"wolbecker"
"3/1/2016 21:00",106,119,3,20,"Regen",225,"wolbecker"
"3/1/2016 22:00",123,87,4,22,"wolkig",210,"wolbecker"
"3/1/2016 23:00",50,52,5,24,"wolkig",102,"wolbecker"
"3/2/2016 0:00",36,19,5,20,"wolkig",55,"wolbecker"
"3/2/2016 1:00",11,17,5,17,"wolkig",28,"wolbecker"
"3/2/2016 2:00",4,8,5,15,"Regen",12,"wolbecker"
"3/2/2016 3:00",5,5,6,20,"Regen",10,"wolbecker"
"3/2/2016 4:00",3,6,6,19,"Regen",9,"wolbecker"
"3/2/2016 5:00",34,28,7,20,"wolkig",62,"wolbecker"
"3/2/2016 6:00",118,137,7,24,"wolkig",255,"wolbecker"
"3/2/2016 7:00",545,316,7,22,"wolkig",861,"wolbecker"
"3/2/2016 8:00",488,229,7,28,"wolkig",717,"wolbecker"
"3/2/2016 9:00",376,139,7,20,"Regen",515,"wolbecker"
"3/2/2016 10:00",220,139,4,28,"Regen",359,"wolbecker"
"3/2/2016 11:00",184,147,5,28,"wolkig",331,"wolbecker"
"3/2/2016 12:00",256,227,6,28,"wolkig",483,"wolbecker"
"3/2/2016 13:00",279,308,7,30,"teilweise bewölkt",587,"wolbecker"
"3/2/2016 14:00",251,307,6,28,"teilweise bewölkt",558,"wolbecker"
"3/2/2016 15:00",322,324,7,20,"teilweise bewölkt",646,"wolbecker"
"3/2/2016 16:00",278,413,6,13,"wolkig",691,"wolbecker"
"3/2/2016 17:00",352,416,6,11,"wolkig",768,"wolbecker"
"3/2/2016 18:00",294,382,6,11,"wolkig",676,"wolbecker"
"3/2/2016 19:00",240,301,5,11,"wolkig",541,"wolbecker"
"3/2/2016 20:00",135,174,5,19,"Regen",309,"wolbecker"
"3/2/2016 21:00",115,99,4,15,"teilweise bewölkt",214,"wolbecker"
"3/2/2016 22:00",116,131,4,17,"wolkig",247,"wolbecker"
"3/2/2016 23:00",42,67,4,22,"wolkig",109,"wolbecker"
"3/3/2016 0:00",41,30,4,20,"wolkig",71,"wolbecker"
"3/3/2016 1:00",16,30,4,20,"Regen",46,"wolbecker"
"3/3/2016 2:00",10,18,3,20,"Regen",28,"wolbecker"
"3/3/2016 3:00",15,13,3,19,"Regen",28,"wolbecker"
"3/3/2016 4:00",10,9,3,19,"Regen",19,"wolbecker"
"3/3/2016 5:00",36,35,3,19,"Regen",71,"wolbecker"
"3/3/2016 6:00",114,153,3,19,"wolkig",267,"wolbecker"
"3/3/2016 7:00",505,271,3,19,"wolkig",776,"wolbecker"
"3/3/2016 8:00",489,203,3,17,"wolkig",692,"wolbecker"
"3/3/2016 9:00",374,157,4,22,"wolkig",531,"wolbecker"
"3/3/2016 10:00",269,155,5,19,"wolkig",424,"wolbecker"
"3/3/2016 11:00",255,191,5,19,"wolkig",446,"wolbecker"
"3/3/2016 12:00",257,264,6,24,"wolkig",521,"wolbecker"
"3/3/2016 13:00",281,307,5,24,"wolkig",588,"wolbecker"
"3/3/2016 14:00",308,311,2,20,"Regen",619,"wolbecker"
"3/3/2016 15:00",307,354,5,17,"wolkig",661,"wolbecker"
"3/3/2016 16:00",360,427,2,17,"Regen",787,"wolbecker"
"3/3/2016 17:00",366,465,4,13,"teilweise bewölkt",831,"wolbecker"
"3/3/2016 18:00",307,425,3,11,"teilweise bewölkt",732,"wolbecker"
"3/3/2016 19:00",242,341,2,7,"teilweise bewölkt",583,"wolbecker"
"3/3/2016 20:00",158,220,1,6,"Klarer Himmel",378,"wolbecker"
"3/3/2016 21:00",108,163,1,4,"Nebel",271,"wolbecker"
"3/3/2016 22:00",144,108,0,4,"Nebel",252,"wolbecker"
"3/3/2016 23:00",86,72,-2,7,"Nebel",158,"wolbecker"
"3/4/2016 0:00",50,62,-2,6,"Nebel",112,"wolbecker"
"3/4/2016 1:00",17,35,0,9,"Nebel",52,"wolbecker"
"3/4/2016 2:00",9,8,0,9,"Klarer Himmel",17,"wolbecker"
"3/4/2016 3:00",17,9,0,9,"Klarer Himmel",26,"wolbecker"
"3/4/2016 4:00",28,11,0,11,"Klarer Himmel",39,"wolbecker"
"3/4/2016 5:00",50,30,0,11,NA,80,"wolbecker"
"3/4/2016 6:00",115,136,0,11,NA,251,"wolbecker"
"3/4/2016 7:00",518,257,0,9,NA,775,"wolbecker"
"3/4/2016 8:00",408,205,2,17,"wolkig",613,"wolbecker"
"3/4/2016 9:00",317,150,2,15,"wolkig",467,"wolbecker"
"3/4/2016 10:00",284,156,3,17,"wolkig",440,"wolbecker"
"3/4/2016 11:00",209,233,4,15,"wolkig",442,"wolbecker"
"3/4/2016 12:00",268,291,4,20,"Regen",559,"wolbecker"
"3/4/2016 13:00",249,303,4,24,"Regen",552,"wolbecker"
"3/4/2016 14:00",232,291,2,26,"Regen",523,"wolbecker"
"3/4/2016 15:00",154,216,2,22,"Regen",370,"wolbecker"
"3/4/2016 16:00",156,240,1,15,"Regen",396,"wolbecker"
"3/4/2016 17:00",169,234,2,15,"Regen",403,"wolbecker"
"3/4/2016 18:00",182,249,3,11,"wolkig",431,"wolbecker"
"3/4/2016 19:00",155,180,3,11,"wolkig",335,"wolbecker"
"3/4/2016 20:00",144,154,3,9,"wolkig",298,"wolbecker"
"3/4/2016 21:00",76,109,3,7,"wolkig",185,"wolbecker"
"3/4/2016 22:00",70,73,3,7,"wolkig",143,"wolbecker"
"3/4/2016 23:00",63,62,3,7,"wolkig",125,"wolbecker"
"3/5/2016 0:00",47,53,3,6,"wolkig",100,"wolbecker"
"3/5/2016 1:00",53,67,3,2,"wolkig",120,"wolbecker"
"3/5/2016 2:00",29,38,2,2,"Nebel",67,"wolbecker"
"3/5/2016 3:00",24,21,0,2,"Nebel",45,"wolbecker"
"3/5/2016 4:00",33,12,2,2,"Nebel",45,"wolbecker"
"3/5/2016 5:00",17,13,2,6,"Nebel",30,"wolbecker"
"3/5/2016 6:00",19,18,2,4,"Nebel",37,"wolbecker"
"3/5/2016 7:00",68,52,2,4,"Nebel",120,"wolbecker"
"3/5/2016 8:00",85,68,2,6,"wolkig",153,"wolbecker"
"3/5/2016 9:00",215,102,2,11,"wolkig",317,"wolbecker"
"3/5/2016 10:00",291,151,3,9,"wolkig",442,"wolbecker"
"3/5/2016 11:00",279,209,4,7,"wolkig",488,"wolbecker"
"3/5/2016 12:00",278,253,5,7,"wolkig",531,"wolbecker"
"3/5/2016 13:00",277,281,5,6,"wolkig",558,"wolbecker"
"3/5/2016 14:00",239,274,5,9,"wolkig",513,"wolbecker"
"3/5/2016 15:00",201,240,6,7,"wolkig",441,"wolbecker"
"3/5/2016 16:00",200,242,5,7,"wolkig",442,"wolbecker"
"3/5/2016 17:00",187,259,5,6,"wolkig",446,"wolbecker"
"3/5/2016 18:00",171,223,4,0,"Klarer Himmel",394,"wolbecker"
"3/5/2016 19:00",124,145,4,2,NA,269,"wolbecker"
"3/5/2016 20:00",122,132,3,2,NA,254,"wolbecker"
"3/5/2016 21:00",88,104,1,4,NA,192,"wolbecker"
"3/5/2016 22:00",98,65,0,2,"Nebel",163,"wolbecker"
"3/5/2016 23:00",92,72,0,0,"Nebel",164,"wolbecker"
"3/6/2016 0:00",78,80,-2,0,"Nebel",158,"wolbecker"
"3/6/2016 1:00",65,61,-2,4,"Nebel",126,"wolbecker"
"3/6/2016 2:00",47,34,-2,4,"Nebel",81,"wolbecker"
"3/6/2016 3:00",31,35,-3,2,"Nebel",66,"wolbecker"
"3/6/2016 4:00",21,22,-2,0,"Nebel",43,"wolbecker"
"3/6/2016 5:00",19,10,-3,2,"Nebel",29,"wolbecker"
"3/6/2016 6:00",17,14,-3,2,"Nebel",31,"wolbecker"
"3/6/2016 7:00",20,23,-3,4,"Nebel",43,"wolbecker"
"3/6/2016 8:00",42,34,-1,2,"Nebel",76,"wolbecker"
"3/6/2016 9:00",90,44,2,2,"Nebel",134,"wolbecker"
"3/6/2016 10:00",102,83,4,4,NA,185,"wolbecker"
"3/6/2016 11:00",101,123,5,4,"teilweise bewölkt",224,"wolbecker"
"3/6/2016 12:00",129,129,6,7,"teilweise bewölkt",258,"wolbecker"
"3/6/2016 13:00",145,131,6,2,"teilweise bewölkt",276,"wolbecker"
"3/6/2016 14:00",160,130,6,4,"teilweise bewölkt",290,"wolbecker"
"3/6/2016 15:00",178,123,7,6,"teilweise bewölkt",301,"wolbecker"
"3/6/2016 16:00",148,155,5,7,"wolkig",303,"wolbecker"
"3/6/2016 17:00",172,159,3,6,"wolkig",331,"wolbecker"
"3/6/2016 18:00",150,168,3,7,"wolkig",318,"wolbecker"
"3/6/2016 19:00",134,114,3,7,"wolkig",248,"wolbecker"
"3/6/2016 20:00",98,73,1,4,"wolkig",171,"wolbecker"
"3/6/2016 21:00",93,55,1,6,"wolkig",148,"wolbecker"
"3/6/2016 22:00",91,52,2,9,"wolkig",143,"wolbecker"
"3/6/2016 23:00",28,24,2,13,"Regen",52,"wolbecker"
"3/7/2016 0:00",22,8,2,11,"teilweise bewölkt",30,"wolbecker"
"3/7/2016 1:00",6,5,1,6,"teilweise bewölkt",11,"wolbecker"
"3/7/2016 2:00",11,2,1,6,"Nebel",13,"wolbecker"
"3/7/2016 3:00",5,2,1,7,"Nebel",7,"wolbecker"
"3/7/2016 4:00",5,8,1,6,"wolkig",13,"wolbecker"
"3/7/2016 5:00",33,27,1,7,"Schnee",60,"wolbecker"
"3/7/2016 6:00",136,138,1,6,"wolkig",274,"wolbecker"
"3/7/2016 7:00",525,281,2,6,"wolkig",806,"wolbecker"
"3/7/2016 8:00",403,239,2,7,"Regen",642,"wolbecker"
"3/7/2016 9:00",323,144,2,9,"wolkig",467,"wolbecker"
"3/7/2016 10:00",272,160,3,6,"wolkig",432,"wolbecker"
"3/7/2016 11:00",248,175,3,7,"wolkig",423,"wolbecker"
"3/7/2016 12:00",258,258,3,9,"wolkig",516,"wolbecker"
"3/7/2016 13:00",246,282,4,7,"wolkig",528,"wolbecker"
"3/7/2016 14:00",273,265,4,6,"wolkig",538,"wolbecker"
"3/7/2016 15:00",313,330,5,11,"teilweise bewölkt",643,"wolbecker"
"3/7/2016 16:00",346,417,5,6,"teilweise bewölkt",763,"wolbecker"
"3/7/2016 17:00",429,439,5,6,"teilweise bewölkt",868,"wolbecker"
"3/7/2016 18:00",345,447,2,2,"teilweise bewölkt",792,"wolbecker"
"3/7/2016 19:00",263,329,0,2,"Klarer Himmel",592,"wolbecker"
"3/7/2016 20:00",155,174,0,4,"Klarer Himmel",329,"wolbecker"
"3/7/2016 21:00",108,155,-1,2,"Klarer Himmel",263,"wolbecker"
"3/7/2016 22:00",90,93,-2,2,"Nebel",183,"wolbecker"
"3/7/2016 23:00",35,41,-2,2,"Nebel",76,"wolbecker"
"3/8/2016 0:00",26,28,-3,0,"Nebel",54,"wolbecker"
"3/8/2016 1:00",11,11,-3,0,"Nebel",22,"wolbecker"
"3/8/2016 2:00",6,3,-3,2,"Nebel",9,"wolbecker"
"3/8/2016 3:00",1,3,-4,2,"Nebel",4,"wolbecker"
"3/8/2016 4:00",5,10,-4,4,"Nebel",15,"wolbecker"
"3/8/2016 5:00",42,39,-4,0,"Nebel",81,"wolbecker"
"3/8/2016 6:00",134,164,-4,0,"Nebel",298,"wolbecker"
"3/8/2016 7:00",532,314,-2,4,"teilweise bewölkt",846,"wolbecker"
"3/8/2016 8:00",495,236,-1,4,"Nebel",731,"wolbecker"
"3/8/2016 9:00",376,171,0,7,"wolkig",547,"wolbecker"
"3/8/2016 10:00",281,163,2,7,"Regen",444,"wolbecker"
"3/8/2016 11:00",217,195,4,11,"wolkig",412,"wolbecker"
"3/8/2016 12:00",273,262,5,17,"wolkig",535,"wolbecker"
"3/8/2016 13:00",272,294,5,15,"teilweise bewölkt",566,"wolbecker"
"3/8/2016 14:00",298,315,6,19,"teilweise bewölkt",613,"wolbecker"
"3/8/2016 15:00",330,399,6,20,"wolkig",729,"wolbecker"
"3/8/2016 16:00",378,478,5,15,"wolkig",856,"wolbecker"
"3/8/2016 17:00",375,508,5,11,"wolkig",883,"wolbecker"
"3/8/2016 18:00",372,430,4,11,NA,802,"wolbecker"
"3/8/2016 19:00",275,353,3,9,"wolkig",628,"wolbecker"
"3/8/2016 20:00",148,185,3,11,"wolkig",333,"wolbecker"
"3/8/2016 21:00",106,124,3,13,"Klarer Himmel",230,"wolbecker"
"3/8/2016 22:00",156,102,2,13,"Klarer Himmel",258,"wolbecker"
"3/8/2016 23:00",62,42,2,11,"Klarer Himmel",104,"wolbecker"
"3/9/2016 0:00",26,23,1,9,"Klarer Himmel",49,"wolbecker"
"3/9/2016 1:00",15,9,1,9,"Klarer Himmel",24,"wolbecker"
"3/9/2016 2:00",6,2,0,11,"Klarer Himmel",8,"wolbecker"
"3/9/2016 3:00",6,8,0,11,"Klarer Himmel",14,"wolbecker"
"3/9/2016 4:00",3,9,0,9,"Klarer Himmel",12,"wolbecker"
"3/9/2016 5:00",41,42,-1,9,"Klarer Himmel",83,"wolbecker"
"3/9/2016 6:00",136,170,-1,9,"Klarer Himmel",306,"wolbecker"
"3/9/2016 7:00",580,309,0,7,"Klarer Himmel",889,"wolbecker"
"3/9/2016 8:00",530,274,1,15,"Klarer Himmel",804,"wolbecker"
"3/9/2016 9:00",393,175,3,15,"Klarer Himmel",568,"wolbecker"
"3/9/2016 10:00",335,170,5,24,"Klarer Himmel",505,"wolbecker"
"3/9/2016 11:00",302,201,6,22,"Klarer Himmel",503,"wolbecker"
"3/9/2016 12:00",319,317,7,22,"Klarer Himmel",636,"wolbecker"
"3/9/2016 13:00",320,343,7,24,"Klarer Himmel",663,"wolbecker"
"3/9/2016 14:00",292,360,7,20,"Klarer Himmel",652,"wolbecker"
"3/9/2016 15:00",291,377,7,22,"Klarer Himmel",668,"wolbecker"
"3/9/2016 16:00",368,458,8,15,"Klarer Himmel",826,"wolbecker"
"3/9/2016 17:00",430,505,7,11,"Klarer Himmel",935,"wolbecker"
"3/9/2016 18:00",373,468,7,9,"Klarer Himmel",841,"wolbecker"
"3/9/2016 19:00",280,346,6,7,"Klarer Himmel",626,"wolbecker"
"3/9/2016 20:00",174,198,5,4,"Klarer Himmel",372,"wolbecker"
"3/9/2016 21:00",119,149,4,6,"Klarer Himmel",268,"wolbecker"
"3/9/2016 22:00",128,145,4,6,"Klarer Himmel",273,"wolbecker"
"3/9/2016 23:00",69,61,3,6,"Klarer Himmel",130,"wolbecker"
"3/10/2016 0:00",51,35,2,6,"Klarer Himmel",86,"wolbecker"
"3/10/2016 1:00",10,30,3,7,"Klarer Himmel",40,"wolbecker"
"3/10/2016 2:00",8,17,3,6,"Klarer Himmel",25,"wolbecker"
"3/10/2016 3:00",16,6,0,9,"Klarer Himmel",22,"wolbecker"
"3/10/2016 4:00",8,8,1,9,NA,16,"wolbecker"
"3/10/2016 5:00",40,45,0,9,NA,85,"wolbecker"
"3/10/2016 6:00",139,160,-1,7,NA,299,"wolbecker"
"3/10/2016 7:00",529,303,0,7,NA,832,"wolbecker"
"3/10/2016 8:00",497,214,2,11,NA,711,"wolbecker"
"3/10/2016 9:00",374,167,3,17,NA,541,"wolbecker"
"3/10/2016 10:00",245,185,5,13,"Klarer Himmel",430,"wolbecker"
"3/10/2016 11:00",286,214,6,13,"wolkig",500,"wolbecker"
"3/10/2016 12:00",302,260,6,15,"wolkig",562,"wolbecker"
"3/10/2016 13:00",309,342,7,13,"wolkig",651,"wolbecker"
"3/10/2016 14:00",276,323,6,15,"wolkig",599,"wolbecker"
"3/10/2016 15:00",331,387,7,13,"wolkig",718,"wolbecker"
"3/10/2016 16:00",366,497,7,11,"wolkig",863,"wolbecker"
"3/10/2016 17:00",429,458,7,7,"wolkig",887,"wolbecker"
"3/10/2016 18:00",352,421,6,9,"wolkig",773,"wolbecker"
"3/10/2016 19:00",247,323,5,9,"wolkig",570,"wolbecker"
"3/10/2016 20:00",157,188,5,6,"wolkig",345,"wolbecker"
"3/10/2016 21:00",118,130,5,4,"wolkig",248,"wolbecker"
"3/10/2016 22:00",145,119,6,9,"wolkig",264,"wolbecker"
"3/10/2016 23:00",61,77,5,11,"wolkig",138,"wolbecker"
"3/11/2016 0:00",27,23,4,9,"wolkig",50,"wolbecker"
"3/11/2016 1:00",6,16,2,9,"teilweise bewölkt",22,"wolbecker"
"3/11/2016 2:00",7,9,1,6,"Nebel",16,"wolbecker"
"3/11/2016 3:00",4,11,1,7,"Nebel",15,"wolbecker"
"3/11/2016 4:00",5,5,2,6,"wolkig",10,"wolbecker"
"3/11/2016 5:00",36,29,3,9,"wolkig",65,"wolbecker"
"3/11/2016 6:00",142,152,3,9,"wolkig",294,"wolbecker"
"3/11/2016 7:00",536,288,3,6,"wolkig",824,"wolbecker"
"3/11/2016 8:00",471,196,4,9,"wolkig",667,"wolbecker"
"3/11/2016 9:00",337,163,3,15,"wolkig",500,"wolbecker"
"3/11/2016 10:00",262,148,3,11,"wolkig",410,"wolbecker"
"3/11/2016 11:00",276,244,4,15,"wolkig",520,"wolbecker"
"3/11/2016 12:00",291,317,4,13,"wolkig",608,"wolbecker"
"3/11/2016 13:00",322,380,4,11,"wolkig",702,"wolbecker"
"3/11/2016 14:00",354,366,4,11,"wolkig",720,"wolbecker"
"3/11/2016 15:00",349,386,4,11,"wolkig",735,"wolbecker"
"3/11/2016 16:00",322,369,5,15,"wolkig",691,"wolbecker"
"3/11/2016 17:00",321,395,4,11,"wolkig",716,"wolbecker"
"3/11/2016 18:00",270,362,3,9,"teilweise bewölkt",632,"wolbecker"
"3/11/2016 19:00",257,285,2,6,"Klarer Himmel",542,"wolbecker"
"3/11/2016 20:00",180,182,2,7,"Klarer Himmel",362,"wolbecker"
"3/11/2016 21:00",118,147,2,4,"teilweise bewölkt",265,"wolbecker"
"3/11/2016 22:00",119,110,1,4,"Klarer Himmel",229,"wolbecker"
"3/11/2016 23:00",76,86,-1,4,"Klarer Himmel",162,"wolbecker"
"3/12/2016 0:00",81,87,0,4,"Klarer Himmel",168,"wolbecker"
"3/12/2016 1:00",60,69,-1,6,NA,129,"wolbecker"
"3/12/2016 2:00",41,35,0,6,NA,76,"wolbecker"
"3/12/2016 3:00",39,15,0,4,NA,54,"wolbecker"
"3/12/2016 4:00",24,15,-2,6,NA,39,"wolbecker"
"3/12/2016 5:00",36,16,-2,2,"Nebel",52,"wolbecker"
"3/12/2016 6:00",29,28,-2,2,"Nebel",57,"wolbecker"
"3/12/2016 7:00",55,68,-2,4,"Nebel",123,"wolbecker"
"3/12/2016 8:00",145,88,2,6,"wolkig",233,"wolbecker"
"3/12/2016 9:00",279,134,4,11,"wolkig",413,"wolbecker"
"3/12/2016 10:00",334,163,4,6,"wolkig",497,"wolbecker"
"3/12/2016 11:00",330,219,4,7,"wolkig",549,"wolbecker"
"3/12/2016 12:00",330,276,5,9,"wolkig",606,"wolbecker"
"3/12/2016 13:00",319,283,5,11,"wolkig",602,"wolbecker"
"3/12/2016 14:00",265,320,6,11,"wolkig",585,"wolbecker"
"3/12/2016 15:00",221,288,6,7,"wolkig",509,"wolbecker"
"3/12/2016 16:00",186,282,5,13,"teilweise bewölkt",468,"wolbecker"
"3/12/2016 17:00",183,271,5,11,"teilweise bewölkt",454,"wolbecker"
"3/12/2016 18:00",168,258,4,9,"teilweise bewölkt",426,"wolbecker"
"3/12/2016 19:00",185,216,3,7,"teilweise bewölkt",401,"wolbecker"
"3/12/2016 20:00",148,133,2,7,"Klarer Himmel",281,"wolbecker"
"3/12/2016 21:00",98,99,1,7,"wolkig",197,"wolbecker"
"3/12/2016 22:00",115,111,2,7,"teilweise bewölkt",226,"wolbecker"
"3/12/2016 23:00",87,89,2,9,"teilweise bewölkt",176,"wolbecker"
"3/13/2016 0:00",67,93,2,6,"wolkig",160,"wolbecker"
"3/13/2016 1:00",69,68,2,7,"wolkig",137,"wolbecker"
"3/13/2016 2:00",56,60,3,7,"wolkig",116,"wolbecker"
"3/13/2016 3:00",36,26,3,6,"wolkig",62,"wolbecker"
"3/13/2016 4:00",43,20,3,6,"wolkig",63,"wolbecker"
"3/13/2016 5:00",32,10,3,9,"wolkig",42,"wolbecker"
"3/13/2016 6:00",17,20,3,9,"wolkig",37,"wolbecker"
"3/13/2016 7:00",22,25,3,13,"wolkig",47,"wolbecker"
"3/13/2016 8:00",50,37,4,17,"wolkig",87,"wolbecker"
"3/13/2016 9:00",77,68,4,13,"wolkig",145,"wolbecker"
"3/13/2016 10:00",117,87,4,11,"wolkig",204,"wolbecker"
"3/13/2016 11:00",102,88,4,13,"wolkig",190,"wolbecker"
"3/13/2016 12:00",123,133,5,13,"wolkig",256,"wolbecker"
"3/13/2016 13:00",159,139,5,24,"teilweise bewölkt",298,"wolbecker"
"3/13/2016 14:00",185,161,5,19,"wolkig",346,"wolbecker"
"3/13/2016 15:00",209,125,5,11,"teilweise bewölkt",334,"wolbecker"
"3/13/2016 16:00",180,158,6,13,"Klarer Himmel",338,"wolbecker"
"3/13/2016 17:00",151,197,6,9,"Klarer Himmel",348,"wolbecker"
"3/13/2016 18:00",168,148,4,6,"teilweise bewölkt",316,"wolbecker"
"3/13/2016 19:00",137,103,4,15,"teilweise bewölkt",240,"wolbecker"
"3/13/2016 20:00",96,94,2,15,"teilweise bewölkt",190,"wolbecker"
"3/13/2016 21:00",86,53,2,11,"wolkig",139,"wolbecker"
"3/13/2016 22:00",70,41,2,17,"wolkig",111,"wolbecker"
"3/13/2016 23:00",31,25,1,17,"wolkig",56,"wolbecker"
"3/14/2016 0:00",25,6,1,7,"wolkig",31,"wolbecker"
"3/14/2016 1:00",7,3,1,6,"wolkig",10,"wolbecker"
"3/14/2016 2:00",1,1,0,6,"Klarer Himmel",2,"wolbecker"
"3/14/2016 3:00",2,4,-1,6,"Klarer Himmel",6,"wolbecker"
"3/14/2016 4:00",8,3,-1,6,"Klarer Himmel",11,"wolbecker"
"3/14/2016 5:00",28,37,-1,7,NA,65,"wolbecker"
"3/14/2016 6:00",142,161,-1,7,NA,303,"wolbecker"
"3/14/2016 7:00",564,264,-1,9,NA,828,"wolbecker"
"3/14/2016 8:00",507,243,1,7,"Klarer Himmel",750,"wolbecker"
"3/14/2016 9:00",392,169,3,11,"Klarer Himmel",561,"wolbecker"
"3/14/2016 10:00",300,159,4,13,"Klarer Himmel",459,"wolbecker"
"3/14/2016 11:00",288,207,6,11,"Klarer Himmel",495,"wolbecker"
"3/14/2016 12:00",267,258,7,15,"Klarer Himmel",525,"wolbecker"
"3/14/2016 13:00",311,314,8,17,"Klarer Himmel",625,"wolbecker"
"3/14/2016 14:00",318,284,9,17,"Klarer Himmel",602,"wolbecker"
"3/14/2016 15:00",315,363,9,20,"Klarer Himmel",678,"wolbecker"
"3/14/2016 16:00",393,481,9,20,"Klarer Himmel",874,"wolbecker"
"3/14/2016 17:00",412,499,8,15,"Klarer Himmel",911,"wolbecker"
"3/14/2016 18:00",305,444,6,13,"Klarer Himmel",749,"wolbecker"
"3/14/2016 19:00",234,351,5,7,"Klarer Himmel",585,"wolbecker"
"3/14/2016 20:00",140,192,4,2,"Klarer Himmel",332,"wolbecker"
"3/14/2016 21:00",127,134,3,0,"Klarer Himmel",261,"wolbecker"
"3/14/2016 22:00",88,89,1,2,"Klarer Himmel",177,"wolbecker"
"3/14/2016 23:00",59,52,1,4,"Klarer Himmel",111,"wolbecker"
"3/15/2016 0:00",26,21,0,2,"Klarer Himmel",47,"wolbecker"
"3/15/2016 1:00",12,15,1,4,"Klarer Himmel",27,"wolbecker"
"3/15/2016 2:00",4,4,-1,4,NA,8,"wolbecker"
"3/15/2016 3:00",4,5,-1,2,"wolkig",9,"wolbecker"
"3/15/2016 4:00",10,3,-1,7,"wolkig",13,"wolbecker"
"3/15/2016 5:00",39,38,2,4,"wolkig",77,"wolbecker"
"3/15/2016 6:00",142,177,2,4,"Nebel",319,"wolbecker"
"3/15/2016 7:00",543,300,2,2,"Regen",843,"wolbecker"
"3/15/2016 8:00",527,239,4,6,"Regen",766,"wolbecker"
"3/15/2016 9:00",374,172,4,13,"wolkig",546,"wolbecker"
"3/15/2016 10:00",309,162,5,11,"wolkig",471,"wolbecker"
"3/15/2016 11:00",257,184,6,11,"wolkig",441,"wolbecker"
"3/15/2016 12:00",245,255,6,11,"wolkig",500,"wolbecker"
"3/15/2016 13:00",271,300,6,11,"wolkig",571,"wolbecker"
"3/15/2016 14:00",294,309,7,15,"wolkig",603,"wolbecker"
"3/15/2016 15:00",324,359,8,19,"wolkig",683,"wolbecker"
"3/15/2016 16:00",353,449,7,13,"Regen",802,"wolbecker"
"3/15/2016 17:00",413,503,7,15,"wolkig",916,"wolbecker"
"3/15/2016 18:00",373,474,7,17,"teilweise bewölkt",847,"wolbecker"
"3/15/2016 19:00",252,341,5,17,"teilweise bewölkt",593,"wolbecker"
"3/15/2016 20:00",147,234,5,13,"teilweise bewölkt",381,"wolbecker"
"3/15/2016 21:00",118,134,5,17,"Klarer Himmel",252,"wolbecker"
"3/15/2016 22:00",119,100,4,11,"Klarer Himmel",219,"wolbecker"
"3/15/2016 23:00",51,48,3,11,"Klarer Himmel",99,"wolbecker"
"3/16/2016 0:00",24,23,2,9,"Klarer Himmel",47,"wolbecker"
"3/16/2016 1:00",16,6,1,7,"Klarer Himmel",22,"wolbecker"
"3/16/2016 2:00",5,7,2,9,"wolkig",12,"wolbecker"
"3/16/2016 3:00",7,5,3,11,"wolkig",12,"wolbecker"
"3/16/2016 4:00",8,6,3,15,"wolkig",14,"wolbecker"
"3/16/2016 5:00",39,35,3,11,"wolkig",74,"wolbecker"
"3/16/2016 6:00",140,182,3,17,"wolkig",322,"wolbecker"
"3/16/2016 7:00",548,313,3,13,"wolkig",861,"wolbecker"
"3/16/2016 8:00",529,260,4,20,"teilweise bewölkt",789,"wolbecker"
"3/16/2016 9:00",422,157,5,15,"teilweise bewölkt",579,"wolbecker"
"3/16/2016 10:00",344,225,6,15,"wolkig",569,"wolbecker"
"3/16/2016 11:00",296,227,6,19,"wolkig",523,"wolbecker"
"3/16/2016 12:00",322,304,7,19,"wolkig",626,"wolbecker"
"3/16/2016 13:00",315,339,7,19,"wolkig",654,"wolbecker"
"3/16/2016 14:00",272,338,8,19,"teilweise bewölkt",610,"wolbecker"
"3/16/2016 15:00",299,351,8,22,"teilweise bewölkt",650,"wolbecker"
"3/16/2016 16:00",325,482,8,17,"teilweise bewölkt",807,"wolbecker"
"3/16/2016 17:00",441,467,8,15,"teilweise bewölkt",908,"wolbecker"
"3/16/2016 18:00",350,455,6,9,"teilweise bewölkt",805,"wolbecker"
"3/16/2016 19:00",275,350,6,6,"Klarer Himmel",625,"wolbecker"
"3/16/2016 20:00",177,204,6,7,"Klarer Himmel",381,"wolbecker"
"3/16/2016 21:00",128,148,5,7,"Klarer Himmel",276,"wolbecker"
"3/16/2016 22:00",107,110,4,7,"Klarer Himmel",217,"wolbecker"
"3/16/2016 23:00",88,97,3,4,"Klarer Himmel",185,"wolbecker"
"3/17/2016 0:00",42,40,2,6,"Klarer Himmel",82,"wolbecker"
"3/17/2016 1:00",14,27,1,2,"Klarer Himmel",41,"wolbecker"
"3/17/2016 2:00",16,18,2,6,"Klarer Himmel",34,"wolbecker"
"3/17/2016 3:00",10,15,1,7,"Klarer Himmel",25,"wolbecker"
"3/17/2016 4:00",15,12,0,4,"Klarer Himmel",27,"wolbecker"
"3/17/2016 5:00",38,33,0,6,"Klarer Himmel",71,"wolbecker"
"3/17/2016 6:00",128,168,0,7,"Klarer Himmel",296,"wolbecker"
"3/17/2016 7:00",491,306,1,6,"Klarer Himmel",797,"wolbecker"
"3/17/2016 8:00",592,247,4,9,"Klarer Himmel",839,"wolbecker"
"3/17/2016 9:00",403,191,7,13,"Klarer Himmel",594,"wolbecker"
"3/17/2016 10:00",326,161,9,15,"Klarer Himmel",487,"wolbecker"
"3/17/2016 11:00",278,184,10,17,"Klarer Himmel",462,"wolbecker"
"3/17/2016 12:00",295,265,10,11,"Klarer Himmel",560,"wolbecker"
"3/17/2016 13:00",340,343,11,15,"Klarer Himmel",683,"wolbecker"
"3/17/2016 14:00",324,348,11,15,"Klarer Himmel",672,"wolbecker"
"3/17/2016 15:00",364,436,12,11,"Klarer Himmel",800,"wolbecker"
"3/17/2016 16:00",426,483,12,11,"Klarer Himmel",909,"wolbecker"
"3/17/2016 17:00",460,516,11,11,"Klarer Himmel",976,"wolbecker"
"3/17/2016 18:00",348,512,8,6,"Klarer Himmel",860,"wolbecker"
"3/17/2016 19:00",310,329,6,2,"Klarer Himmel",639,"wolbecker"
"3/17/2016 20:00",182,207,3,2,"Klarer Himmel",389,"wolbecker"
"3/17/2016 21:00",131,142,3,2,"Klarer Himmel",273,"wolbecker"
"3/17/2016 22:00",123,145,1,6,"Klarer Himmel",268,"wolbecker"
"3/17/2016 23:00",79,76,2,2,"Klarer Himmel",155,"wolbecker"
"3/18/2016 0:00",32,34,1,6,NA,66,"wolbecker"
"3/18/2016 1:00",17,27,1,6,NA,44,"wolbecker"
"3/18/2016 2:00",9,28,1,13,"Nebel",37,"wolbecker"
"3/18/2016 3:00",4,4,1,11,"Nebel",8,"wolbecker"
"3/18/2016 4:00",8,14,1,7,"wolkig",22,"wolbecker"
"3/18/2016 5:00",44,33,1,13,"wolkig",77,"wolbecker"
"3/18/2016 6:00",122,134,1,7,"wolkig",256,"wolbecker"
"3/18/2016 7:00",468,275,2,11,"Regen",743,"wolbecker"
"3/18/2016 8:00",488,227,3,11,"Regen",715,"wolbecker"
"3/18/2016 9:00",351,148,4,13,"wolkig",499,"wolbecker"
"3/18/2016 10:00",245,178,4,13,"Regen",423,"wolbecker"
"3/18/2016 11:00",292,227,5,11,"wolkig",519,"wolbecker"
"3/18/2016 12:00",288,351,5,13,"wolkig",639,"wolbecker"
"3/18/2016 13:00",315,393,6,13,"wolkig",708,"wolbecker"
"3/18/2016 14:00",288,364,6,15,"wolkig",652,"wolbecker"
"3/18/2016 15:00",315,378,6,13,"wolkig",693,"wolbecker"
"3/18/2016 16:00",345,401,6,15,"wolkig",746,"wolbecker"
"3/18/2016 17:00",345,390,6,13,"wolkig",735,"wolbecker"
"3/18/2016 18:00",256,379,5,9,"wolkig",635,"wolbecker"
"3/18/2016 19:00",183,269,5,11,"Regen",452,"wolbecker"
"3/18/2016 20:00",180,195,5,9,"wolkig",375,"wolbecker"
"3/18/2016 21:00",123,125,5,6,"wolkig",248,"wolbecker"
"3/18/2016 22:00",103,120,5,7,"wolkig",223,"wolbecker"
"3/18/2016 23:00",88,96,5,7,"wolkig",184,"wolbecker"
"3/19/2016 0:00",57,67,5,9,"wolkig",124,"wolbecker"
"3/19/2016 1:00",51,63,5,6,"wolkig",114,"wolbecker"
"3/19/2016 2:00",30,28,5,7,"wolkig",58,"wolbecker"
"3/19/2016 3:00",23,18,5,9,"wolkig",41,"wolbecker"
"3/19/2016 4:00",31,11,5,2,"wolkig",42,"wolbecker"
"3/19/2016 5:00",40,19,5,6,"wolkig",59,"wolbecker"
"3/19/2016 6:00",32,26,5,7,"wolkig",58,"wolbecker"
"3/19/2016 7:00",72,41,5,7,"wolkig",113,"wolbecker"
"3/19/2016 8:00",130,76,5,9,"wolkig",206,"wolbecker"
"3/19/2016 9:00",244,104,5,9,"wolkig",348,"wolbecker"
"3/19/2016 10:00",323,164,5,9,"wolkig",487,"wolbecker"
"3/19/2016 11:00",369,220,5,9,"wolkig",589,"wolbecker"
"3/19/2016 12:00",294,274,5,13,"wolkig",568,"wolbecker"
"3/19/2016 13:00",291,276,5,7,"wolkig",567,"wolbecker"
"3/19/2016 14:00",229,327,6,7,"wolkig",556,"wolbecker"
"3/19/2016 15:00",247,278,6,9,"wolkig",525,"wolbecker"
"3/19/2016 16:00",182,263,7,9,"wolkig",445,"wolbecker"
"3/19/2016 17:00",186,249,7,7,"wolkig",435,"wolbecker"
"3/19/2016 18:00",174,234,6,11,"wolkig",408,"wolbecker"
"3/19/2016 19:00",162,181,6,9,"wolkig",343,"wolbecker"
"3/19/2016 20:00",110,128,6,11,"wolkig",238,"wolbecker"
"3/19/2016 21:00",86,96,6,11,"wolkig",182,"wolbecker"
"3/19/2016 22:00",84,82,5,7,"wolkig",166,"wolbecker"
"3/19/2016 23:00",58,71,5,7,"wolkig",129,"wolbecker"
"3/20/2016 0:00",64,104,5,9,"wolkig",168,"wolbecker"
"3/20/2016 1:00",75,96,5,11,"Regen",171,"wolbecker"
"3/20/2016 2:00",51,36,5,11,"Regen",87,"wolbecker"
"3/20/2016 3:00",31,31,4,11,"Regen",62,"wolbecker"
"3/20/2016 4:00",45,17,4,11,"Regen",62,"wolbecker"
"3/20/2016 5:00",31,12,4,9,"Regen",43,"wolbecker"
"3/20/2016 6:00",15,8,4,9,"wolkig",23,"wolbecker"
"3/20/2016 7:00",17,24,4,13,"wolkig",41,"wolbecker"
"3/20/2016 8:00",33,28,5,13,"wolkig",61,"wolbecker"
"3/20/2016 9:00",61,52,6,13,"wolkig",113,"wolbecker"
"3/20/2016 10:00",118,74,6,15,"Regen",192,"wolbecker"
"3/20/2016 11:00",117,98,7,20,"wolkig",215,"wolbecker"
"3/20/2016 12:00",138,135,7,19,"Regen",273,"wolbecker"
"3/20/2016 13:00",151,162,7,19,"wolkig",313,"wolbecker"
"3/20/2016 14:00",167,163,7,17,"Regen",330,"wolbecker"
"3/20/2016 15:00",180,154,7,17,"Regen",334,"wolbecker"
"3/20/2016 16:00",145,147,7,17,"Regen",292,"wolbecker"
"3/20/2016 17:00",159,147,7,11,"wolkig",306,"wolbecker"
"3/20/2016 18:00",146,122,7,13,"wolkig",268,"wolbecker"
"3/20/2016 19:00",91,130,7,9,"wolkig",221,"wolbecker"
"3/20/2016 20:00",95,81,7,9,"wolkig",176,"wolbecker"
"3/20/2016 21:00",67,49,7,9,"wolkig",116,"wolbecker"
"3/20/2016 22:00",77,39,7,9,"wolkig",116,"wolbecker"
"3/20/2016 23:00",63,26,6,15,"wolkig",89,"wolbecker"
"3/21/2016 0:00",15,16,6,13,"Regen",31,"wolbecker"
"3/21/2016 1:00",8,2,6,13,"wolkig",10,"wolbecker"
"3/21/2016 2:00",2,0,6,11,"Regen",2,"wolbecker"
"3/21/2016 3:00",3,2,6,13,"wolkig",5,"wolbecker"
"3/21/2016 4:00",7,9,6,11,"wolkig",16,"wolbecker"
"3/21/2016 5:00",33,29,5,9,"Regen",62,"wolbecker"
"3/21/2016 6:00",112,102,5,7,"Regen",214,"wolbecker"
"3/21/2016 7:00",328,177,6,15,"Regen",505,"wolbecker"
"3/21/2016 8:00",393,204,6,13,"Regen",597,"wolbecker"
"3/21/2016 9:00",334,123,7,19,"wolkig",457,"wolbecker"
"3/21/2016 10:00",258,136,7,13,"wolkig",394,"wolbecker"
"3/21/2016 11:00",258,171,9,19,"wolkig",429,"wolbecker"
"3/21/2016 12:00",245,224,9,19,"wolkig",469,"wolbecker"
"3/21/2016 13:00",233,242,9,20,"wolkig",475,"wolbecker"
"3/21/2016 14:00",247,263,8,22,"wolkig",510,"wolbecker"
"3/21/2016 15:00",301,297,8,24,"wolkig",598,"wolbecker"
"3/21/2016 16:00",290,436,8,22,"wolkig",726,"wolbecker"
"3/21/2016 17:00",366,430,8,20,"wolkig",796,"wolbecker"
"3/21/2016 18:00",285,392,7,9,"wolkig",677,"wolbecker"
"3/21/2016 19:00",207,280,7,20,"Regen",487,"wolbecker"
"3/21/2016 20:00",124,149,6,11,"wolkig",273,"wolbecker"
"3/21/2016 21:00",103,116,6,15,"wolkig",219,"wolbecker"
"3/21/2016 22:00",79,90,6,17,"wolkig",169,"wolbecker"
"3/21/2016 23:00",34,53,6,13,"wolkig",87,"wolbecker"
"3/22/2016 0:00",26,33,6,13,"wolkig",59,"wolbecker"
"3/22/2016 1:00",11,8,6,15,"wolkig",19,"wolbecker"
"3/22/2016 2:00",6,2,6,13,"Regen",8,"wolbecker"
"3/22/2016 3:00",5,4,5,13,"wolkig",9,"wolbecker"
"3/22/2016 4:00",4,5,5,15,"wolkig",9,"wolbecker"
"3/22/2016 5:00",36,36,5,13,"wolkig",72,"wolbecker"
"3/22/2016 6:00",128,109,6,11,"Regen",237,"wolbecker"
"3/22/2016 7:00",310,206,6,13,"Regen",516,"wolbecker"
"3/22/2016 8:00",454,176,6,15,"wolkig",630,"wolbecker"
"3/22/2016 9:00",350,131,7,13,"wolkig",481,"wolbecker"
"3/22/2016 10:00",237,151,8,15,"wolkig",388,"wolbecker"
"3/22/2016 11:00",252,182,8,17,"Regen",434,"wolbecker"
"3/22/2016 12:00",227,199,8,11,"Regen",426,"wolbecker"
"3/22/2016 13:00",261,227,8,13,"Regen",488,"wolbecker"
"3/22/2016 14:00",248,245,9,7,"Regen",493,"wolbecker"
"3/22/2016 15:00",217,301,8,9,"Regen",518,"wolbecker"
"3/22/2016 16:00",280,396,8,9,"Regen",676,"wolbecker"
"3/22/2016 17:00",346,419,8,13,"Regen",765,"wolbecker"
"3/22/2016 18:00",267,416,7,17,"Regen",683,"wolbecker"
"3/22/2016 19:00",208,343,7,11,"Regen",551,"wolbecker"
"3/22/2016 20:00",117,140,7,11,"Regen",257,"wolbecker"
"3/22/2016 21:00",91,101,7,6,"Regen",192,"wolbecker"
"3/22/2016 22:00",101,71,7,9,"Regen",172,"wolbecker"
"3/22/2016 23:00",56,50,7,13,"Regen",106,"wolbecker"
"3/23/2016 0:00",28,37,6,13,"Regen",65,"wolbecker"
"3/23/2016 1:00",14,8,7,11,"wolkig",22,"wolbecker"
"3/23/2016 2:00",6,10,6,9,"Regen",16,"wolbecker"
"3/23/2016 3:00",11,10,6,13,"Regen",21,"wolbecker"
"3/23/2016 4:00",6,5,6,7,"Regen",11,"wolbecker"
"3/23/2016 5:00",33,32,6,9,"wolkig",65,"wolbecker"
"3/23/2016 6:00",123,111,6,11,"Regen",234,"wolbecker"
"3/23/2016 7:00",304,178,6,11,"wolkig",482,"wolbecker"
"3/23/2016 8:00",457,190,6,11,"Regen",647,"wolbecker"
"3/23/2016 9:00",392,146,7,13,"wolkig",538,"wolbecker"
"3/23/2016 10:00",298,180,7,11,"wolkig",478,"wolbecker"
"3/23/2016 11:00",314,203,8,20,"wolkig",517,"wolbecker"
"3/23/2016 12:00",292,263,8,13,"teilweise bewölkt",555,"wolbecker"
"3/23/2016 13:00",288,286,8,15,"wolkig",574,"wolbecker"
"3/23/2016 14:00",243,291,9,20,"wolkig",534,"wolbecker"
"3/23/2016 15:00",272,323,9,13,"wolkig",595,"wolbecker"
"3/23/2016 16:00",305,380,9,19,"wolkig",685,"wolbecker"
"3/23/2016 17:00",341,435,8,15,NA,776,"wolbecker"
"3/23/2016 18:00",270,414,8,11,"wolkig",684,"wolbecker"
"3/23/2016 19:00",236,284,7,7,"wolkig",520,"wolbecker"
"3/23/2016 20:00",155,184,6,13,"wolkig",339,"wolbecker"
"3/23/2016 21:00",102,126,5,7,"teilweise bewölkt",228,"wolbecker"
"3/23/2016 22:00",100,82,5,7,"wolkig",182,"wolbecker"
"3/23/2016 23:00",81,78,4,6,"wolkig",159,"wolbecker"
"3/24/2016 0:00",45,44,3,4,"wolkig",89,"wolbecker"
"3/24/2016 1:00",32,29,3,6,"wolkig",61,"wolbecker"
"3/24/2016 2:00",18,49,3,6,"wolkig",67,"wolbecker"
"3/24/2016 3:00",20,10,3,7,"wolkig",30,"wolbecker"
"3/24/2016 4:00",11,14,2,6,"wolkig",25,"wolbecker"
"3/24/2016 5:00",29,43,1,2,"wolkig",72,"wolbecker"
"3/24/2016 6:00",115,89,2,0,"wolkig",204,"wolbecker"
"3/24/2016 7:00",285,180,4,4,"wolkig",465,"wolbecker"
"3/24/2016 8:00",353,144,5,6,"wolkig",497,"wolbecker"
"3/24/2016 9:00",299,128,5,7,"wolkig",427,"wolbecker"
"3/24/2016 10:00",242,147,6,6,"wolkig",389,"wolbecker"
"3/24/2016 11:00",266,168,6,9,"Regen",434,"wolbecker"
"3/24/2016 12:00",230,247,7,9,"Regen",477,"wolbecker"
"3/24/2016 13:00",261,262,8,15,"wolkig",523,"wolbecker"
"3/24/2016 14:00",225,304,8,13,"wolkig",529,"wolbecker"
"3/24/2016 15:00",262,350,8,13,"wolkig",612,"wolbecker"
"3/24/2016 16:00",303,418,8,9,NA,721,"wolbecker"
"3/24/2016 17:00",357,398,8,7,"wolkig",755,"wolbecker"
"3/24/2016 18:00",273,332,8,13,"wolkig",605,"wolbecker"
"3/24/2016 19:00",201,273,8,11,"Regen",474,"wolbecker"
"3/24/2016 20:00",127,162,8,13,"Regen",289,"wolbecker"
"3/24/2016 21:00",89,98,7,11,"Regen",187,"wolbecker"
"3/24/2016 22:00",81,92,7,11,"Regen",173,"wolbecker"
"3/24/2016 23:00",55,42,6,9,"Regen",97,"wolbecker"
"3/25/2016 0:00",44,47,6,11,"Regen",91,"wolbecker"
"3/25/2016 1:00",38,37,6,9,"Regen",75,"wolbecker"
"3/25/2016 2:00",18,16,6,9,"Regen",34,"wolbecker"
"3/25/2016 3:00",11,18,6,15,"Regen",29,"wolbecker"
"3/25/2016 4:00",7,4,6,15,"Regen",11,"wolbecker"
"3/25/2016 5:00",12,6,6,15,"Regen",18,"wolbecker"
"3/25/2016 6:00",10,18,6,17,"Regen",28,"wolbecker"
"3/25/2016 7:00",13,16,6,15,"Regen",29,"wolbecker"
"3/25/2016 8:00",26,34,7,17,"Regen",60,"wolbecker"
"3/25/2016 9:00",42,41,7,17,"Regen",83,"wolbecker"
"3/25/2016 10:00",33,59,7,17,"Regen",92,"wolbecker"
"3/25/2016 11:00",47,47,7,19,"Regen",94,"wolbecker"
"3/25/2016 12:00",46,55,8,15,"Regen",101,"wolbecker"
"3/25/2016 13:00",44,37,8,13,"Regen",81,"wolbecker"
"3/25/2016 14:00",66,71,8,13,"Regen",137,"wolbecker"
"3/25/2016 15:00",39,61,8,13,"Regen",100,"wolbecker"
"3/25/2016 16:00",73,63,8,11,"wolkig",136,"wolbecker"
"3/25/2016 17:00",85,68,8,9,"wolkig",153,"wolbecker"
"3/25/2016 18:00",90,80,8,6,"wolkig",170,"wolbecker"
"3/25/2016 19:00",75,70,7,6,"wolkig",145,"wolbecker"
"3/25/2016 20:00",39,53,6,9,"wolkig",92,"wolbecker"
"3/25/2016 21:00",40,41,6,9,"wolkig",81,"wolbecker"
"3/25/2016 22:00",35,32,7,11,"wolkig",67,"wolbecker"
"3/25/2016 23:00",26,28,7,17,"wolkig",54,"wolbecker"
"3/26/2016 0:00",31,22,7,6,"wolkig",53,"wolbecker"
"3/26/2016 1:00",16,16,6,7,"wolkig",32,"wolbecker"
"3/26/2016 2:00",9,10,6,2,"wolkig",19,"wolbecker"
"3/26/2016 3:00",6,5,4,2,"Nebel",11,"wolbecker"
"3/26/2016 4:00",4,2,3,7,"Nebel",6,"wolbecker"
"3/26/2016 5:00",15,5,1,6,"Nebel",20,"wolbecker"
"3/26/2016 6:00",23,23,3,9,"Nebel",46,"wolbecker"
"3/26/2016 7:00",60,41,5,7,"Nebel",101,"wolbecker"
"3/26/2016 8:00",113,64,7,13,"teilweise bewölkt",177,"wolbecker"
"3/26/2016 9:00",306,122,9,13,"teilweise bewölkt",428,"wolbecker"
"3/26/2016 10:00",437,169,10,19,"teilweise bewölkt",606,"wolbecker"
"3/26/2016 11:00",443,286,12,20,"teilweise bewölkt",729,"wolbecker"
"3/26/2016 12:00",417,363,13,24,"teilweise bewölkt",780,"wolbecker"
"3/26/2016 13:00",340,341,14,19,"Klarer Himmel",681,"wolbecker"
"3/26/2016 14:00",269,341,14,20,"wolkig",610,"wolbecker"
"3/26/2016 15:00",209,317,15,22,"Klarer Himmel",526,"wolbecker"
"3/26/2016 16:00",209,278,15,32,"Klarer Himmel",487,"wolbecker"
"3/26/2016 17:00",160,287,14,22,"Klarer Himmel",447,"wolbecker"
"3/26/2016 18:00",133,215,13,17,"Klarer Himmel",348,"wolbecker"
"3/26/2016 19:00",111,149,12,17,"Klarer Himmel",260,"wolbecker"
"3/26/2016 20:00",91,112,12,19,"Klarer Himmel",203,"wolbecker"
"3/26/2016 21:00",60,62,11,19,"Klarer Himmel",122,"wolbecker"
"3/26/2016 22:00",80,61,10,15,"Klarer Himmel",141,"wolbecker"
"3/26/2016 23:00",41,66,10,20,"Klarer Himmel",107,"wolbecker"
"3/27/2016 0:00",41,77,9,13,"Klarer Himmel",118,"wolbecker"
"3/27/2016 1:00",44,50,9,9,"Klarer Himmel",94,"wolbecker"
"3/27/2016 3:00",0,0,NA,NA,NA,0,"wolbecker"
"3/27/2016 3:00",34,39,9,9,"Klarer Himmel",73,"wolbecker"
"3/27/2016 4:00",31,27,10,17,"Klarer Himmel",58,"wolbecker"
"3/27/2016 5:00",33,11,10,15,"Klarer Himmel",44,"wolbecker"
"3/27/2016 6:00",22,11,10,7,"Regen",33,"wolbecker"
"3/27/2016 7:00",17,19,9,9,"wolkig",36,"wolbecker"
"3/27/2016 8:00",11,28,9,28,"Regen",39,"wolbecker"
"3/27/2016 9:00",24,26,8,19,"Regen",50,"wolbecker"
"3/27/2016 10:00",40,36,8,24,"Regen",76,"wolbecker"
"3/27/2016 11:00",19,40,8,19,"wolkig",59,"wolbecker"
"3/27/2016 12:00",47,55,9,24,"wolkig",102,"wolbecker"
"3/27/2016 13:00",60,66,10,20,"wolkig",126,"wolbecker"
"3/27/2016 14:00",51,64,11,32,"teilweise bewölkt",115,"wolbecker"
"3/27/2016 15:00",91,85,12,28,"wolkig",176,"wolbecker"
"3/27/2016 16:00",89,86,12,19,"Regen",175,"wolbecker"
"3/27/2016 17:00",72,71,12,24,"wolkig",143,"wolbecker"
"3/27/2016 18:00",73,77,12,19,"teilweise bewölkt",150,"wolbecker"
"3/27/2016 19:00",89,67,11,13,"Klarer Himmel",156,"wolbecker"
"3/27/2016 20:00",71,60,10,15,"Klarer Himmel",131,"wolbecker"
"3/27/2016 21:00",62,49,9,19,"Klarer Himmel",111,"wolbecker"
"3/27/2016 22:00",48,33,9,19,"Klarer Himmel",81,"wolbecker"
"3/27/2016 23:00",42,24,8,15,"teilweise bewölkt",66,"wolbecker"
"3/28/2016 0:00",25,30,8,17,"Klarer Himmel",55,"wolbecker"
"3/28/2016 1:00",16,50,7,13,"Klarer Himmel",66,"wolbecker"
"3/28/2016 2:00",11,14,8,17,"Klarer Himmel",25,"wolbecker"
"3/28/2016 3:00",12,21,8,19,"Klarer Himmel",33,"wolbecker"
"3/28/2016 4:00",25,6,7,19,"Klarer Himmel",31,"wolbecker"
"3/28/2016 5:00",25,4,8,20,"Klarer Himmel",29,"wolbecker"
"3/28/2016 6:00",10,11,8,24,"Klarer Himmel",21,"wolbecker"
"3/28/2016 7:00",15,16,8,20,"Klarer Himmel",31,"wolbecker"
"3/28/2016 8:00",23,22,9,28,"Klarer Himmel",45,"wolbecker"
"3/28/2016 9:00",36,29,9,43,"Regen",65,"wolbecker"
"3/28/2016 10:00",47,46,10,28,"Regen",93,"wolbecker"
"3/28/2016 11:00",63,65,11,35,"wolkig",128,"wolbecker"
"3/28/2016 12:00",67,57,12,37,"wolkig",124,"wolbecker"
"3/28/2016 13:00",74,69,12,37,"wolkig",143,"wolbecker"
"3/28/2016 14:00",87,73,11,32,"Regen",160,"wolbecker"
"3/28/2016 15:00",62,60,9,19,"wolkig",122,"wolbecker"
"3/28/2016 16:00",93,71,10,15,"wolkig",164,"wolbecker"
"3/28/2016 17:00",108,51,10,24,"teilweise bewölkt",159,"wolbecker"
"3/28/2016 18:00",90,72,10,19,"teilweise bewölkt",162,"wolbecker"
"3/28/2016 19:00",95,82,10,19,"teilweise bewölkt",177,"wolbecker"
"3/28/2016 20:00",89,79,9,15,"wolkig",168,"wolbecker"
"3/28/2016 21:00",63,43,9,15,"teilweise bewölkt",106,"wolbecker"
"3/28/2016 22:00",41,43,8,17,"teilweise bewölkt",84,"wolbecker"
"3/28/2016 23:00",33,18,8,11,"wolkig",51,"wolbecker"
"3/29/2016 0:00",24,10,8,19,"wolkig",34,"wolbecker"
"3/29/2016 1:00",9,9,7,26,"Regen",18,"wolbecker"
"3/29/2016 2:00",6,7,7,15,"Regen",13,"wolbecker"
"3/29/2016 3:00",0,5,6,22,"wolkig",5,"wolbecker"
"3/29/2016 4:00",8,12,6,22,"wolkig",20,"wolbecker"
"3/29/2016 5:00",29,32,6,24,"wolkig",61,"wolbecker"
"3/29/2016 6:00",90,88,6,24,"wolkig",178,"wolbecker"
"3/29/2016 7:00",298,162,6,24,"Regen",460,"wolbecker"
"3/29/2016 8:00",320,157,7,26,"wolkig",477,"wolbecker"
"3/29/2016 9:00",274,109,7,24,"wolkig",383,"wolbecker"
"3/29/2016 10:00",220,141,7,28,"wolkig",361,"wolbecker"
"3/29/2016 11:00",260,163,8,28,"Regen",423,"wolbecker"
"3/29/2016 12:00",211,194,8,20,"wolkig",405,"wolbecker"
"3/29/2016 13:00",190,202,9,26,"wolkig",392,"wolbecker"
"3/29/2016 14:00",254,208,10,28,"wolkig",462,"wolbecker"
"3/29/2016 15:00",291,290,11,37,"wolkig",581,"wolbecker"
"3/29/2016 16:00",302,370,9,26,"Regen",672,"wolbecker"
"3/29/2016 17:00",364,427,10,26,"wolkig",791,"wolbecker"
"3/29/2016 18:00",288,395,10,26,"wolkig",683,"wolbecker"
"3/29/2016 19:00",210,285,9,20,"teilweise bewölkt",495,"wolbecker"
"3/29/2016 20:00",141,189,8,11,"teilweise bewölkt",330,"wolbecker"
"3/29/2016 21:00",95,92,7,7,"teilweise bewölkt",187,"wolbecker"
"3/29/2016 22:00",105,88,5,7,"Klarer Himmel",193,"wolbecker"
"3/29/2016 23:00",70,49,6,9,"Klarer Himmel",119,"wolbecker"
"3/30/2016 0:00",33,33,6,9,"Klarer Himmel",66,"wolbecker"
"3/30/2016 1:00",13,24,6,11,"Klarer Himmel",37,"wolbecker"
"3/30/2016 2:00",5,4,7,15,"Regen",9,"wolbecker"
"3/30/2016 3:00",8,3,7,17,"Regen",11,"wolbecker"
"3/30/2016 4:00",4,5,8,17,"wolkig",9,"wolbecker"
"3/30/2016 5:00",32,31,9,15,"wolkig",63,"wolbecker"
"3/30/2016 6:00",105,95,9,22,"wolkig",200,"wolbecker"
"3/30/2016 7:00",289,181,7,24,"wolkig",470,"wolbecker"
"3/30/2016 8:00",375,176,8,22,"wolkig",551,"wolbecker"
"3/30/2016 9:00",367,147,8,26,"wolkig",514,"wolbecker"
"3/30/2016 10:00",299,167,9,28,"wolkig",466,"wolbecker"
"3/30/2016 11:00",340,199,10,28,"wolkig",539,"wolbecker"
"3/30/2016 12:00",296,242,11,28,"wolkig",538,"wolbecker"
"3/30/2016 13:00",285,294,11,32,"wolkig",579,"wolbecker"
"3/30/2016 14:00",288,293,11,28,"wolkig",581,"wolbecker"
"3/30/2016 15:00",272,370,12,30,"wolkig",642,"wolbecker"
"3/30/2016 16:00",294,414,12,32,"wolkig",708,"wolbecker"
"3/30/2016 17:00",361,452,12,30,"wolkig",813,"wolbecker"
"3/30/2016 18:00",318,446,11,22,"wolkig",764,"wolbecker"
"3/30/2016 19:00",277,300,10,20,"wolkig",577,"wolbecker"
"3/30/2016 20:00",159,186,9,9,"wolkig",345,"wolbecker"
"3/30/2016 21:00",100,138,8,7,"wolkig",238,"wolbecker"
"3/30/2016 22:00",109,96,8,6,"Klarer Himmel",205,"wolbecker"
"3/30/2016 23:00",72,86,7,4,"wolkig",158,"wolbecker"
"3/31/2016 0:00",48,45,6,2,"Klarer Himmel",93,"wolbecker"
"3/31/2016 1:00",35,48,5,2,"Klarer Himmel",83,"wolbecker"
"3/31/2016 2:00",26,18,5,2,"Klarer Himmel",44,"wolbecker"
"3/31/2016 3:00",15,18,5,2,"Klarer Himmel",33,"wolbecker"
"3/31/2016 4:00",16,10,5,0,"Klarer Himmel",26,"wolbecker"
"3/31/2016 5:00",38,42,4,2,"Klarer Himmel",80,"wolbecker"
"3/31/2016 6:00",110,104,4,2,"Klarer Himmel",214,"wolbecker"
"3/31/2016 7:00",316,199,4,4,"wolkig",515,"wolbecker"
"3/31/2016 8:00",376,193,6,2,"Klarer Himmel",569,"wolbecker"
"3/31/2016 9:00",339,152,7,4,"wolkig",491,"wolbecker"
"3/31/2016 10:00",255,168,8,4,"wolkig",423,"wolbecker"
"3/31/2016 11:00",279,186,9,11,"wolkig",465,"wolbecker"
"3/31/2016 12:00",269,227,10,11,"wolkig",496,"wolbecker"
"3/31/2016 13:00",259,279,10,19,"wolkig",538,"wolbecker"
"3/31/2016 14:00",296,300,10,17,"wolkig",596,"wolbecker"
"3/31/2016 15:00",305,345,11,17,"wolkig",650,"wolbecker"
"3/31/2016 16:00",286,447,10,17,"wolkig",733,"wolbecker"
"3/31/2016 17:00",392,404,10,17,"wolkig",796,"wolbecker"
"3/31/2016 18:00",327,431,9,17,"wolkig",758,"wolbecker"
"3/31/2016 19:00",253,363,9,15,"wolkig",616,"wolbecker"
"3/31/2016 20:00",156,188,8,9,"wolkig",344,"wolbecker"
"3/31/2016 21:00",107,100,8,17,"wolkig",207,"wolbecker"
"3/31/2016 22:00",115,114,7,17,"Klarer Himmel",229,"wolbecker"
"3/31/2016 23:00",77,53,7,17,"Klarer Himmel",130,"wolbecker"
"4/1/2016 0:00",42,29,6,20,"Klarer Himmel",71,"wolbecker"
"4/1/2016 1:00",21,18,6,19,"Klarer Himmel",39,"wolbecker"
"4/1/2016 2:00",11,6,6,11,"Klarer Himmel",17,"wolbecker"
"4/1/2016 3:00",5,12,5,9,"Klarer Himmel",17,"wolbecker"
"4/1/2016 4:00",6,10,5,13,"Klarer Himmel",16,"wolbecker"
"4/1/2016 5:00",38,34,3,9,"teilweise bewölkt",72,"wolbecker"
"4/1/2016 6:00",104,102,2,6,"Klarer Himmel",206,"wolbecker"
"4/1/2016 7:00",299,177,2,4,"Klarer Himmel",476,"wolbecker"
"4/1/2016 8:00",404,179,5,9,"Klarer Himmel",583,"wolbecker"
"4/1/2016 9:00",314,143,6,9,"Klarer Himmel",457,"wolbecker"
"4/1/2016 10:00",318,168,8,6,"Klarer Himmel",486,"wolbecker"
"4/1/2016 11:00",318,213,9,6,"teilweise bewölkt",531,"wolbecker"
"4/1/2016 12:00",300,328,11,7,"teilweise bewölkt",628,"wolbecker"
"4/1/2016 13:00",329,342,12,9,"teilweise bewölkt",671,"wolbecker"
"4/1/2016 14:00",361,383,13,9,"teilweise bewölkt",744,"wolbecker"
"4/1/2016 15:00",355,336,13,9,"teilweise bewölkt",691,"wolbecker"
"4/1/2016 16:00",354,421,14,6,"Klarer Himmel",775,"wolbecker"
"4/1/2016 17:00",319,442,13,13,"Klarer Himmel",761,"wolbecker"
"4/1/2016 18:00",306,389,12,6,"Klarer Himmel",695,"wolbecker"
"4/1/2016 19:00",246,328,11,4,"Klarer Himmel",574,"wolbecker"
"4/1/2016 20:00",197,223,10,6,"Klarer Himmel",420,"wolbecker"
"4/1/2016 21:00",134,168,9,6,"Klarer Himmel",302,"wolbecker"
"4/1/2016 22:00",136,128,8,6,"Klarer Himmel",264,"wolbecker"
"4/1/2016 23:00",76,91,8,6,"Klarer Himmel",167,"wolbecker"
"4/2/2016 0:00",85,98,7,6,"Klarer Himmel",183,"wolbecker"
"4/2/2016 1:00",72,77,6,4,"Klarer Himmel",149,"wolbecker"
"4/2/2016 2:00",41,54,6,6,"Klarer Himmel",95,"wolbecker"
"4/2/2016 3:00",43,18,5,6,"Klarer Himmel",61,"wolbecker"
"4/2/2016 4:00",31,21,5,6,"Klarer Himmel",52,"wolbecker"
"4/2/2016 5:00",46,21,5,7,"Klarer Himmel",67,"wolbecker"
"4/2/2016 6:00",36,27,4,6,"Klarer Himmel",63,"wolbecker"
"4/2/2016 7:00",70,58,4,6,"Klarer Himmel",128,"wolbecker"
"4/2/2016 8:00",125,83,6,7,"Klarer Himmel",208,"wolbecker"
"4/2/2016 9:00",286,118,8,13,"Klarer Himmel",404,"wolbecker"
"4/2/2016 10:00",390,214,10,9,"Klarer Himmel",604,"wolbecker"
"4/2/2016 11:00",472,269,11,9,"Klarer Himmel",741,"wolbecker"
"4/2/2016 12:00",447,360,13,11,"Klarer Himmel",807,"wolbecker"
"4/2/2016 13:00",384,400,14,11,"teilweise bewölkt",784,"wolbecker"
"4/2/2016 14:00",331,426,14,13,"teilweise bewölkt",757,"wolbecker"
"4/2/2016 15:00",287,378,14,13,"Klarer Himmel",665,"wolbecker"
"4/2/2016 16:00",219,332,15,9,"Klarer Himmel",551,"wolbecker"
"4/2/2016 17:00",252,359,15,7,"Klarer Himmel",611,"wolbecker"
"4/2/2016 18:00",226,323,14,4,"Klarer Himmel",549,"wolbecker"
"4/2/2016 19:00",186,274,14,6,"Klarer Himmel",460,"wolbecker"
"4/2/2016 20:00",171,181,12,6,"Klarer Himmel",352,"wolbecker"
"4/2/2016 21:00",128,130,12,6,"Klarer Himmel",258,"wolbecker"
"4/2/2016 22:00",147,89,13,6,"Klarer Himmel",236,"wolbecker"
"4/2/2016 23:00",94,88,13,6,"Klarer Himmel",182,"wolbecker"
"4/3/2016 0:00",102,73,12,7,"Klarer Himmel",175,"wolbecker"
"4/3/2016 1:00",84,74,12,2,"Klarer Himmel",158,"wolbecker"
"4/3/2016 2:00",56,55,11,6,"Klarer Himmel",111,"wolbecker"
"4/3/2016 3:00",52,34,12,6,"Regen",86,"wolbecker"
"4/3/2016 4:00",28,22,11,4,"Klarer Himmel",50,"wolbecker"
"4/3/2016 5:00",31,10,11,6,"Klarer Himmel",41,"wolbecker"
"4/3/2016 6:00",25,16,11,6,"Klarer Himmel",41,"wolbecker"
"4/3/2016 7:00",16,36,11,4,"Klarer Himmel",52,"wolbecker"
"4/3/2016 8:00",32,38,12,9,"Klarer Himmel",70,"wolbecker"
"4/3/2016 9:00",74,57,13,6,"Klarer Himmel",131,"wolbecker"
"4/3/2016 10:00",127,110,14,9,"Klarer Himmel",237,"wolbecker"
"4/3/2016 11:00",119,102,15,11,"wolkig",221,"wolbecker"
"4/3/2016 12:00",144,140,16,7,"wolkig",284,"wolbecker"
"4/3/2016 13:00",201,145,17,11,"Klarer Himmel",346,"wolbecker"
"4/3/2016 14:00",280,173,19,13,"Klarer Himmel",453,"wolbecker"
"4/3/2016 15:00",296,180,20,9,"wolkig",476,"wolbecker"
"4/3/2016 16:00",259,242,20,19,"wolkig",501,"wolbecker"
"4/3/2016 17:00",254,266,20,9,"wolkig",520,"wolbecker"
"4/3/2016 18:00",222,229,20,7,"wolkig",451,"wolbecker"
"4/3/2016 19:00",208,171,19,2,"wolkig",379,"wolbecker"
"4/3/2016 20:00",141,103,18,6,"wolkig",244,"wolbecker"
"4/3/2016 21:00",100,79,18,11,"Klarer Himmel",179,"wolbecker"
"4/3/2016 22:00",77,56,17,13,"Klarer Himmel",133,"wolbecker"
"4/3/2016 23:00",43,28,16,11,"Regen",71,"wolbecker"
"4/4/2016 0:00",18,20,15,11,"Regen",38,"wolbecker"
"4/4/2016 1:00",11,12,15,11,"Regen",23,"wolbecker"
"4/4/2016 2:00",5,2,14,7,"Regen",7,"wolbecker"
"4/4/2016 3:00",6,3,13,9,"Klarer Himmel",9,"wolbecker"
"4/4/2016 4:00",7,10,14,13,"Klarer Himmel",17,"wolbecker"
"4/4/2016 5:00",42,39,14,11,"Klarer Himmel",81,"wolbecker"
"4/4/2016 6:00",160,170,13,15,"Klarer Himmel",330,"wolbecker"
"4/4/2016 7:00",650,323,14,13,"wolkig",973,"wolbecker"
"4/4/2016 8:00",567,263,15,13,"wolkig",830,"wolbecker"
"4/4/2016 9:00",436,197,17,19,"teilweise bewölkt",633,"wolbecker"
"4/4/2016 10:00",363,201,17,19,"teilweise bewölkt",564,"wolbecker"
"4/4/2016 11:00",324,253,18,19,"wolkig",577,"wolbecker"
"4/4/2016 12:00",304,327,19,22,"teilweise bewölkt",631,"wolbecker"
"4/4/2016 13:00",357,349,18,32,"wolkig",706,"wolbecker"
"4/4/2016 14:00",321,376,15,32,"wolkig",697,"wolbecker"
"4/4/2016 15:00",357,436,16,22,"wolkig",793,"wolbecker"
"4/4/2016 16:00",423,529,16,19,"wolkig",952,"wolbecker"
"4/4/2016 17:00",497,532,15,19,"wolkig",1029,"wolbecker"
"4/4/2016 18:00",376,506,15,11,"wolkig",882,"wolbecker"
"4/4/2016 19:00",329,391,14,7,"Klarer Himmel",720,"wolbecker"
"4/4/2016 20:00",203,244,11,2,"Klarer Himmel",447,"wolbecker"
"4/4/2016 21:00",148,146,9,4,"Klarer Himmel",294,"wolbecker"
"4/4/2016 22:00",130,132,11,6,"Klarer Himmel",262,"wolbecker"
"4/4/2016 23:00",57,53,11,6,"Klarer Himmel",110,"wolbecker"
"4/5/2016 0:00",28,28,10,6,"teilweise bewölkt",56,"wolbecker"
"4/5/2016 1:00",12,12,10,4,"teilweise bewölkt",24,"wolbecker"
"4/5/2016 2:00",4,7,11,6,"Klarer Himmel",11,"wolbecker"
"4/5/2016 3:00",4,12,11,4,"Klarer Himmel",16,"wolbecker"
"4/5/2016 4:00",6,18,12,4,"wolkig",24,"wolbecker"
"4/5/2016 5:00",40,49,12,6,"wolkig",89,"wolbecker"
"4/5/2016 6:00",132,181,12,6,"wolkig",313,"wolbecker"
"4/5/2016 7:00",618,319,11,11,"wolkig",937,"wolbecker"
"4/5/2016 8:00",552,266,12,11,"Regen",818,"wolbecker"
"4/5/2016 9:00",386,168,12,11,"Regen",554,"wolbecker"
"4/5/2016 10:00",229,153,13,9,"Regen",382,"wolbecker"
"4/5/2016 11:00",207,177,13,11,"Regen",384,"wolbecker"
"4/5/2016 12:00",198,216,12,9,"Regen",414,"wolbecker"
"4/5/2016 13:00",288,308,12,9,"Regen",596,"wolbecker"
"4/5/2016 14:00",285,287,12,17,"Regen",572,"wolbecker"
"4/5/2016 15:00",261,327,11,17,"Regen",588,"wolbecker"
"4/5/2016 16:00",333,446,11,15,"Regen",779,"wolbecker"
"4/5/2016 17:00",377,472,11,11,"Regen",849,"wolbecker"
"4/5/2016 18:00",330,396,11,11,"Regen",726,"wolbecker"
"4/5/2016 19:00",285,338,11,6,"wolkig",623,"wolbecker"
"4/5/2016 20:00",170,201,10,9,"teilweise bewölkt",371,"wolbecker"
"4/5/2016 21:00",120,122,10,9,NA,242,"wolbecker"
"4/5/2016 22:00",119,116,9,11,NA,235,"wolbecker"
"4/5/2016 23:00",48,72,8,7,NA,120,"wolbecker"
"4/6/2016 0:00",40,32,8,6,NA,72,"wolbecker"
"4/6/2016 1:00",13,22,7,7,NA,35,"wolbecker"
"4/6/2016 2:00",8,6,7,9,"Nebel",14,"wolbecker"
"4/6/2016 3:00",8,1,7,11,"Nebel",9,"wolbecker"
"4/6/2016 4:00",8,10,8,13,"wolkig",18,"wolbecker"
"4/6/2016 5:00",36,34,8,15,"wolkig",70,"wolbecker"
"4/6/2016 6:00",141,198,8,15,"wolkig",339,"wolbecker"
"4/6/2016 7:00",655,296,8,15,"wolkig",951,"wolbecker"
"4/6/2016 8:00",581,261,8,15,"wolkig",842,"wolbecker"
"4/6/2016 9:00",467,186,8,17,"wolkig",653,"wolbecker"
"4/6/2016 10:00",365,186,9,19,"wolkig",551,"wolbecker"
"4/6/2016 11:00",310,257,9,20,"wolkig",567,"wolbecker"
"4/6/2016 12:00",338,341,11,20,"wolkig",679,"wolbecker"
"4/6/2016 13:00",323,386,12,30,"teilweise bewölkt",709,"wolbecker"
"4/6/2016 14:00",345,351,12,30,"wolkig",696,"wolbecker"
"4/6/2016 15:00",361,432,12,33,"wolkig",793,"wolbecker"
"4/6/2016 16:00",375,506,12,28,"Regen",881,"wolbecker"
"4/6/2016 17:00",449,538,12,26,"Regen",987,"wolbecker"
"4/6/2016 18:00",375,507,12,26,"Regen",882,"wolbecker"
"4/6/2016 19:00",269,334,11,20,"wolkig",603,"wolbecker"
"4/6/2016 20:00",198,213,11,22,"Regen",411,"wolbecker"
"4/6/2016 21:00",131,162,9,20,"Regen",293,"wolbecker"
"4/6/2016 22:00",148,118,8,46,"Regen",266,"wolbecker"
"4/6/2016 23:00",68,71,7,20,"Klarer Himmel",139,"wolbecker"
"4/7/2016 0:00",39,43,7,17,"Regen",82,"wolbecker"
"4/7/2016 1:00",23,40,7,15,"wolkig",63,"wolbecker"
"4/7/2016 2:00",10,16,6,13,"teilweise bewölkt",26,"wolbecker"
"4/7/2016 3:00",14,21,6,15,"teilweise bewölkt",35,"wolbecker"
"4/7/2016 4:00",16,22,6,22,"teilweise bewölkt",38,"wolbecker"
"4/7/2016 5:00",42,45,6,17,"Klarer Himmel",87,"wolbecker"
"4/7/2016 6:00",137,176,6,15,"teilweise bewölkt",313,"wolbecker"
"4/7/2016 7:00",617,328,6,13,"teilweise bewölkt",945,"wolbecker"
"4/7/2016 8:00",530,255,6,20,"teilweise bewölkt",785,"wolbecker"
"4/7/2016 9:00",452,191,7,22,"teilweise bewölkt",643,"wolbecker"
"4/7/2016 10:00",291,148,8,26,"teilweise bewölkt",439,"wolbecker"
"4/7/2016 11:00",296,227,9,30,"teilweise bewölkt",523,"wolbecker"
"4/7/2016 12:00",297,285,10,30,"teilweise bewölkt",582,"wolbecker"
"4/7/2016 13:00",293,356,10,28,"wolkig",649,"wolbecker"
"4/7/2016 14:00",323,338,11,33,"teilweise bewölkt",661,"wolbecker"
"4/7/2016 15:00",351,412,11,30,"teilweise bewölkt",763,"wolbecker"
"4/7/2016 16:00",424,520,12,30,"teilweise bewölkt",944,"wolbecker"
"4/7/2016 17:00",497,576,11,22,"teilweise bewölkt",1073,"wolbecker"
"4/7/2016 18:00",425,516,10,24,"teilweise bewölkt",941,"wolbecker"
"4/7/2016 19:00",322,421,8,13,"teilweise bewölkt",743,"wolbecker"
"4/7/2016 20:00",212,255,8,11,"teilweise bewölkt",467,"wolbecker"
"4/7/2016 21:00",131,154,7,13,"Klarer Himmel",285,"wolbecker"
"4/7/2016 22:00",110,102,7,13,"Klarer Himmel",212,"wolbecker"
"4/7/2016 23:00",110,111,7,15,"Klarer Himmel",221,"wolbecker"
"4/8/2016 0:00",50,42,6,13,"Klarer Himmel",92,"wolbecker"
"4/8/2016 1:00",15,31,5,9,"Klarer Himmel",46,"wolbecker"
"4/8/2016 2:00",4,7,5,7,"Klarer Himmel",11,"wolbecker"
"4/8/2016 3:00",7,10,3,6,"teilweise bewölkt",17,"wolbecker"
"4/8/2016 4:00",9,7,3,6,"teilweise bewölkt",16,"wolbecker"
"4/8/2016 5:00",42,42,4,7,"wolkig",84,"wolbecker"
"4/8/2016 6:00",139,153,5,13,"wolkig",292,"wolbecker"
"4/8/2016 7:00",612,283,5,9,"wolkig",895,"wolbecker"
"4/8/2016 8:00",479,225,6,11,"wolkig",704,"wolbecker"
"4/8/2016 9:00",411,165,6,11,"wolkig",576,"wolbecker"
"4/8/2016 10:00",306,194,7,13,"wolkig",500,"wolbecker"
"4/8/2016 11:00",302,262,8,9,"wolkig",564,"wolbecker"
"4/8/2016 12:00",328,334,9,13,"wolkig",662,"wolbecker"
"4/8/2016 13:00",357,477,10,13,"wolkig",834,"wolbecker"
"4/8/2016 14:00",407,438,11,11,"wolkig",845,"wolbecker"
"4/8/2016 15:00",390,427,11,13,"wolkig",817,"wolbecker"
"4/8/2016 16:00",328,458,11,13,"wolkig",786,"wolbecker"
"4/8/2016 17:00",331,432,11,13,"wolkig",763,"wolbecker"
"4/8/2016 18:00",322,420,11,7,"wolkig",742,"wolbecker"
"4/8/2016 19:00",303,326,10,6,"wolkig",629,"wolbecker"
"4/8/2016 20:00",236,229,7,4,"teilweise bewölkt",465,"wolbecker"
"4/8/2016 21:00",143,161,7,4,"Klarer Himmel",304,"wolbecker"
"4/8/2016 22:00",128,127,7,4,"Klarer Himmel",255,"wolbecker"
"4/8/2016 23:00",91,115,5,2,"Klarer Himmel",206,"wolbecker"
"4/9/2016 0:00",79,94,4,4,"Klarer Himmel",173,"wolbecker"
"4/9/2016 1:00",60,99,3,2,"Klarer Himmel",159,"wolbecker"
"4/9/2016 2:00",41,55,2,2,"Nebel",96,"wolbecker"
"4/9/2016 3:00",53,31,2,2,"Nebel",84,"wolbecker"
"4/9/2016 4:00",28,22,1,2,"Nebel",50,"wolbecker"
"4/9/2016 5:00",39,10,2,6,"Nebel",49,"wolbecker"
"4/9/2016 6:00",29,29,2,6,"Nebel",58,"wolbecker"
"4/9/2016 7:00",73,66,3,4,"Nebel",139,"wolbecker"
"4/9/2016 8:00",173,102,5,4,NA,275,"wolbecker"
"4/9/2016 9:00",300,161,7,7,NA,461,"wolbecker"
"4/9/2016 10:00",448,165,10,11,"Klarer Himmel",613,"wolbecker"
"4/9/2016 11:00",492,265,12,11,"teilweise bewölkt",757,"wolbecker"
"4/9/2016 12:00",468,403,13,9,"teilweise bewölkt",871,"wolbecker"
"4/9/2016 13:00",460,448,13,7,"teilweise bewölkt",908,"wolbecker"
"4/9/2016 14:00",364,435,14,15,"teilweise bewölkt",799,"wolbecker"
"4/9/2016 15:00",316,419,15,11,"Klarer Himmel",735,"wolbecker"
"4/9/2016 16:00",277,385,15,9,"Klarer Himmel",662,"wolbecker"
"4/9/2016 17:00",284,345,15,9,"teilweise bewölkt",629,"wolbecker"
"4/9/2016 18:00",301,345,14,13,"Klarer Himmel",646,"wolbecker"
"4/9/2016 19:00",244,332,13,6,"Klarer Himmel",576,"wolbecker"
"4/9/2016 20:00",212,229,12,6,"Klarer Himmel",441,"wolbecker"
"4/9/2016 21:00",135,150,11,6,"Klarer Himmel",285,"wolbecker"
"4/9/2016 22:00",133,121,11,7,"Klarer Himmel",254,"wolbecker"
"4/9/2016 23:00",109,111,10,7,"Klarer Himmel",220,"wolbecker"
"4/10/2016 0:00",107,123,10,7,"Klarer Himmel",230,"wolbecker"
"4/10/2016 1:00",106,104,10,6,"Klarer Himmel",210,"wolbecker"
"4/10/2016 2:00",61,54,10,7,"Klarer Himmel",115,"wolbecker"
"4/10/2016 3:00",57,45,10,6,"Klarer Himmel",102,"wolbecker"
"4/10/2016 4:00",55,26,10,7,"Klarer Himmel",81,"wolbecker"
"4/10/2016 5:00",43,15,10,9,"Klarer Himmel",58,"wolbecker"
"4/10/2016 6:00",27,17,10,7,"Klarer Himmel",44,"wolbecker"
"4/10/2016 7:00",25,32,9,6,"Klarer Himmel",57,"wolbecker"
"4/10/2016 8:00",33,36,10,9,"Klarer Himmel",69,"wolbecker"
"4/10/2016 9:00",73,71,12,11,"Klarer Himmel",144,"wolbecker"
"4/10/2016 10:00",169,103,13,9,"wolkig",272,"wolbecker"
"4/10/2016 11:00",198,143,14,9,"wolkig",341,"wolbecker"
"4/10/2016 12:00",220,177,15,9,"wolkig",397,"wolbecker"
"4/10/2016 13:00",246,181,16,13,"wolkig",427,"wolbecker"
"4/10/2016 14:00",325,221,16,9,"teilweise bewölkt",546,"wolbecker"
"4/10/2016 15:00",300,229,17,11,"teilweise bewölkt",529,"wolbecker"
"4/10/2016 16:00",274,241,17,15,"teilweise bewölkt",515,"wolbecker"
"4/10/2016 17:00",317,279,16,11,"teilweise bewölkt",596,"wolbecker"
"4/10/2016 18:00",252,267,15,7,"Klarer Himmel",519,"wolbecker"
"4/10/2016 19:00",206,245,15,7,"Klarer Himmel",451,"wolbecker"
"4/10/2016 20:00",159,189,13,6,"Klarer Himmel",348,"wolbecker"
"4/10/2016 21:00",119,108,12,7,"Klarer Himmel",227,"wolbecker"
"4/10/2016 22:00",95,66,11,7,"Klarer Himmel",161,"wolbecker"
"4/10/2016 23:00",42,36,11,9,"Klarer Himmel",78,"wolbecker"
"4/11/2016 0:00",25,16,10,11,"Klarer Himmel",41,"wolbecker"
"4/11/2016 1:00",10,6,9,11,"Klarer Himmel",16,"wolbecker"
"4/11/2016 2:00",2,2,8,11,"Klarer Himmel",4,"wolbecker"
"4/11/2016 3:00",1,2,8,13,"Klarer Himmel",3,"wolbecker"
"4/11/2016 4:00",3,7,8,9,"Klarer Himmel",10,"wolbecker"
"4/11/2016 5:00",33,39,7,11,"Klarer Himmel",72,"wolbecker"
"4/11/2016 6:00",164,167,7,11,"Klarer Himmel",331,"wolbecker"
"4/11/2016 7:00",730,353,7,11,"Klarer Himmel",1083,"wolbecker"
"4/11/2016 8:00",635,283,9,15,"Klarer Himmel",918,"wolbecker"
"4/11/2016 9:00",548,210,10,17,"Klarer Himmel",758,"wolbecker"
"4/11/2016 10:00",389,218,11,19,"Klarer Himmel",607,"wolbecker"
"4/11/2016 11:00",373,309,12,17,"teilweise bewölkt",682,"wolbecker"
"4/11/2016 12:00",346,349,13,13,"teilweise bewölkt",695,"wolbecker"
"4/11/2016 13:00",443,403,14,19,"Klarer Himmel",846,"wolbecker"
"4/11/2016 14:00",375,370,16,15,"Klarer Himmel",745,"wolbecker"
"4/11/2016 15:00",445,497,16,17,"Klarer Himmel",942,"wolbecker"
"4/11/2016 16:00",448,590,16,15,"Klarer Himmel",1038,"wolbecker"
"4/11/2016 17:00",559,681,16,13,"Klarer Himmel",1240,"wolbecker"
"4/11/2016 18:00",454,636,16,17,"Klarer Himmel",1090,"wolbecker"
"4/11/2016 19:00",369,501,14,13,"Klarer Himmel",870,"wolbecker"
"4/11/2016 20:00",235,284,13,9,"Klarer Himmel",519,"wolbecker"
"4/11/2016 21:00",202,207,12,9,"Klarer Himmel",409,"wolbecker"
"4/11/2016 22:00",158,124,11,7,"Klarer Himmel",282,"wolbecker"
"4/11/2016 23:00",67,96,10,9,"Klarer Himmel",163,"wolbecker"
"4/12/2016 0:00",38,50,9,7,"Klarer Himmel",88,"wolbecker"
"4/12/2016 1:00",24,25,9,9,"Klarer Himmel",49,"wolbecker"
"4/12/2016 2:00",11,9,9,7,"Klarer Himmel",20,"wolbecker"
"4/12/2016 3:00",15,5,8,7,"Klarer Himmel",20,"wolbecker"
"4/12/2016 4:00",11,5,8,6,"Klarer Himmel",16,"wolbecker"
"4/12/2016 5:00",35,43,8,11,NA,78,"wolbecker"
"4/12/2016 6:00",164,207,8,7,NA,371,"wolbecker"
"4/12/2016 7:00",746,346,8,7,"Regen",1092,"wolbecker"
"4/12/2016 8:00",658,283,9,4,NA,941,"wolbecker"
"4/12/2016 9:00",564,198,10,7,NA,762,"wolbecker"
"4/12/2016 10:00",372,258,13,4,"teilweise bewölkt",630,"wolbecker"
"4/12/2016 11:00",342,241,15,9,"Klarer Himmel",583,"wolbecker"
"4/12/2016 12:00",336,358,16,7,"teilweise bewölkt",694,"wolbecker"
"4/12/2016 13:00",418,424,18,9,"teilweise bewölkt",842,"wolbecker"
"4/12/2016 14:00",397,433,18,6,"teilweise bewölkt",830,"wolbecker"
"4/12/2016 15:00",486,533,18,7,"Klarer Himmel",1019,"wolbecker"
"4/12/2016 16:00",444,612,18,7,"Klarer Himmel",1056,"wolbecker"
"4/12/2016 17:00",568,644,18,4,"Klarer Himmel",1212,"wolbecker"
"4/12/2016 18:00",480,583,18,6,"Klarer Himmel",1063,"wolbecker"
"4/12/2016 19:00",351,462,16,4,"Klarer Himmel",813,"wolbecker"
"4/12/2016 20:00",296,348,15,6,"Klarer Himmel",644,"wolbecker"
"4/12/2016 21:00",157,154,12,22,NA,311,"wolbecker"
"4/12/2016 22:00",173,205,11,13,"Regen",378,"wolbecker"
"4/12/2016 23:00",88,150,10,4,"wolkig",238,"wolbecker"
"4/13/2016 0:00",43,92,10,13,"wolkig",135,"wolbecker"
"4/13/2016 1:00",18,17,10,9,"wolkig",35,"wolbecker"
"4/13/2016 2:00",24,6,9,6,"wolkig",30,"wolbecker"
"4/13/2016 3:00",35,6,8,2,"Nebel",41,"wolbecker"
"4/13/2016 4:00",33,7,9,7,"wolkig",40,"wolbecker"
"4/13/2016 5:00",39,42,8,6,"wolkig",81,"wolbecker"
"4/13/2016 6:00",141,190,8,6,"Nebel",331,"wolbecker"
"4/13/2016 7:00",812,322,8,7,"teilweise bewölkt",1134,"wolbecker"
"4/13/2016 8:00",683,305,9,4,"wolkig",988,"wolbecker"
"4/13/2016 9:00",560,193,10,4,"wolkig",753,"wolbecker"
"4/13/2016 10:00",386,269,11,4,"wolkig",655,"wolbecker"
"4/13/2016 11:00",432,278,12,4,"wolkig",710,"wolbecker"
"4/13/2016 12:00",362,403,13,6,"wolkig",765,"wolbecker"
"4/13/2016 13:00",425,450,13,6,"wolkig",875,"wolbecker"
"4/13/2016 14:00",352,500,14,4,"wolkig",852,"wolbecker"
"4/13/2016 15:00",413,517,14,6,"wolkig",930,"wolbecker"
"4/13/2016 16:00",435,567,14,9,"wolkig",1002,"wolbecker"
"4/13/2016 17:00",520,568,14,9,"wolkig",1088,"wolbecker"
"4/13/2016 18:00",454,561,14,7,"wolkig",1015,"wolbecker"
"4/13/2016 19:00",389,401,13,6,"wolkig",790,"wolbecker"
"4/13/2016 20:00",305,326,10,24,"Regen",631,"wolbecker"
"4/13/2016 21:00",184,224,9,2,"wolkig",408,"wolbecker"
"4/13/2016 22:00",186,166,9,6,"wolkig",352,"wolbecker"
"4/13/2016 23:00",85,108,9,2,"wolkig",193,"wolbecker"
"4/14/2016 0:00",73,87,8,4,"wolkig",160,"wolbecker"
"4/14/2016 1:00",29,58,7,2,"Nebel",87,"wolbecker"
"4/14/2016 2:00",12,34,6,7,"Nebel",46,"wolbecker"
"4/14/2016 3:00",24,35,6,4,"Nebel",59,"wolbecker"
"4/14/2016 4:00",17,26,4,4,"Nebel",43,"wolbecker"
"4/14/2016 5:00",42,53,3,6,"Nebel",95,"wolbecker"
"4/14/2016 6:00",133,187,4,2,"Nebel",320,"wolbecker"
"4/14/2016 7:00",736,338,4,2,"Nebel",1074,"wolbecker"
"4/14/2016 8:00",624,261,7,6,NA,885,"wolbecker"
"4/14/2016 9:00",546,179,10,4,"Klarer Himmel",725,"wolbecker"
"4/14/2016 10:00",368,199,13,4,"Klarer Himmel",567,"wolbecker"
"4/14/2016 11:00",392,272,14,7,"teilweise bewölkt",664,"wolbecker"
"4/14/2016 12:00",365,402,14,13,"teilweise bewölkt",767,"wolbecker"
"4/14/2016 13:00",428,465,16,13,"teilweise bewölkt",893,"wolbecker"
"4/14/2016 14:00",385,408,15,15,"Klarer Himmel",793,"wolbecker"
"4/14/2016 15:00",414,527,16,13,"teilweise bewölkt",941,"wolbecker"
"4/14/2016 16:00",469,612,15,15,"teilweise bewölkt",1081,"wolbecker"
"4/14/2016 17:00",520,658,14,11,"wolkig",1178,"wolbecker"
"4/14/2016 18:00",479,566,14,6,"wolkig",1045,"wolbecker"
"4/14/2016 19:00",379,450,14,4,"Klarer Himmel",829,"wolbecker"
"4/14/2016 20:00",235,367,11,4,"Klarer Himmel",602,"wolbecker"
"4/14/2016 21:00",148,188,8,4,"Klarer Himmel",336,"wolbecker"
"4/14/2016 22:00",136,132,7,4,"Klarer Himmel",268,"wolbecker"
"4/14/2016 23:00",116,150,8,4,"Klarer Himmel",266,"wolbecker"
"4/15/2016 0:00",38,54,10,2,"wolkig",92,"wolbecker"
"4/15/2016 1:00",31,25,10,7,"Regen",56,"wolbecker"
"4/15/2016 2:00",15,12,9,6,"Klarer Himmel",27,"wolbecker"
"4/15/2016 3:00",13,10,8,11,"Klarer Himmel",23,"wolbecker"
"4/15/2016 4:00",15,13,8,11,"Klarer Himmel",28,"wolbecker"
"4/15/2016 5:00",28,50,10,13,"Regen",78,"wolbecker"
"4/15/2016 6:00",125,157,9,4,"Regen",282,"wolbecker"
"4/15/2016 7:00",525,243,9,4,"Regen",768,"wolbecker"
"4/15/2016 8:00",433,166,9,6,"Regen",599,"wolbecker"
"4/15/2016 9:00",343,142,9,6,"wolkig",485,"wolbecker"
"4/15/2016 10:00",267,205,10,7,"wolkig",472,"wolbecker"
"4/15/2016 11:00",295,249,12,15,"Regen",544,"wolbecker"
"4/15/2016 12:00",310,310,11,17,"Regen",620,"wolbecker"
"4/15/2016 13:00",285,396,12,20,"Regen",681,"wolbecker"
"4/15/2016 14:00",343,392,11,32,"Regen",735,"wolbecker"
"4/15/2016 15:00",319,376,12,24,"Regen",695,"wolbecker"
"4/15/2016 16:00",293,362,12,19,"wolkig",655,"wolbecker"
"4/15/2016 17:00",374,386,12,28,"Klarer Himmel",760,"wolbecker"
"4/15/2016 18:00",321,359,13,17,"teilweise bewölkt",680,"wolbecker"
"4/15/2016 19:00",292,305,12,9,"teilweise bewölkt",597,"wolbecker"
"4/15/2016 20:00",307,273,8,6,"teilweise bewölkt",580,"wolbecker"
"4/15/2016 21:00",146,230,9,2,"wolkig",376,"wolbecker"
"4/15/2016 22:00",118,209,7,6,"Klarer Himmel",327,"wolbecker"
"4/15/2016 23:00",104,162,6,4,"Klarer Himmel",266,"wolbecker"
"4/16/2016 0:00",96,113,6,6,"Klarer Himmel",209,"wolbecker"
"4/16/2016 1:00",79,85,7,4,"teilweise bewölkt",164,"wolbecker"
"4/16/2016 2:00",57,60,8,7,"teilweise bewölkt",117,"wolbecker"
"4/16/2016 3:00",55,29,9,7,"wolkig",84,"wolbecker"
"4/16/2016 4:00",27,21,9,13,"wolkig",48,"wolbecker"
"4/16/2016 5:00",32,23,10,17,"teilweise bewölkt",55,"wolbecker"
"4/16/2016 6:00",27,28,11,17,"wolkig",55,"wolbecker"
"4/16/2016 7:00",75,72,11,24,"wolkig",147,"wolbecker"
"4/16/2016 8:00",143,87,10,32,"Regen",230,"wolbecker"
"4/16/2016 9:00",273,126,11,15,"wolkig",399,"wolbecker"
"4/16/2016 10:00",354,187,12,37,"teilweise bewölkt",541,"wolbecker"
"4/16/2016 11:00",380,246,13,28,"teilweise bewölkt",626,"wolbecker"
"4/16/2016 12:00",358,348,13,28,"teilweise bewölkt",706,"wolbecker"
"4/16/2016 13:00",315,345,15,26,"Regen",660,"wolbecker"
"4/16/2016 14:00",291,354,11,35,"Regen",645,"wolbecker"
"4/16/2016 15:00",273,340,13,32,"Regen",613,"wolbecker"
"4/16/2016 16:00",236,348,12,22,"Regen",584,"wolbecker"
"4/16/2016 17:00",253,308,11,19,"Regen",561,"wolbecker"
"4/16/2016 18:00",210,346,11,22,"Regen",556,"wolbecker"
"4/16/2016 19:00",184,213,10,19,"wolkig",397,"wolbecker"
"4/16/2016 20:00",194,185,9,17,"wolkig",379,"wolbecker"
"4/16/2016 21:00",147,129,8,15,"wolkig",276,"wolbecker"
"4/16/2016 22:00",137,112,7,9,"wolkig",249,"wolbecker"
"4/16/2016 23:00",90,76,6,6,"wolkig",166,"wolbecker"
"4/17/2016 0:00",90,106,6,7,"teilweise bewölkt",196,"wolbecker"
"4/17/2016 1:00",64,89,5,6,"Klarer Himmel",153,"wolbecker"
"4/17/2016 2:00",58,77,3,6,"Klarer Himmel",135,"wolbecker"
"4/17/2016 3:00",54,46,3,6,"teilweise bewölkt",100,"wolbecker"
"4/17/2016 4:00",47,16,4,6,"wolkig",63,"wolbecker"
"4/17/2016 5:00",33,12,4,4,"wolkig",45,"wolbecker"
"4/17/2016 6:00",23,23,5,7,"wolkig",46,"wolbecker"
"4/17/2016 7:00",21,25,5,7,"Regen",46,"wolbecker"
"4/17/2016 8:00",50,41,6,13,"Regen",91,"wolbecker"
"4/17/2016 9:00",104,81,7,13,"Regen",185,"wolbecker"
"4/17/2016 10:00",119,91,7,13,"wolkig",210,"wolbecker"
"4/17/2016 11:00",146,125,9,19,"teilweise bewölkt",271,"wolbecker"
"4/17/2016 12:00",155,159,10,19,"teilweise bewölkt",314,"wolbecker"
"4/17/2016 13:00",197,187,10,17,"teilweise bewölkt",384,"wolbecker"
"4/17/2016 14:00",206,229,9,20,"Regen",435,"wolbecker"
"4/17/2016 15:00",245,205,10,20,"teilweise bewölkt",450,"wolbecker"
"4/17/2016 16:00",250,236,9,15,"Regen",486,"wolbecker"
"4/17/2016 17:00",278,240,9,17,"Regen",518,"wolbecker"
"4/17/2016 18:00",317,229,8,15,"teilweise bewölkt",546,"wolbecker"
"4/17/2016 19:00",228,131,8,9,"teilweise bewölkt",359,"wolbecker"
"4/17/2016 20:00",190,137,7,6,"teilweise bewölkt",327,"wolbecker"
"4/17/2016 21:00",127,98,4,2,"Klarer Himmel",225,"wolbecker"
"4/17/2016 22:00",115,71,4,2,"Klarer Himmel",186,"wolbecker"
"4/17/2016 23:00",52,37,3,4,"teilweise bewölkt",89,"wolbecker"
"4/18/2016 0:00",22,20,3,6,"teilweise bewölkt",42,"wolbecker"
"4/18/2016 1:00",7,10,2,2,"Klarer Himmel",17,"wolbecker"
"4/18/2016 2:00",0,2,2,2,"Klarer Himmel",2,"wolbecker"
"4/18/2016 3:00",3,4,0,2,"Klarer Himmel",7,"wolbecker"
"4/18/2016 4:00",5,7,0,2,"Nebel",12,"wolbecker"
"4/18/2016 5:00",39,45,0,4,"Nebel",84,"wolbecker"
"4/18/2016 6:00",170,163,0,2,"Nebel",333,"wolbecker"
"4/18/2016 7:00",707,326,2,4,"Klarer Himmel",1033,"wolbecker"
"4/18/2016 8:00",671,272,6,11,"Klarer Himmel",943,"wolbecker"
"4/18/2016 9:00",549,202,8,20,"Klarer Himmel",751,"wolbecker"
"4/18/2016 10:00",387,220,9,20,"teilweise bewölkt",607,"wolbecker"
"4/18/2016 11:00",401,300,11,24,"teilweise bewölkt",701,"wolbecker"
"4/18/2016 12:00",349,321,11,28,"teilweise bewölkt",670,"wolbecker"
"4/18/2016 13:00",391,380,11,24,"wolkig",771,"wolbecker"
"4/18/2016 14:00",376,376,11,22,"wolkig",752,"wolbecker"
"4/18/2016 15:00",388,421,12,24,"wolkig",809,"wolbecker"
"4/18/2016 16:00",435,598,12,28,"wolkig",1033,"wolbecker"
"4/18/2016 17:00",498,609,12,30,"wolkig",1107,"wolbecker"
"4/18/2016 18:00",429,561,11,28,"wolkig",990,"wolbecker"
"4/18/2016 19:00",333,509,11,20,"wolkig",842,"wolbecker"
"4/18/2016 20:00",190,292,10,20,"teilweise bewölkt",482,"wolbecker"
"4/18/2016 21:00",150,174,9,17,"Klarer Himmel",324,"wolbecker"
"4/18/2016 22:00",125,128,9,20,"wolkig",253,"wolbecker"
"4/18/2016 23:00",66,61,9,17,"Klarer Himmel",127,"wolbecker"
"4/19/2016 0:00",23,31,9,17,"Klarer Himmel",54,"wolbecker"
"4/19/2016 1:00",15,12,9,15,"wolkig",27,"wolbecker"
"4/19/2016 2:00",3,9,8,22,"wolkig",12,"wolbecker"
"4/19/2016 3:00",2,4,8,15,"wolkig",6,"wolbecker"
"4/19/2016 4:00",6,9,8,17,"wolkig",15,"wolbecker"
"4/19/2016 5:00",40,48,8,15,"wolkig",88,"wolbecker"
"4/19/2016 6:00",139,195,8,17,"Klarer Himmel",334,"wolbecker"
"4/19/2016 7:00",743,351,8,17,"Klarer Himmel",1094,"wolbecker"
"4/19/2016 8:00",686,261,9,17,"wolkig",947,"wolbecker"
"4/19/2016 9:00",551,206,10,22,"wolkig",757,"wolbecker"
"4/19/2016 10:00",336,208,11,22,"wolkig",544,"wolbecker"
"4/19/2016 11:00",328,265,12,19,"teilweise bewölkt",593,"wolbecker"
"4/19/2016 12:00",323,384,13,17,"wolkig",707,"wolbecker"
"4/19/2016 13:00",314,430,14,20,"wolkig",744,"wolbecker"
"4/19/2016 14:00",366,401,13,19,"teilweise bewölkt",767,"wolbecker"
"4/19/2016 15:00",403,450,12,19,"teilweise bewölkt",853,"wolbecker"
"4/19/2016 16:00",421,605,13,24,"teilweise bewölkt",1026,"wolbecker"
"4/19/2016 17:00",519,680,13,26,"teilweise bewölkt",1199,"wolbecker"
"4/19/2016 18:00",450,588,12,24,"teilweise bewölkt",1038,"wolbecker"
"4/19/2016 19:00",376,484,10,20,"teilweise bewölkt",860,"wolbecker"
"4/19/2016 20:00",236,343,8,17,"teilweise bewölkt",579,"wolbecker"
"4/19/2016 21:00",146,186,7,13,"Klarer Himmel",332,"wolbecker"
"4/19/2016 22:00",185,164,7,11,"teilweise bewölkt",349,"wolbecker"
"4/19/2016 23:00",63,72,6,11,"teilweise bewölkt",135,"wolbecker"
"4/20/2016 0:00",33,30,5,6,"Klarer Himmel",63,"wolbecker"
"4/20/2016 1:00",19,20,4,4,"Klarer Himmel",39,"wolbecker"
"4/20/2016 2:00",4,13,2,6,"Klarer Himmel",17,"wolbecker"
"4/20/2016 3:00",5,10,2,4,"Klarer Himmel",15,"wolbecker"
"4/20/2016 4:00",6,9,1,0,"teilweise bewölkt",15,"wolbecker"
"4/20/2016 5:00",41,49,1,4,"Nebel",90,"wolbecker"
"4/20/2016 6:00",147,207,1,4,"Nebel",354,"wolbecker"
"4/20/2016 7:00",755,347,3,2,"teilweise bewölkt",1102,"wolbecker"
"4/20/2016 8:00",692,273,6,7,"teilweise bewölkt",965,"wolbecker"
"4/20/2016 9:00",547,206,8,11,"teilweise bewölkt",753,"wolbecker"
"4/20/2016 10:00",403,269,9,9,"teilweise bewölkt",672,"wolbecker"
"4/20/2016 11:00",451,262,10,11,"teilweise bewölkt",713,"wolbecker"
"4/20/2016 12:00",404,400,10,11,"teilweise bewölkt",804,"wolbecker"
"4/20/2016 13:00",426,402,11,9,"teilweise bewölkt",828,"wolbecker"
"4/20/2016 14:00",375,499,12,7,"Klarer Himmel",874,"wolbecker"
"4/20/2016 15:00",442,486,13,9,"Klarer Himmel",928,"wolbecker"
"4/20/2016 16:00",461,622,13,11,"Klarer Himmel",1083,"wolbecker"
"4/20/2016 17:00",559,597,13,15,"Klarer Himmel",1156,"wolbecker"
"4/20/2016 18:00",481,630,13,11,"Klarer Himmel",1111,"wolbecker"
"4/20/2016 19:00",378,492,12,11,"Klarer Himmel",870,"wolbecker"
"4/20/2016 20:00",260,357,9,7,"Klarer Himmel",617,"wolbecker"
"4/20/2016 21:00",173,252,9,13,"Klarer Himmel",425,"wolbecker"
"4/20/2016 22:00",160,186,8,15,"Klarer Himmel",346,"wolbecker"
"4/20/2016 23:00",95,122,6,9,"Klarer Himmel",217,"wolbecker"
"4/21/2016 0:00",60,79,5,7,"Klarer Himmel",139,"wolbecker"
"4/21/2016 1:00",25,34,4,4,"Klarer Himmel",59,"wolbecker"
"4/21/2016 2:00",14,23,3,4,"Klarer Himmel",37,"wolbecker"
"4/21/2016 3:00",45,16,3,2,"Klarer Himmel",61,"wolbecker"
"4/21/2016 4:00",24,16,2,6,"Klarer Himmel",40,"wolbecker"
"4/21/2016 5:00",48,49,3,6,"Klarer Himmel",97,"wolbecker"
"4/21/2016 6:00",168,195,3,2,"Klarer Himmel",363,"wolbecker"
"4/21/2016 7:00",766,354,5,6,"Klarer Himmel",1120,"wolbecker"
"4/21/2016 8:00",633,265,7,6,"Klarer Himmel",898,"wolbecker"
"4/21/2016 9:00",610,216,10,6,"Klarer Himmel",826,"wolbecker"
"4/21/2016 10:00",356,241,11,9,"Klarer Himmel",597,"wolbecker"
"4/21/2016 11:00",369,288,12,9,"Klarer Himmel",657,"wolbecker"
"4/21/2016 12:00",362,417,14,9,"Klarer Himmel",779,"wolbecker"
"4/21/2016 13:00",428,432,14,9,"Klarer Himmel",860,"wolbecker"
"4/21/2016 14:00",390,450,16,9,"Klarer Himmel",840,"wolbecker"
"4/21/2016 15:00",464,518,16,13,"Klarer Himmel",982,"wolbecker"
"4/21/2016 16:00",494,611,16,13,"Klarer Himmel",1105,"wolbecker"
"4/21/2016 17:00",574,686,16,9,"Klarer Himmel",1260,"wolbecker"
"4/21/2016 18:00",500,594,15,15,"Klarer Himmel",1094,"wolbecker"
"4/21/2016 19:00",430,552,14,13,"Klarer Himmel",982,"wolbecker"
"4/21/2016 20:00",261,364,11,9,"Klarer Himmel",625,"wolbecker"
"4/21/2016 21:00",208,224,8,7,"Klarer Himmel",432,"wolbecker"
"4/21/2016 22:00",208,153,9,17,"Klarer Himmel",361,"wolbecker"
"4/21/2016 23:00",128,95,8,20,"Klarer Himmel",223,"wolbecker"
"4/22/2016 0:00",51,48,6,11,"Klarer Himmel",99,"wolbecker"
"4/22/2016 1:00",23,25,4,4,"Klarer Himmel",48,"wolbecker"
"4/22/2016 2:00",10,11,4,2,"Klarer Himmel",21,"wolbecker"
"4/22/2016 3:00",4,11,2,9,"Klarer Himmel",15,"wolbecker"
"4/22/2016 4:00",5,9,2,2,"Klarer Himmel",14,"wolbecker"
"4/22/2016 5:00",35,51,2,2,"Nebel",86,"wolbecker"
"4/22/2016 6:00",127,162,2,4,"Nebel",289,"wolbecker"
"4/22/2016 7:00",704,299,5,6,"Klarer Himmel",1003,"wolbecker"
"4/22/2016 8:00",587,281,7,15,"wolkig",868,"wolbecker"
"4/22/2016 9:00",469,185,8,22,"wolkig",654,"wolbecker"
"4/22/2016 10:00",377,232,9,13,"wolkig",609,"wolbecker"
"4/22/2016 11:00",330,293,10,7,"wolkig",623,"wolbecker"
"4/22/2016 12:00",367,399,11,11,"wolkig",766,"wolbecker"
"4/22/2016 13:00",411,564,12,11,"Klarer Himmel",975,"wolbecker"
"4/22/2016 14:00",413,515,13,4,"Klarer Himmel",928,"wolbecker"
"4/22/2016 15:00",441,467,13,15,"Klarer Himmel",908,"wolbecker"
"4/22/2016 16:00",434,501,13,13,"Klarer Himmel",935,"wolbecker"
"4/22/2016 17:00",445,483,13,13,"Klarer Himmel",928,"wolbecker"
"4/22/2016 18:00",377,502,12,15,"Klarer Himmel",879,"wolbecker"
"4/22/2016 19:00",311,428,11,15,"Klarer Himmel",739,"wolbecker"
"4/22/2016 20:00",225,318,10,17,"Klarer Himmel",543,"wolbecker"
"4/22/2016 21:00",182,172,9,15,"Klarer Himmel",354,"wolbecker"
"4/22/2016 22:00",218,167,8,15,"Klarer Himmel",385,"wolbecker"
"4/22/2016 23:00",146,120,7,15,"Klarer Himmel",266,"wolbecker"
"4/23/2016 0:00",120,110,6,11,"Klarer Himmel",230,"wolbecker"
"4/23/2016 1:00",64,98,6,7,"Klarer Himmel",162,"wolbecker"
"4/23/2016 2:00",68,62,5,7,"Klarer Himmel",130,"wolbecker"
"4/23/2016 3:00",48,48,5,7,"Klarer Himmel",96,"wolbecker"
"4/23/2016 4:00",38,24,4,7,"Klarer Himmel",62,"wolbecker"
"4/23/2016 5:00",34,22,4,4,"Klarer Himmel",56,"wolbecker"
"4/23/2016 6:00",37,33,4,6,"Klarer Himmel",70,"wolbecker"
"4/23/2016 7:00",81,65,4,11,"wolkig",146,"wolbecker"
"4/23/2016 8:00",162,92,6,15,"wolkig",254,"wolbecker"
"4/23/2016 9:00",289,165,6,15,"wolkig",454,"wolbecker"
"4/23/2016 10:00",340,162,6,13,"teilweise bewölkt",502,"wolbecker"
"4/23/2016 11:00",342,223,7,15,"teilweise bewölkt",565,"wolbecker"
"4/23/2016 12:00",336,292,7,20,"teilweise bewölkt",628,"wolbecker"
"4/23/2016 13:00",346,317,9,17,"wolkig",663,"wolbecker"
"4/23/2016 14:00",282,370,9,13,"teilweise bewölkt",652,"wolbecker"
"4/23/2016 15:00",207,290,7,20,"teilweise bewölkt",497,"wolbecker"
"4/23/2016 16:00",181,257,9,22,"teilweise bewölkt",438,"wolbecker"
"4/23/2016 17:00",193,284,8,19,"teilweise bewölkt",477,"wolbecker"
"4/23/2016 18:00",174,285,7,9,"teilweise bewölkt",459,"wolbecker"
"4/23/2016 19:00",187,210,6,17,"Regen",397,"wolbecker"
"4/23/2016 20:00",164,165,5,13,"teilweise bewölkt",329,"wolbecker"
"4/23/2016 21:00",136,129,5,11,"teilweise bewölkt",265,"wolbecker"
"4/23/2016 22:00",122,96,3,6,"teilweise bewölkt",218,"wolbecker"
"4/23/2016 23:00",86,95,3,9,"teilweise bewölkt",181,"wolbecker"
"4/24/2016 0:00",96,85,2,11,"teilweise bewölkt",181,"wolbecker"
"4/24/2016 1:00",69,67,2,11,"Klarer Himmel",136,"wolbecker"
"4/24/2016 2:00",65,65,3,13,"wolkig",130,"wolbecker"
"4/24/2016 3:00",31,39,2,11,"teilweise bewölkt",70,"wolbecker"
"4/24/2016 4:00",43,25,2,13,"teilweise bewölkt",68,"wolbecker"
"4/24/2016 5:00",37,17,1,13,"teilweise bewölkt",54,"wolbecker"
"4/24/2016 6:00",22,23,1,15,"teilweise bewölkt",45,"wolbecker"
"4/24/2016 7:00",29,25,2,17,"teilweise bewölkt",54,"wolbecker"
"4/24/2016 8:00",50,34,4,19,"teilweise bewölkt",84,"wolbecker"
"4/24/2016 9:00",112,69,5,24,"teilweise bewölkt",181,"wolbecker"
"4/24/2016 10:00",98,84,6,19,"teilweise bewölkt",182,"wolbecker"
"4/24/2016 11:00",86,107,5,22,"teilweise bewölkt",193,"wolbecker"
"4/24/2016 12:00",129,132,5,4,"teilweise bewölkt",261,"wolbecker"
"4/24/2016 13:00",117,135,6,19,"teilweise bewölkt",252,"wolbecker"
"4/24/2016 14:00",163,163,8,24,"teilweise bewölkt",326,"wolbecker"
"4/24/2016 15:00",161,96,7,30,"teilweise bewölkt",257,"wolbecker"
"4/24/2016 16:00",159,158,5,6,"teilweise bewölkt",317,"wolbecker"
"4/24/2016 17:00",196,172,6,7,"teilweise bewölkt",368,"wolbecker"
"4/24/2016 18:00",188,164,6,20,"wolkig",352,"wolbecker"
"4/24/2016 19:00",149,131,6,9,"teilweise bewölkt",280,"wolbecker"
"4/24/2016 20:00",151,92,4,13,"Regen",243,"wolbecker"
"4/24/2016 21:00",117,76,4,19,"teilweise bewölkt",193,"wolbecker"
"4/24/2016 22:00",99,50,1,11,"teilweise bewölkt",149,"wolbecker"
"4/24/2016 23:00",55,26,1,11,"teilweise bewölkt",81,"wolbecker"
"4/25/2016 0:00",22,11,1,7,"wolkig",33,"wolbecker"
"4/25/2016 1:00",12,6,1,9,"teilweise bewölkt",18,"wolbecker"
"4/25/2016 2:00",1,2,0,9,"Klarer Himmel",3,"wolbecker"
"4/25/2016 3:00",0,2,1,9,"teilweise bewölkt",2,"wolbecker"
"4/25/2016 4:00",7,9,0,7,"teilweise bewölkt",16,"wolbecker"
"4/25/2016 5:00",42,42,1,9,"Nebel",84,"wolbecker"
"4/25/2016 6:00",118,165,1,13,"teilweise bewölkt",283,"wolbecker"
"4/25/2016 7:00",651,302,2,11,"Klarer Himmel",953,"wolbecker"
"4/25/2016 8:00",603,264,4,19,"teilweise bewölkt",867,"wolbecker"
"4/25/2016 9:00",505,197,6,19,"wolkig",702,"wolbecker"
"4/25/2016 10:00",358,188,6,28,"wolkig",546,"wolbecker"
"4/25/2016 11:00",288,215,7,24,"teilweise bewölkt",503,"wolbecker"
"4/25/2016 12:00",307,312,9,28,"wolkig",619,"wolbecker"
"4/25/2016 13:00",352,353,8,32,"Regen",705,"wolbecker"
"4/25/2016 14:00",332,351,8,22,"wolkig",683,"wolbecker"
"4/25/2016 15:00",368,413,7,32,"Regen",781,"wolbecker"
"4/25/2016 16:00",348,496,6,22,"Regen",844,"wolbecker"
"4/25/2016 17:00",322,462,4,19,"Regen",784,"wolbecker"
"4/25/2016 18:00",285,427,4,13,"Regen",712,"wolbecker"
"4/25/2016 19:00",256,306,3,17,"Regen",562,"wolbecker"
"4/25/2016 20:00",165,201,3,7,"wolkig",366,"wolbecker"
"4/25/2016 21:00",101,112,3,9,"wolkig",213,"wolbecker"
"4/25/2016 22:00",74,99,4,17,"wolkig",173,"wolbecker"
"4/25/2016 23:00",41,47,3,13,"wolkig",88,"wolbecker"
"4/26/2016 0:00",18,38,3,17,"wolkig",56,"wolbecker"
"4/26/2016 1:00",8,27,2,15,"teilweise bewölkt",35,"wolbecker"
"4/26/2016 2:00",3,18,2,13,"teilweise bewölkt",21,"wolbecker"
"4/26/2016 3:00",1,15,1,15,"Klarer Himmel",16,"wolbecker"
"4/26/2016 4:00",9,10,1,13,"Klarer Himmel",19,"wolbecker"
"4/26/2016 5:00",41,36,1,13,"Klarer Himmel",77,"wolbecker"
"4/26/2016 6:00",154,192,1,19,"Schnee",346,"wolbecker"
"4/26/2016 7:00",710,337,3,22,"wolkig",1047,"wolbecker"
"4/26/2016 8:00",618,245,3,30,"Schnee",863,"wolbecker"
"4/26/2016 9:00",417,141,3,28,"Regen",558,"wolbecker"
"4/26/2016 10:00",278,152,4,30,"wolkig",430,"wolbecker"
"4/26/2016 11:00",273,212,5,33,"Regen",485,"wolbecker"
"4/26/2016 12:00",227,268,2,9,"Schnee",495,"wolbecker"
"4/26/2016 13:00",272,348,6,30,"Regen",620,"wolbecker"
"4/26/2016 14:00",302,343,1,13,"Schnee",645,"wolbecker"
"4/26/2016 15:00",322,394,6,28,"teilweise bewölkt",716,"wolbecker"
"4/26/2016 16:00",311,476,7,22,"wolkig",787,"wolbecker"
"4/26/2016 17:00",417,535,6,30,"wolkig",952,"wolbecker"
"4/26/2016 18:00",383,527,5,22,"Regen",910,"wolbecker"
"4/26/2016 19:00",293,389,4,26,"Regen",682,"wolbecker"
"4/26/2016 20:00",198,269,4,26,"wolkig",467,"wolbecker"
"4/26/2016 21:00",144,146,4,22,"teilweise bewölkt",290,"wolbecker"
"4/26/2016 22:00",130,105,4,32,"wolkig",235,"wolbecker"
"4/26/2016 23:00",72,70,4,28,"Regen",142,"wolbecker"
"4/27/2016 0:00",33,31,4,32,"wolkig",64,"wolbecker"
"4/27/2016 1:00",7,14,3,20,"teilweise bewölkt",21,"wolbecker"
"4/27/2016 2:00",6,14,3,19,"wolkig",20,"wolbecker"
"4/27/2016 3:00",4,15,2,13,"teilweise bewölkt",19,"wolbecker"
"4/27/2016 4:00",9,6,3,11,"wolkig",15,"wolbecker"
"4/27/2016 5:00",39,33,3,9,"wolkig",72,"wolbecker"
"4/27/2016 6:00",134,159,3,11,"Regen",293,"wolbecker"
"4/27/2016 7:00",498,271,3,19,"Regen",769,"wolbecker"
"4/27/2016 8:00",490,186,4,17,"Regen",676,"wolbecker"
"4/27/2016 9:00",360,138,3,22,"Regen",498,"wolbecker"
"4/27/2016 10:00",336,179,5,20,"wolkig",515,"wolbecker"
"4/27/2016 11:00",350,210,7,20,"Regen",560,"wolbecker"
"4/27/2016 12:00",302,284,8,24,"Regen",586,"wolbecker"
"4/27/2016 13:00",344,331,4,30,"Regen",675,"wolbecker"
"4/27/2016 14:00",268,294,4,9,"wolkig",562,"wolbecker"
"4/27/2016 15:00",298,385,8,22,"Regen",683,"wolbecker"
"4/27/2016 16:00",342,497,9,24,"wolkig",839,"wolbecker"
"4/27/2016 17:00",356,487,9,20,"wolkig",843,"wolbecker"
"4/27/2016 18:00",320,447,5,24,"Regen",767,"wolbecker"
"4/27/2016 19:00",298,341,6,7,"wolkig",639,"wolbecker"
"4/27/2016 20:00",213,262,5,9,"wolkig",475,"wolbecker"
"4/27/2016 21:00",137,174,5,7,"teilweise bewölkt",311,"wolbecker"
"4/27/2016 22:00",130,144,4,17,"teilweise bewölkt",274,"wolbecker"
"4/27/2016 23:00",88,77,4,11,"Klarer Himmel",165,"wolbecker"
"4/28/2016 0:00",46,85,2,9,"Klarer Himmel",131,"wolbecker"
"4/28/2016 1:00",17,33,2,11,"Klarer Himmel",50,"wolbecker"
"4/28/2016 2:00",11,19,2,11,"Klarer Himmel",30,"wolbecker"
"4/28/2016 3:00",15,18,2,13,"Klarer Himmel",33,"wolbecker"
"4/28/2016 4:00",17,21,1,11,"Klarer Himmel",38,"wolbecker"
"4/28/2016 5:00",37,45,2,9,"teilweise bewölkt",82,"wolbecker"
"4/28/2016 6:00",142,163,1,11,"teilweise bewölkt",305,"wolbecker"
"4/28/2016 7:00",620,292,2,11,"teilweise bewölkt",912,"wolbecker"
"4/28/2016 8:00",611,261,5,19,"teilweise bewölkt",872,"wolbecker"
"4/28/2016 9:00",552,207,7,17,"teilweise bewölkt",759,"wolbecker"
"4/28/2016 10:00",327,194,7,13,"teilweise bewölkt",521,"wolbecker"
"4/28/2016 11:00",318,240,6,20,"Regen",558,"wolbecker"
"4/28/2016 12:00",267,356,7,9,"wolkig",623,"wolbecker"
"4/28/2016 13:00",345,378,8,22,"Regen",723,"wolbecker"
"4/28/2016 14:00",324,389,11,9,"teilweise bewölkt",713,"wolbecker"
"4/28/2016 15:00",443,452,10,17,"teilweise bewölkt",895,"wolbecker"
"4/28/2016 16:00",387,558,10,20,"Regen",945,"wolbecker"
"4/28/2016 17:00",484,540,9,13,"wolkig",1024,"wolbecker"
"4/28/2016 18:00",406,577,7,13,"wolkig",983,"wolbecker"
"4/28/2016 19:00",326,394,6,9,"wolkig",720,"wolbecker"
"4/28/2016 20:00",178,258,6,13,"Klarer Himmel",436,"wolbecker"
"4/28/2016 21:00",144,185,5,9,"Klarer Himmel",329,"wolbecker"
"4/28/2016 22:00",163,158,5,9,"Klarer Himmel",321,"wolbecker"
"4/28/2016 23:00",97,99,5,9,"Klarer Himmel",196,"wolbecker"
"4/29/2016 0:00",49,54,4,9,"Klarer Himmel",103,"wolbecker"
"4/29/2016 1:00",16,16,3,7,NA,32,"wolbecker"
"4/29/2016 2:00",17,11,3,11,NA,28,"wolbecker"
"4/29/2016 3:00",15,14,3,15,"Klarer Himmel",29,"wolbecker"
"4/29/2016 4:00",9,10,3,15,"Klarer Himmel",19,"wolbecker"
"4/29/2016 5:00",37,42,4,17,"Klarer Himmel",79,"wolbecker"
"4/29/2016 6:00",135,158,4,17,"Klarer Himmel",293,"wolbecker"
"4/29/2016 7:00",622,265,6,20,"Klarer Himmel",887,"wolbecker"
"4/29/2016 8:00",556,228,8,19,"Klarer Himmel",784,"wolbecker"
"4/29/2016 9:00",455,202,10,26,"wolkig",657,"wolbecker"
"4/29/2016 10:00",320,214,10,33,"wolkig",534,"wolbecker"
"4/29/2016 11:00",345,287,10,26,"wolkig",632,"wolbecker"
"4/29/2016 12:00",313,383,11,26,"Regen",696,"wolbecker"
"4/29/2016 13:00",367,457,11,26,"Regen",824,"wolbecker"
"4/29/2016 14:00",330,449,8,17,"Regen",779,"wolbecker"
"4/29/2016 15:00",349,433,8,13,"Regen",782,"wolbecker"
"4/29/2016 16:00",348,420,9,20,"Regen",768,"wolbecker"
"4/29/2016 17:00",335,448,9,17,"Regen",783,"wolbecker"
"4/29/2016 18:00",282,416,8,19,"Regen",698,"wolbecker"
"4/29/2016 19:00",242,333,7,11,"Regen",575,"wolbecker"
"4/29/2016 20:00",156,208,7,11,"wolkig",364,"wolbecker"
"4/29/2016 21:00",120,152,7,17,"wolkig",272,"wolbecker"
"4/29/2016 22:00",126,130,7,13,"Klarer Himmel",256,"wolbecker"
"4/29/2016 23:00",119,127,7,9,"Klarer Himmel",246,"wolbecker"
"4/30/2016 0:00",116,95,6,7,"Klarer Himmel",211,"wolbecker"
"4/30/2016 1:00",73,85,6,7,"Klarer Himmel",158,"wolbecker"
"4/30/2016 2:00",58,47,6,7,"Klarer Himmel",105,"wolbecker"
"4/30/2016 3:00",46,35,7,7,"Regen",81,"wolbecker"
"4/30/2016 4:00",67,21,6,13,"Regen",88,"wolbecker"
"4/30/2016 5:00",34,17,5,6,"Regen",51,"wolbecker"
"4/30/2016 6:00",34,30,5,4,"Regen",64,"wolbecker"
"4/30/2016 7:00",59,44,5,6,"Regen",103,"wolbecker"
"4/30/2016 8:00",112,66,6,9,"Regen",178,"wolbecker"
"4/30/2016 9:00",198,101,7,7,"Regen",299,"wolbecker"
"4/30/2016 10:00",251,147,8,6,"Regen",398,"wolbecker"
"4/30/2016 11:00",314,195,8,6,"Regen",509,"wolbecker"
"4/30/2016 12:00",334,235,9,4,"Regen",569,"wolbecker"
"4/30/2016 13:00",292,291,8,6,"Regen",583,"wolbecker"
"4/30/2016 14:00",233,323,10,7,"wolkig",556,"wolbecker"
"4/30/2016 15:00",264,285,10,6,"wolkig",549,"wolbecker"
"4/30/2016 16:00",218,270,10,4,"wolkig",488,"wolbecker"
"4/30/2016 17:00",183,301,11,2,"wolkig",484,"wolbecker"
"4/30/2016 18:00",210,288,10,7,"wolkig",498,"wolbecker"
"4/30/2016 19:00",181,281,10,6,"wolkig",462,"wolbecker"
"4/30/2016 20:00",175,178,9,4,"wolkig",353,"wolbecker"
"4/30/2016 21:00",137,171,9,17,"wolkig",308,"wolbecker"
"4/30/2016 22:00",135,158,8,17,"Klarer Himmel",293,"wolbecker"
"4/30/2016 23:00",124,117,6,15,"Klarer Himmel",241,"wolbecker"
"5/1/2016 0:00",117,136,6,15,"Klarer Himmel",253,"wolbecker"
"5/1/2016 1:00",158,102,6,13,"wolkig",260,"wolbecker"
"5/1/2016 2:00",103,58,6,11,"wolkig",161,"wolbecker"
"5/1/2016 3:00",73,42,6,13,"wolkig",115,"wolbecker"
"5/1/2016 4:00",56,27,5,13,"wolkig",83,"wolbecker"
"5/1/2016 5:00",45,19,5,13,"wolkig",64,"wolbecker"
"5/1/2016 6:00",20,19,5,9,"wolkig",39,"wolbecker"
"5/1/2016 7:00",20,30,6,17,"wolkig",50,"wolbecker"
"5/1/2016 8:00",37,55,7,17,"wolkig",92,"wolbecker"
"5/1/2016 9:00",84,75,8,17,"wolkig",159,"wolbecker"
"5/1/2016 10:00",124,172,9,19,"wolkig",296,"wolbecker"
"5/1/2016 11:00",206,194,11,20,"teilweise bewölkt",400,"wolbecker"
"5/1/2016 12:00",266,210,12,19,"teilweise bewölkt",476,"wolbecker"
"5/1/2016 13:00",281,242,13,17,"teilweise bewölkt",523,"wolbecker"
"5/1/2016 14:00",326,248,13,19,"teilweise bewölkt",574,"wolbecker"
"5/1/2016 15:00",301,225,14,19,"teilweise bewölkt",526,"wolbecker"
"5/1/2016 16:00",262,271,14,17,"teilweise bewölkt",533,"wolbecker"
"5/1/2016 17:00",258,291,14,19,"Klarer Himmel",549,"wolbecker"
"5/1/2016 18:00",273,244,14,15,"Klarer Himmel",517,"wolbecker"
"5/1/2016 19:00",250,205,13,15,"Klarer Himmel",455,"wolbecker"
"5/1/2016 20:00",250,151,11,11,"Klarer Himmel",401,"wolbecker"
"5/1/2016 21:00",155,96,9,6,"Klarer Himmel",251,"wolbecker"
"5/1/2016 22:00",122,52,7,4,"Klarer Himmel",174,"wolbecker"
"5/1/2016 23:00",49,43,7,2,"Klarer Himmel",92,"wolbecker"
"5/2/2016 0:00",32,20,6,2,"Klarer Himmel",52,"wolbecker"
"5/2/2016 1:00",8,10,5,2,"Klarer Himmel",18,"wolbecker"
"5/2/2016 2:00",6,5,4,0,"Klarer Himmel",11,"wolbecker"
"5/2/2016 3:00",2,4,3,2,"Klarer Himmel",6,"wolbecker"
"5/2/2016 4:00",9,4,3,2,"Klarer Himmel",13,"wolbecker"
"5/2/2016 5:00",40,41,2,2,"Nebel",81,"wolbecker"
"5/2/2016 6:00",152,166,3,2,"Nebel",318,"wolbecker"
"5/2/2016 7:00",692,342,6,0,"Klarer Himmel",1034,"wolbecker"
"5/2/2016 8:00",605,250,9,6,"Klarer Himmel",855,"wolbecker"
"5/2/2016 9:00",563,213,12,4,"Klarer Himmel",776,"wolbecker"
"5/2/2016 10:00",380,203,14,2,NA,583,"wolbecker"
"5/2/2016 11:00",391,255,16,7,"teilweise bewölkt",646,"wolbecker"
"5/2/2016 12:00",423,336,18,11,"teilweise bewölkt",759,"wolbecker"
"5/2/2016 13:00",473,437,18,9,"Klarer Himmel",910,"wolbecker"
"5/2/2016 14:00",407,400,19,9,"Klarer Himmel",807,"wolbecker"
"5/2/2016 15:00",479,483,19,6,"Klarer Himmel",962,"wolbecker"
"5/2/2016 16:00",490,620,19,9,"Klarer Himmel",1110,"wolbecker"
"5/2/2016 17:00",557,652,19,11,"Klarer Himmel",1209,"wolbecker"
"5/2/2016 18:00",444,587,19,7,"Klarer Himmel",1031,"wolbecker"
"5/2/2016 19:00",366,543,17,7,"Klarer Himmel",909,"wolbecker"
"5/2/2016 20:00",219,337,15,7,"Klarer Himmel",556,"wolbecker"
"5/2/2016 21:00",164,218,13,4,"Klarer Himmel",382,"wolbecker"
"5/2/2016 22:00",137,146,12,6,"Klarer Himmel",283,"wolbecker"
"5/2/2016 23:00",64,77,11,2,"Klarer Himmel",141,"wolbecker"
"5/3/2016 0:00",22,25,13,7,"Klarer Himmel",47,"wolbecker"
"5/3/2016 1:00",15,11,13,9,"Klarer Himmel",26,"wolbecker"
"5/3/2016 2:00",3,5,12,9,"Klarer Himmel",8,"wolbecker"
"5/3/2016 3:00",3,4,12,7,"wolkig",7,"wolbecker"
"5/3/2016 4:00",5,13,12,7,"wolkig",18,"wolbecker"
"5/3/2016 5:00",35,52,12,7,"wolkig",87,"wolbecker"
"5/3/2016 6:00",147,185,9,17,"Regen",332,"wolbecker"
"5/3/2016 7:00",518,249,8,11,"Regen",767,"wolbecker"
"5/3/2016 8:00",549,227,9,11,"wolkig",776,"wolbecker"
"5/3/2016 9:00",492,205,9,20,"wolkig",697,"wolbecker"
"5/3/2016 10:00",344,180,11,17,"teilweise bewölkt",524,"wolbecker"
"5/3/2016 11:00",367,238,13,19,"teilweise bewölkt",605,"wolbecker"
"5/3/2016 12:00",320,324,12,26,"Regen",644,"wolbecker"
"5/3/2016 13:00",360,381,14,17,"teilweise bewölkt",741,"wolbecker"
"5/3/2016 14:00",328,386,14,24,"teilweise bewölkt",714,"wolbecker"
"5/3/2016 15:00",378,425,14,26,"teilweise bewölkt",803,"wolbecker"
"5/3/2016 16:00",421,509,14,24,"teilweise bewölkt",930,"wolbecker"
"5/3/2016 17:00",542,613,14,20,"Klarer Himmel",1155,"wolbecker"
"5/3/2016 18:00",411,544,14,22,"Klarer Himmel",955,"wolbecker"
"5/3/2016 19:00",372,481,12,26,"Klarer Himmel",853,"wolbecker"
"5/3/2016 20:00",251,346,11,13,"Klarer Himmel",597,"wolbecker"
"5/3/2016 21:00",135,188,10,11,"Klarer Himmel",323,"wolbecker"
"5/3/2016 22:00",139,145,8,9,"Klarer Himmel",284,"wolbecker"
"5/3/2016 23:00",89,114,6,4,"Klarer Himmel",203,"wolbecker"
"5/4/2016 0:00",30,40,5,4,"Klarer Himmel",70,"wolbecker"
"5/4/2016 1:00",13,10,4,2,"Klarer Himmel",23,"wolbecker"
"5/4/2016 2:00",2,4,3,0,"Klarer Himmel",6,"wolbecker"
"5/4/2016 3:00",2,6,2,2,"Klarer Himmel",8,"wolbecker"
"5/4/2016 4:00",4,6,2,4,"Nebel",10,"wolbecker"
"5/4/2016 5:00",47,48,1,0,"Nebel",95,"wolbecker"
"5/4/2016 6:00",167,193,1,0,"Nebel",360,"wolbecker"
"5/4/2016 7:00",763,333,5,2,"Klarer Himmel",1096,"wolbecker"
"5/4/2016 8:00",677,282,9,2,"teilweise bewölkt",959,"wolbecker"
"5/4/2016 9:00",598,215,10,9,"teilweise bewölkt",813,"wolbecker"
"5/4/2016 10:00",461,223,10,6,"teilweise bewölkt",684,"wolbecker"
"5/4/2016 11:00",450,317,12,11,"teilweise bewölkt",767,"wolbecker"
"5/4/2016 12:00",421,445,12,6,"teilweise bewölkt",866,"wolbecker"
"5/4/2016 13:00",441,479,13,9,"teilweise bewölkt",920,"wolbecker"
"5/4/2016 14:00",390,503,13,11,"Klarer Himmel",893,"wolbecker"
"5/4/2016 15:00",403,558,15,6,"Klarer Himmel",961,"wolbecker"
"5/4/2016 16:00",461,596,15,6,"Klarer Himmel",1057,"wolbecker"
"5/4/2016 17:00",534,617,15,9,"Klarer Himmel",1151,"wolbecker"
"5/4/2016 18:00",420,601,15,6,"Klarer Himmel",1021,"wolbecker"
"5/4/2016 19:00",357,503,14,7,"Klarer Himmel",860,"wolbecker"
"5/4/2016 20:00",284,351,12,4,"Klarer Himmel",635,"wolbecker"
"5/4/2016 21:00",186,216,10,4,"Klarer Himmel",402,"wolbecker"
"5/4/2016 22:00",186,198,7,4,"Klarer Himmel",384,"wolbecker"
"5/4/2016 23:00",152,143,8,4,"Klarer Himmel",295,"wolbecker"
"5/5/2016 0:00",114,121,7,4,"Klarer Himmel",235,"wolbecker"
"5/5/2016 1:00",92,126,6,6,"Klarer Himmel",218,"wolbecker"
"5/5/2016 2:00",63,87,4,4,"Klarer Himmel",150,"wolbecker"
"5/5/2016 3:00",50,48,5,6,"Klarer Himmel",98,"wolbecker"
"5/5/2016 4:00",58,31,4,4,"Klarer Himmel",89,"wolbecker"
"5/5/2016 5:00",32,23,3,4,"Klarer Himmel",55,"wolbecker"
"5/5/2016 6:00",38,25,7,7,"Klarer Himmel",63,"wolbecker"
"5/5/2016 7:00",28,61,9,7,"Klarer Himmel",89,"wolbecker"
"5/5/2016 8:00",68,91,11,9,"Klarer Himmel",159,"wolbecker"
"5/5/2016 9:00",132,91,13,9,"Klarer Himmel",223,"wolbecker"
"5/5/2016 10:00",185,191,14,17,"Klarer Himmel",376,"wolbecker"
"5/5/2016 11:00",166,171,16,17,"Klarer Himmel",337,"wolbecker"
"5/5/2016 12:00",209,229,17,11,"Klarer Himmel",438,"wolbecker"
"5/5/2016 13:00",277,221,18,11,"Klarer Himmel",498,"wolbecker"
"5/5/2016 14:00",313,312,18,13,"Klarer Himmel",625,"wolbecker"
"5/5/2016 15:00",276,285,18,19,"Klarer Himmel",561,"wolbecker"
"5/5/2016 16:00",269,288,19,13,"Klarer Himmel",557,"wolbecker"
"5/5/2016 17:00",346,290,19,15,"Klarer Himmel",636,"wolbecker"
"5/5/2016 18:00",287,267,19,13,"Klarer Himmel",554,"wolbecker"
"5/5/2016 19:00",268,240,18,7,"Klarer Himmel",508,"wolbecker"
"5/5/2016 20:00",255,198,17,6,"Klarer Himmel",453,"wolbecker"
"5/5/2016 21:00",169,114,15,7,"Klarer Himmel",283,"wolbecker"
"5/5/2016 22:00",128,93,14,6,"Klarer Himmel",221,"wolbecker"
"5/5/2016 23:00",102,57,13,7,"Klarer Himmel",159,"wolbecker"
"5/6/2016 0:00",44,44,13,7,"Klarer Himmel",88,"wolbecker"
"5/6/2016 1:00",21,18,13,7,"Klarer Himmel",39,"wolbecker"
"5/6/2016 2:00",7,11,12,7,"Klarer Himmel",18,"wolbecker"
"5/6/2016 3:00",5,7,12,7,"Klarer Himmel",12,"wolbecker"
"5/6/2016 4:00",3,7,11,7,"Klarer Himmel",10,"wolbecker"
"5/6/2016 5:00",35,27,11,7,"Klarer Himmel",62,"wolbecker"
"5/6/2016 6:00",109,88,12,7,"Klarer Himmel",197,"wolbecker"
"5/6/2016 7:00",287,150,13,9,"Klarer Himmel",437,"wolbecker"
"5/6/2016 8:00",434,171,15,11,"Klarer Himmel",605,"wolbecker"
"5/6/2016 9:00",435,201,17,17,"Klarer Himmel",636,"wolbecker"
"5/6/2016 10:00",456,214,18,17,"Klarer Himmel",670,"wolbecker"
"5/6/2016 11:00",467,306,20,13,"Klarer Himmel",773,"wolbecker"
"5/6/2016 12:00",476,439,21,19,"Klarer Himmel",915,"wolbecker"
"5/6/2016 13:00",440,480,23,20,"Klarer Himmel",920,"wolbecker"
"5/6/2016 14:00",452,566,23,19,"Klarer Himmel",1018,"wolbecker"
"5/6/2016 15:00",411,486,24,19,"Klarer Himmel",897,"wolbecker"
"5/6/2016 16:00",381,504,25,17,"Klarer Himmel",885,"wolbecker"
"5/6/2016 17:00",413,505,25,19,"Klarer Himmel",918,"wolbecker"
"5/6/2016 18:00",368,472,24,17,"Klarer Himmel",840,"wolbecker"
"5/6/2016 19:00",324,440,24,13,"Klarer Himmel",764,"wolbecker"
"5/6/2016 20:00",226,267,22,7,"Klarer Himmel",493,"wolbecker"
"5/6/2016 21:00",197,187,19,6,"Klarer Himmel",384,"wolbecker"
"5/6/2016 22:00",137,165,18,6,"Klarer Himmel",302,"wolbecker"
"5/6/2016 23:00",114,123,17,6,"Klarer Himmel",237,"wolbecker"
"5/7/2016 0:00",98,114,16,7,"Klarer Himmel",212,"wolbecker"
"5/7/2016 1:00",60,79,16,6,"Klarer Himmel",139,"wolbecker"
"5/7/2016 2:00",55,49,15,6,"Klarer Himmel",104,"wolbecker"
"5/7/2016 3:00",30,26,14,6,"Klarer Himmel",56,"wolbecker"
"5/7/2016 4:00",37,18,14,7,"Klarer Himmel",55,"wolbecker"
"5/7/2016 5:00",32,17,13,7,"Klarer Himmel",49,"wolbecker"
"5/7/2016 6:00",36,35,14,9,"Klarer Himmel",71,"wolbecker"
"5/7/2016 7:00",89,61,16,9,"Klarer Himmel",150,"wolbecker"
"5/7/2016 8:00",173,118,18,11,"Klarer Himmel",291,"wolbecker"
"5/7/2016 9:00",336,167,20,9,"Klarer Himmel",503,"wolbecker"
"5/7/2016 10:00",503,257,22,11,"Klarer Himmel",760,"wolbecker"
"5/7/2016 11:00",528,351,23,17,"Klarer Himmel",879,"wolbecker"
"5/7/2016 12:00",463,440,24,17,"Klarer Himmel",903,"wolbecker"
"5/7/2016 13:00",402,464,25,19,"Klarer Himmel",866,"wolbecker"
"5/7/2016 14:00",371,486,25,17,"Klarer Himmel",857,"wolbecker"
"5/7/2016 15:00",311,426,25,17,"Klarer Himmel",737,"wolbecker"
"5/7/2016 16:00",282,389,25,22,"Klarer Himmel",671,"wolbecker"
"5/7/2016 17:00",339,389,25,17,"Klarer Himmel",728,"wolbecker"
"5/7/2016 18:00",312,385,25,15,"Klarer Himmel",697,"wolbecker"
"5/7/2016 19:00",257,328,24,11,"Klarer Himmel",585,"wolbecker"
"5/7/2016 20:00",229,234,22,7,"Klarer Himmel",463,"wolbecker"
"5/7/2016 21:00",175,164,20,9,"Klarer Himmel",339,"wolbecker"
"5/7/2016 22:00",169,140,20,9,"Klarer Himmel",309,"wolbecker"
"5/7/2016 23:00",172,144,18,7,"Klarer Himmel",316,"wolbecker"
"5/8/2016 0:00",138,86,18,11,"Klarer Himmel",224,"wolbecker"
"5/8/2016 1:00",81,85,17,9,"Klarer Himmel",166,"wolbecker"
"5/8/2016 2:00",59,42,16,7,"Klarer Himmel",101,"wolbecker"
"5/8/2016 3:00",68,29,16,9,"Klarer Himmel",97,"wolbecker"
"5/8/2016 4:00",29,21,15,9,"Klarer Himmel",50,"wolbecker"
"5/8/2016 5:00",25,10,15,13,"Klarer Himmel",35,"wolbecker"
"5/8/2016 6:00",24,13,16,11,"Klarer Himmel",37,"wolbecker"
"5/8/2016 7:00",20,32,17,11,"Klarer Himmel",52,"wolbecker"
"5/8/2016 8:00",49,53,18,15,"Klarer Himmel",102,"wolbecker"
"5/8/2016 9:00",131,97,20,15,"Klarer Himmel",228,"wolbecker"
"5/8/2016 10:00",195,170,22,17,"Klarer Himmel",365,"wolbecker"
"5/8/2016 11:00",211,148,23,20,"Klarer Himmel",359,"wolbecker"
"5/8/2016 12:00",333,198,23,20,"Klarer Himmel",531,"wolbecker"
"5/8/2016 13:00",395,236,23,19,"Klarer Himmel",631,"wolbecker"
"5/8/2016 14:00",353,295,24,19,"Klarer Himmel",648,"wolbecker"
"5/8/2016 15:00",360,334,25,19,"Klarer Himmel",694,"wolbecker"
"5/8/2016 16:00",290,358,25,19,"Klarer Himmel",648,"wolbecker"
"5/8/2016 17:00",302,372,24,19,"Klarer Himmel",674,"wolbecker"
"5/8/2016 18:00",304,300,24,17,"Klarer Himmel",604,"wolbecker"
"5/8/2016 19:00",285,233,23,17,"Klarer Himmel",518,"wolbecker"
"5/8/2016 20:00",250,161,21,11,"Klarer Himmel",411,"wolbecker"
"5/8/2016 21:00",154,125,20,9,"Klarer Himmel",279,"wolbecker"
"5/8/2016 22:00",148,84,19,9,"Klarer Himmel",232,"wolbecker"
"5/8/2016 23:00",68,41,18,9,"Klarer Himmel",109,"wolbecker"
"5/9/2016 0:00",33,15,18,13,"Klarer Himmel",48,"wolbecker"
"5/9/2016 1:00",12,6,17,11,"Klarer Himmel",18,"wolbecker"
"5/9/2016 2:00",1,2,17,11,"Klarer Himmel",3,"wolbecker"
"5/9/2016 3:00",2,2,16,11,"Klarer Himmel",4,"wolbecker"
"5/9/2016 4:00",6,11,16,9,"Klarer Himmel",17,"wolbecker"
"5/9/2016 5:00",40,39,16,11,"Klarer Himmel",79,"wolbecker"
"5/9/2016 6:00",187,178,16,9,"Klarer Himmel",365,"wolbecker"
"5/9/2016 7:00",755,365,18,11,"Klarer Himmel",1120,"wolbecker"
"5/9/2016 8:00",702,295,19,15,"Klarer Himmel",997,"wolbecker"
"5/9/2016 9:00",557,230,19,13,"Klarer Himmel",787,"wolbecker"
"5/9/2016 10:00",425,232,21,13,"Klarer Himmel",657,"wolbecker"
"5/9/2016 11:00",395,292,22,19,"Klarer Himmel",687,"wolbecker"
"5/9/2016 12:00",356,403,22,17,"Klarer Himmel",759,"wolbecker"
"5/9/2016 13:00",409,395,23,17,"Klarer Himmel",804,"wolbecker"
"5/9/2016 14:00",380,425,24,17,"Klarer Himmel",805,"wolbecker"
"5/9/2016 15:00",474,526,25,20,"Klarer Himmel",1000,"wolbecker"
"5/9/2016 16:00",488,654,25,22,"Klarer Himmel",1142,"wolbecker"
"5/9/2016 17:00",640,622,25,20,"Klarer Himmel",1262,"wolbecker"
"5/9/2016 18:00",534,618,24,17,"Klarer Himmel",1152,"wolbecker"
"5/9/2016 19:00",408,488,23,11,"Klarer Himmel",896,"wolbecker"
"5/9/2016 20:00",248,348,21,7,"Klarer Himmel",596,"wolbecker"
"5/9/2016 21:00",179,246,20,7,"Klarer Himmel",425,"wolbecker"
"5/9/2016 22:00",158,173,19,7,"Klarer Himmel",331,"wolbecker"
"5/9/2016 23:00",73,86,18,9,"Klarer Himmel",159,"wolbecker"
"5/10/2016 0:00",34,36,18,7,"Klarer Himmel",70,"wolbecker"
"5/10/2016 1:00",19,10,17,9,"Klarer Himmel",29,"wolbecker"
"5/10/2016 2:00",3,6,17,9,"Klarer Himmel",9,"wolbecker"
"5/10/2016 3:00",3,12,16,7,"Klarer Himmel",15,"wolbecker"
"5/10/2016 4:00",10,14,16,7,"Klarer Himmel",24,"wolbecker"
"5/10/2016 5:00",38,52,16,9,"wolkig",90,"wolbecker"
"5/10/2016 6:00",215,202,16,9,"Klarer Himmel",417,"wolbecker"
"5/10/2016 7:00",813,388,17,9,"Klarer Himmel",1201,"wolbecker"
"5/10/2016 8:00",753,307,19,13,"Klarer Himmel",1060,"wolbecker"
"5/10/2016 9:00",593,224,21,11,"Klarer Himmel",817,"wolbecker"
"5/10/2016 10:00",419,238,22,13,"Klarer Himmel",657,"wolbecker"
"5/10/2016 11:00",397,258,23,20,"Klarer Himmel",655,"wolbecker"
"5/10/2016 12:00",350,394,24,20,"Klarer Himmel",744,"wolbecker"
"5/10/2016 13:00",394,452,24,13,"Klarer Himmel",846,"wolbecker"
"5/10/2016 14:00",363,461,24,13,"Klarer Himmel",824,"wolbecker"
"5/10/2016 15:00",456,516,24,15,"Klarer Himmel",972,"wolbecker"
"5/10/2016 16:00",483,658,24,13,"Klarer Himmel",1141,"wolbecker"
"5/10/2016 17:00",610,664,24,9,"Klarer Himmel",1274,"wolbecker"
"5/10/2016 18:00",502,662,23,9,"Klarer Himmel",1164,"wolbecker"
"5/10/2016 19:00",407,520,22,7,"Klarer Himmel",927,"wolbecker"
"5/10/2016 20:00",239,350,21,7,"Klarer Himmel",589,"wolbecker"
"5/10/2016 21:00",184,227,21,9,"Klarer Himmel",411,"wolbecker"
"5/10/2016 22:00",182,153,20,9,"Klarer Himmel",335,"wolbecker"
"5/10/2016 23:00",87,103,19,6,"Klarer Himmel",190,"wolbecker"
"5/11/2016 0:00",38,32,19,6,"Klarer Himmel",70,"wolbecker"
"5/11/2016 1:00",21,14,18,4,"Klarer Himmel",35,"wolbecker"
"5/11/2016 2:00",4,10,18,4,"Klarer Himmel",14,"wolbecker"
"5/11/2016 3:00",5,7,17,4,"Klarer Himmel",12,"wolbecker"
"5/11/2016 4:00",14,7,17,6,"Klarer Himmel",21,"wolbecker"
"5/11/2016 5:00",44,53,16,6,"Klarer Himmel",97,"wolbecker"
"5/11/2016 6:00",200,199,16,6,"Klarer Himmel",399,"wolbecker"
"5/11/2016 7:00",825,359,18,7,"Klarer Himmel",1184,"wolbecker"
"5/11/2016 8:00",749,312,19,7,"Klarer Himmel",1061,"wolbecker"
"5/11/2016 9:00",607,240,19,7,"Klarer Himmel",847,"wolbecker"
"5/11/2016 10:00",432,247,22,9,NA,679,"wolbecker"
"5/11/2016 11:00",457,302,23,11,"teilweise bewölkt",759,"wolbecker"
"5/11/2016 12:00",455,410,23,17,"Klarer Himmel",865,"wolbecker"
"5/11/2016 13:00",455,453,24,15,"Klarer Himmel",908,"wolbecker"
"5/11/2016 14:00",398,532,25,17,"Klarer Himmel",930,"wolbecker"
"5/11/2016 15:00",457,566,26,15,"Klarer Himmel",1023,"wolbecker"
"5/11/2016 16:00",482,625,25,19,"Klarer Himmel",1107,"wolbecker"
"5/11/2016 17:00",638,647,25,20,"Klarer Himmel",1285,"wolbecker"
"5/11/2016 18:00",516,627,24,17,"Klarer Himmel",1143,"wolbecker"
"5/11/2016 19:00",413,551,22,13,"Klarer Himmel",964,"wolbecker"
"5/11/2016 20:00",291,340,21,13,"Klarer Himmel",631,"wolbecker"
"5/11/2016 21:00",215,283,20,11,"Klarer Himmel",498,"wolbecker"
"5/11/2016 22:00",231,185,19,7,"Klarer Himmel",416,"wolbecker"
"5/11/2016 23:00",149,126,18,9,"Klarer Himmel",275,"wolbecker"
"5/12/2016 0:00",71,71,17,7,"Klarer Himmel",142,"wolbecker"
"5/12/2016 1:00",62,47,16,7,"Klarer Himmel",109,"wolbecker"
"5/12/2016 2:00",9,34,15,11,"Klarer Himmel",43,"wolbecker"
"5/12/2016 3:00",20,16,15,9,"Klarer Himmel",36,"wolbecker"
"5/12/2016 4:00",18,13,15,9,"Klarer Himmel",31,"wolbecker"
"5/12/2016 5:00",35,54,14,13,"Klarer Himmel",89,"wolbecker"
"5/12/2016 6:00",171,208,15,15,"Klarer Himmel",379,"wolbecker"
"5/12/2016 7:00",775,348,16,13,"Klarer Himmel",1123,"wolbecker"
"5/12/2016 8:00",703,294,18,15,"Klarer Himmel",997,"wolbecker"
"5/12/2016 9:00",624,188,20,19,"Klarer Himmel",812,"wolbecker"
"5/12/2016 10:00",408,211,21,19,"Klarer Himmel",619,"wolbecker"
"5/12/2016 11:00",381,337,22,19,"Klarer Himmel",718,"wolbecker"
"5/12/2016 12:00",380,411,24,17,"Klarer Himmel",791,"wolbecker"
"5/12/2016 13:00",425,487,24,22,"Klarer Himmel",912,"wolbecker"
"5/12/2016 14:00",406,456,24,20,"Klarer Himmel",862,"wolbecker"
"5/12/2016 15:00",452,566,24,19,"Klarer Himmel",1018,"wolbecker"
"5/12/2016 16:00",534,665,25,15,"Klarer Himmel",1199,"wolbecker"
"5/12/2016 17:00",605,677,23,17,"Klarer Himmel",1282,"wolbecker"
"5/12/2016 18:00",497,606,24,17,"Klarer Himmel",1103,"wolbecker"
"5/12/2016 19:00",424,495,23,15,"Klarer Himmel",919,"wolbecker"
"5/12/2016 20:00",257,306,21,7,"Klarer Himmel",563,"wolbecker"
"5/12/2016 21:00",196,271,19,11,"Klarer Himmel",467,"wolbecker"
"5/12/2016 22:00",200,221,19,19,"Klarer Himmel",421,"wolbecker"
"5/12/2016 23:00",147,130,18,17,"Klarer Himmel",277,"wolbecker"
"5/13/2016 0:00",85,65,17,11,"Klarer Himmel",150,"wolbecker"
"5/13/2016 1:00",39,35,16,11,"Klarer Himmel",74,"wolbecker"
"5/13/2016 2:00",18,27,15,15,"Klarer Himmel",45,"wolbecker"
"5/13/2016 3:00",16,20,14,17,"Klarer Himmel",36,"wolbecker"
"5/13/2016 4:00",14,17,13,13,"Klarer Himmel",31,"wolbecker"
"5/13/2016 5:00",36,45,11,11,"Klarer Himmel",81,"wolbecker"
"5/13/2016 6:00",150,178,12,11,"Klarer Himmel",328,"wolbecker"
"5/13/2016 7:00",701,317,13,17,"Klarer Himmel",1018,"wolbecker"
"5/13/2016 8:00",584,276,15,15,"Klarer Himmel",860,"wolbecker"
"5/13/2016 9:00",499,216,17,9,"Klarer Himmel",715,"wolbecker"
"5/13/2016 10:00",396,277,19,13,"Klarer Himmel",673,"wolbecker"
"5/13/2016 11:00",421,340,20,24,"Klarer Himmel",761,"wolbecker"
"5/13/2016 12:00",422,465,22,17,"Klarer Himmel",887,"wolbecker"
"5/13/2016 13:00",430,569,22,22,"Klarer Himmel",999,"wolbecker"
"5/13/2016 14:00",459,527,22,24,"Klarer Himmel",986,"wolbecker"
"5/13/2016 15:00",496,495,23,22,"Klarer Himmel",991,"wolbecker"
"5/13/2016 16:00",433,524,21,24,"Klarer Himmel",957,"wolbecker"
"5/13/2016 17:00",416,522,22,24,"Klarer Himmel",938,"wolbecker"
"5/13/2016 18:00",376,440,21,26,"Klarer Himmel",816,"wolbecker"
"5/13/2016 19:00",289,392,19,24,"Klarer Himmel",681,"wolbecker"
"5/13/2016 20:00",228,326,16,20,"Klarer Himmel",554,"wolbecker"
"5/13/2016 21:00",173,225,13,22,"Klarer Himmel",398,"wolbecker"
"5/13/2016 22:00",147,148,11,24,"Klarer Himmel",295,"wolbecker"
"5/13/2016 23:00",110,117,9,20,"Klarer Himmel",227,"wolbecker"
"5/14/2016 0:00",95,78,9,19,"wolkig",173,"wolbecker"
"5/14/2016 1:00",71,91,8,20,"wolkig",162,"wolbecker"
"5/14/2016 2:00",39,31,8,15,"wolkig",70,"wolbecker"
"5/14/2016 3:00",46,32,8,15,"wolkig",78,"wolbecker"
"5/14/2016 4:00",39,25,8,13,"wolkig",64,"wolbecker"
"5/14/2016 5:00",32,25,7,11,"wolkig",57,"wolbecker"
"5/14/2016 6:00",32,30,7,9,"wolkig",62,"wolbecker"
"5/14/2016 7:00",98,70,8,17,"wolkig",168,"wolbecker"
"5/14/2016 8:00",137,96,8,19,"wolkig",233,"wolbecker"
"5/14/2016 9:00",256,123,9,19,"wolkig",379,"wolbecker"
"5/14/2016 10:00",361,223,10,20,"wolkig",584,"wolbecker"
"5/14/2016 11:00",412,234,10,19,"teilweise bewölkt",646,"wolbecker"
"5/14/2016 12:00",382,313,11,20,"wolkig",695,"wolbecker"
"5/14/2016 13:00",356,340,11,22,"wolkig",696,"wolbecker"
"5/14/2016 14:00",298,361,12,19,"teilweise bewölkt",659,"wolbecker"
"5/14/2016 15:00",242,343,11,20,"teilweise bewölkt",585,"wolbecker"
"5/14/2016 16:00",177,260,9,20,"Regen",437,"wolbecker"
"5/14/2016 17:00",172,299,10,20,"Regen",471,"wolbecker"
"5/14/2016 18:00",174,290,9,20,"Regen",464,"wolbecker"
"5/14/2016 19:00",165,202,9,20,"Regen",367,"wolbecker"
"5/14/2016 20:00",138,171,8,15,"teilweise bewölkt",309,"wolbecker"
"5/14/2016 21:00",99,91,7,19,"teilweise bewölkt",190,"wolbecker"
"5/14/2016 22:00",96,79,7,17,"Regen",175,"wolbecker"
"5/14/2016 23:00",78,66,5,15,"teilweise bewölkt",144,"wolbecker"
"5/15/2016 0:00",62,81,5,19,"Klarer Himmel",143,"wolbecker"
"5/15/2016 1:00",50,78,5,15,"teilweise bewölkt",128,"wolbecker"
"5/15/2016 2:00",38,35,5,13,"teilweise bewölkt",73,"wolbecker"
"5/15/2016 3:00",32,23,5,15,"teilweise bewölkt",55,"wolbecker"
"5/15/2016 4:00",41,14,4,15,"teilweise bewölkt",55,"wolbecker"
"5/15/2016 5:00",27,19,4,15,"teilweise bewölkt",46,"wolbecker"
"5/15/2016 6:00",25,18,6,19,"teilweise bewölkt",43,"wolbecker"
"5/15/2016 7:00",26,29,7,20,"teilweise bewölkt",55,"wolbecker"
"5/15/2016 8:00",32,29,8,22,"wolkig",61,"wolbecker"
"5/15/2016 9:00",60,54,9,22,"teilweise bewölkt",114,"wolbecker"
"5/15/2016 10:00",84,83,10,26,"wolkig",167,"wolbecker"
"5/15/2016 11:00",120,81,8,13,"teilweise bewölkt",201,"wolbecker"
"5/15/2016 12:00",94,93,8,15,"teilweise bewölkt",187,"wolbecker"
"5/15/2016 13:00",108,117,12,24,"teilweise bewölkt",225,"wolbecker"
"5/15/2016 14:00",119,103,10,22,"Regen",222,"wolbecker"
"5/15/2016 15:00",100,88,12,28,"teilweise bewölkt",188,"wolbecker"
"5/15/2016 16:00",149,119,10,20,"Regen",268,"wolbecker"
"5/15/2016 17:00",110,120,9,9,"wolkig",230,"wolbecker"
"5/15/2016 18:00",121,161,10,11,"wolkig",282,"wolbecker"
"5/15/2016 19:00",135,117,9,22,"wolkig",252,"wolbecker"
"5/15/2016 20:00",111,100,8,15,"teilweise bewölkt",211,"wolbecker"
"5/15/2016 21:00",90,78,7,11,"teilweise bewölkt",168,"wolbecker"
"5/15/2016 22:00",83,52,6,9,"Klarer Himmel",135,"wolbecker"
"5/15/2016 23:00",57,45,5,7,"Klarer Himmel",102,"wolbecker"
"5/16/2016 0:00",35,34,4,6,"Klarer Himmel",69,"wolbecker"
"5/16/2016 1:00",26,30,3,6,"Klarer Himmel",56,"wolbecker"
"5/16/2016 2:00",22,22,3,7,"Klarer Himmel",44,"wolbecker"
"5/16/2016 3:00",11,10,2,7,"Klarer Himmel",21,"wolbecker"
"5/16/2016 4:00",21,5,3,6,"Nebel",26,"wolbecker"
"5/16/2016 5:00",19,9,3,6,"Nebel",28,"wolbecker"
"5/16/2016 6:00",18,16,3,2,"Nebel",34,"wolbecker"
"5/16/2016 7:00",27,25,6,9,"teilweise bewölkt",52,"wolbecker"
"5/16/2016 8:00",30,42,8,9,"wolkig",72,"wolbecker"
"5/16/2016 9:00",73,73,9,13,"wolkig",146,"wolbecker"
"5/16/2016 10:00",105,102,10,15,"teilweise bewölkt",207,"wolbecker"
"5/16/2016 11:00",135,111,11,9,"teilweise bewölkt",246,"wolbecker"
"5/16/2016 12:00",167,112,11,11,"teilweise bewölkt",279,"wolbecker"
"5/16/2016 13:00",146,121,12,13,"wolkig",267,"wolbecker"
"5/16/2016 14:00",190,167,12,19,"wolkig",357,"wolbecker"
"5/16/2016 15:00",200,158,13,20,"wolkig",358,"wolbecker"
"5/16/2016 16:00",166,191,12,22,"wolkig",357,"wolbecker"
"5/16/2016 17:00",176,191,12,26,"wolkig",367,"wolbecker"
"5/16/2016 18:00",182,167,12,13,"teilweise bewölkt",349,"wolbecker"
"5/16/2016 19:00",144,147,11,17,"wolkig",291,"wolbecker"
"5/16/2016 20:00",142,117,11,13,"wolkig",259,"wolbecker"
"5/16/2016 21:00",102,67,10,17,"wolkig",169,"wolbecker"
"5/16/2016 22:00",102,60,9,15,"Klarer Himmel",162,"wolbecker"
"5/16/2016 23:00",53,49,9,11,"Klarer Himmel",102,"wolbecker"
"5/17/2016 0:00",34,11,9,11,"wolkig",45,"wolbecker"
"5/17/2016 1:00",9,7,9,11,"wolkig",16,"wolbecker"
"5/17/2016 2:00",3,3,8,11,"wolkig",6,"wolbecker"
"5/17/2016 3:00",3,3,8,11,"wolkig",6,"wolbecker"
"5/17/2016 4:00",5,9,9,13,"wolkig",14,"wolbecker"
"5/17/2016 5:00",40,35,9,11,"wolkig",75,"wolbecker"
"5/17/2016 6:00",138,113,9,11,"wolkig",251,"wolbecker"
"5/17/2016 7:00",336,222,9,11,"wolkig",558,"wolbecker"
"5/17/2016 8:00",514,262,10,11,"wolkig",776,"wolbecker"
"5/17/2016 9:00",401,184,11,11,"wolkig",585,"wolbecker"
"5/17/2016 10:00",327,178,12,11,"teilweise bewölkt",505,"wolbecker"
"5/17/2016 11:00",317,260,14,20,"teilweise bewölkt",577,"wolbecker"
"5/17/2016 12:00",325,305,15,19,"wolkig",630,"wolbecker"
"5/17/2016 13:00",326,305,15,19,"wolkig",631,"wolbecker"
"5/17/2016 14:00",328,332,15,17,"teilweise bewölkt",660,"wolbecker"
"5/17/2016 15:00",347,365,17,17,"teilweise bewölkt",712,"wolbecker"
"5/17/2016 16:00",371,515,16,17,"wolkig",886,"wolbecker"
"5/17/2016 17:00",466,536,17,26,"wolkig",1002,"wolbecker"
"5/17/2016 18:00",432,477,16,17,"wolkig",909,"wolbecker"
"5/17/2016 19:00",306,413,16,9,"teilweise bewölkt",719,"wolbecker"
"5/17/2016 20:00",184,272,15,6,"Klarer Himmel",456,"wolbecker"
"5/17/2016 21:00",138,175,12,9,"teilweise bewölkt",313,"wolbecker"
"5/17/2016 22:00",130,122,13,6,"teilweise bewölkt",252,"wolbecker"
"5/17/2016 23:00",83,71,12,11,"Klarer Himmel",154,"wolbecker"
"5/18/2016 0:00",46,38,11,7,"Klarer Himmel",84,"wolbecker"
"5/18/2016 1:00",20,16,9,2,"Klarer Himmel",36,"wolbecker"
"5/18/2016 2:00",6,8,8,4,"teilweise bewölkt",14,"wolbecker"
"5/18/2016 3:00",10,3,10,7,"wolkig",13,"wolbecker"
"5/18/2016 4:00",15,11,10,7,"teilweise bewölkt",26,"wolbecker"
"5/18/2016 5:00",43,57,10,4,"Klarer Himmel",100,"wolbecker"
"5/18/2016 6:00",176,192,10,6,"Klarer Himmel",368,"wolbecker"
"5/18/2016 7:00",641,333,11,7,"wolkig",974,"wolbecker"
"5/18/2016 8:00",583,273,12,7,"wolkig",856,"wolbecker"
"5/18/2016 9:00",481,193,15,15,"wolkig",674,"wolbecker"
"5/18/2016 10:00",411,205,16,15,"teilweise bewölkt",616,"wolbecker"
"5/18/2016 11:00",337,313,17,17,"wolkig",650,"wolbecker"
"5/18/2016 12:00",400,333,18,15,"wolkig",733,"wolbecker"
"5/18/2016 13:00",361,403,18,17,"wolkig",764,"wolbecker"
"5/18/2016 14:00",332,446,18,13,"Regen",778,"wolbecker"
"5/18/2016 15:00",390,396,18,6,"wolkig",786,"wolbecker"
"5/18/2016 16:00",407,484,18,9,"wolkig",891,"wolbecker"
"5/18/2016 17:00",491,602,19,15,"wolkig",1093,"wolbecker"
"5/18/2016 18:00",417,478,16,17,"Regen",895,"wolbecker"
"5/18/2016 19:00",295,400,15,9,"wolkig",695,"wolbecker"
"5/18/2016 20:00",220,244,15,4,NA,464,"wolbecker"
"5/18/2016 21:00",141,170,14,6,"wolkig",311,"wolbecker"
"5/18/2016 22:00",138,107,14,6,"wolkig",245,"wolbecker"
"5/18/2016 23:00",106,103,14,4,"wolkig",209,"wolbecker"
"5/19/2016 0:00",47,50,12,4,"Regen",97,"wolbecker"
"5/19/2016 1:00",22,23,13,6,"wolkig",45,"wolbecker"
"5/19/2016 2:00",4,20,12,6,"Klarer Himmel",24,"wolbecker"
"5/19/2016 3:00",10,20,11,2,"Klarer Himmel",30,"wolbecker"
"5/19/2016 4:00",12,14,10,2,"Klarer Himmel",26,"wolbecker"
"5/19/2016 5:00",52,52,8,2,"Nebel",104,"wolbecker"
"5/19/2016 6:00",155,184,9,0,"Nebel",339,"wolbecker"
"5/19/2016 7:00",627,324,12,2,"Regen",951,"wolbecker"
"5/19/2016 8:00",571,272,13,15,"Klarer Himmel",843,"wolbecker"
"5/19/2016 9:00",476,175,13,13,"wolkig",651,"wolbecker"
"5/19/2016 10:00",291,205,15,11,"wolkig",496,"wolbecker"
"5/19/2016 11:00",230,206,16,11,"wolkig",436,"wolbecker"
"5/19/2016 12:00",349,328,17,13,"wolkig",677,"wolbecker"
"5/19/2016 13:00",326,388,17,15,"wolkig",714,"wolbecker"
"5/19/2016 14:00",399,387,18,20,"wolkig",786,"wolbecker"
"5/19/2016 15:00",392,447,18,19,"wolkig",839,"wolbecker"
"5/19/2016 16:00",452,520,18,17,"teilweise bewölkt",972,"wolbecker"
"5/19/2016 17:00",529,634,19,19,"teilweise bewölkt",1163,"wolbecker"
"5/19/2016 18:00",519,577,18,17,"teilweise bewölkt",1096,"wolbecker"
"5/19/2016 19:00",372,471,18,15,"teilweise bewölkt",843,"wolbecker"
"5/19/2016 20:00",220,337,17,11,"Klarer Himmel",557,"wolbecker"
"5/19/2016 21:00",171,199,14,7,"Klarer Himmel",370,"wolbecker"
"5/19/2016 22:00",196,154,10,6,"Klarer Himmel",350,"wolbecker"
"5/19/2016 23:00",89,85,10,4,"Klarer Himmel",174,"wolbecker"
"5/20/2016 0:00",43,52,10,7,"Klarer Himmel",95,"wolbecker"
"5/20/2016 1:00",20,25,10,11,"Klarer Himmel",45,"wolbecker"
"5/20/2016 2:00",4,11,10,11,"Klarer Himmel",15,"wolbecker"
"5/20/2016 3:00",8,2,10,9,"Klarer Himmel",10,"wolbecker"
"5/20/2016 4:00",6,7,11,11,"Klarer Himmel",13,"wolbecker"
"5/20/2016 5:00",51,39,10,11,"Klarer Himmel",90,"wolbecker"
"5/20/2016 6:00",158,175,11,13,"Klarer Himmel",333,"wolbecker"
"5/20/2016 7:00",653,348,12,15,"wolkig",1001,"wolbecker"
"5/20/2016 8:00",512,236,12,15,"Regen",748,"wolbecker"
"5/20/2016 9:00",394,181,12,15,"wolkig",575,"wolbecker"
"5/20/2016 10:00",308,191,14,13,"Regen",499,"wolbecker"
"5/20/2016 11:00",317,271,14,22,"wolkig",588,"wolbecker"
"5/20/2016 12:00",332,360,15,24,"wolkig",692,"wolbecker"
"5/20/2016 13:00",353,498,16,20,"wolkig",851,"wolbecker"
"5/20/2016 14:00",398,479,14,15,"Regen",877,"wolbecker"
"5/20/2016 15:00",390,434,15,20,"Regen",824,"wolbecker"
"5/20/2016 16:00",380,434,15,9,"wolkig",814,"wolbecker"
"5/20/2016 17:00",356,492,15,13,"wolkig",848,"wolbecker"
"5/20/2016 18:00",283,414,15,11,"wolkig",697,"wolbecker"
"5/20/2016 19:00",267,301,15,9,"wolkig",568,"wolbecker"
"5/20/2016 20:00",219,193,15,9,"Klarer Himmel",412,"wolbecker"
"5/20/2016 21:00",146,179,14,9,"Klarer Himmel",325,"wolbecker"
"5/20/2016 22:00",120,171,14,9,"wolkig",291,"wolbecker"
"5/20/2016 23:00",98,100,14,9,"wolkig",198,"wolbecker"
"5/21/2016 0:00",91,89,14,9,"Klarer Himmel",180,"wolbecker"
"5/21/2016 1:00",83,74,14,13,"wolkig",157,"wolbecker"
"5/21/2016 2:00",57,50,14,13,"wolkig",107,"wolbecker"
"5/21/2016 3:00",42,28,12,7,"Klarer Himmel",70,"wolbecker"
"5/21/2016 4:00",36,35,12,7,"Klarer Himmel",71,"wolbecker"
"5/21/2016 5:00",42,19,11,6,"Nebel",61,"wolbecker"
"5/21/2016 6:00",55,42,12,7,NA,97,"wolbecker"
"5/21/2016 7:00",113,72,14,9,"Klarer Himmel",185,"wolbecker"
"5/21/2016 8:00",205,110,15,15,"Klarer Himmel",315,"wolbecker"
"5/21/2016 9:00",392,185,17,15,"wolkig",577,"wolbecker"
"5/21/2016 10:00",465,283,18,15,"wolkig",748,"wolbecker"
"5/21/2016 11:00",526,304,19,17,"wolkig",830,"wolbecker"
"5/21/2016 12:00",547,399,20,19,"wolkig",946,"wolbecker"
"5/21/2016 13:00",435,421,22,19,"wolkig",856,"wolbecker"
"5/21/2016 14:00",445,473,23,19,"Klarer Himmel",918,"wolbecker"
"5/21/2016 15:00",510,412,23,22,"wolkig",922,"wolbecker"
"5/21/2016 16:00",328,379,22,20,"Klarer Himmel",707,"wolbecker"
"5/21/2016 17:00",298,471,23,19,"Klarer Himmel",769,"wolbecker"
"5/21/2016 18:00",298,548,23,15,"Klarer Himmel",846,"wolbecker"
"5/21/2016 19:00",284,412,22,13,"Klarer Himmel",696,"wolbecker"
"5/21/2016 20:00",187,230,20,6,"Klarer Himmel",417,"wolbecker"
"5/21/2016 21:00",117,146,19,6,"Klarer Himmel",263,"wolbecker"
"5/21/2016 22:00",157,103,17,4,"Klarer Himmel",260,"wolbecker"
"5/21/2016 23:00",184,221,18,9,"Klarer Himmel",405,"wolbecker"
"5/22/2016 0:00",113,136,18,7,"Klarer Himmel",249,"wolbecker"
"5/22/2016 1:00",119,141,17,7,"Klarer Himmel",260,"wolbecker"
"5/22/2016 2:00",89,82,16,9,"Klarer Himmel",171,"wolbecker"
"5/22/2016 3:00",67,41,15,7,"Klarer Himmel",108,"wolbecker"
"5/22/2016 4:00",75,31,14,7,"Klarer Himmel",106,"wolbecker"
"5/22/2016 5:00",36,9,14,7,"Klarer Himmel",45,"wolbecker"
"5/22/2016 6:00",26,21,15,9,"Klarer Himmel",47,"wolbecker"
"5/22/2016 7:00",22,34,17,11,"Klarer Himmel",56,"wolbecker"
"5/22/2016 8:00",51,47,19,13,"Klarer Himmel",98,"wolbecker"
"5/22/2016 9:00",127,78,21,13,"Klarer Himmel",205,"wolbecker"
"5/22/2016 10:00",141,122,23,13,"Klarer Himmel",263,"wolbecker"
"5/22/2016 11:00",178,132,24,20,"Klarer Himmel",310,"wolbecker"
"5/22/2016 12:00",191,178,23,22,"wolkig",369,"wolbecker"
"5/22/2016 13:00",221,181,22,32,"wolkig",402,"wolbecker"
"5/22/2016 14:00",206,170,23,24,"wolkig",376,"wolbecker"
"5/22/2016 15:00",213,218,22,20,"Regen",431,"wolbecker"
"5/22/2016 16:00",202,182,20,22,"Klarer Himmel",384,"wolbecker"
"5/22/2016 17:00",194,188,19,17,"Regen",382,"wolbecker"
"5/22/2016 18:00",188,130,17,20,"Regen",318,"wolbecker"
"5/22/2016 19:00",161,102,16,6,"Regen",263,"wolbecker"
"5/22/2016 20:00",115,89,15,4,"wolkig",204,"wolbecker"
"5/22/2016 21:00",104,66,15,7,"Klarer Himmel",170,"wolbecker"
"5/22/2016 22:00",108,47,15,7,"Regen",155,"wolbecker"
"5/22/2016 23:00",32,22,15,7,"wolkig",54,"wolbecker"
"5/23/2016 0:00",27,22,15,7,"wolkig",49,"wolbecker"
"5/23/2016 1:00",15,12,15,7,"wolkig",27,"wolbecker"
"5/23/2016 2:00",0,6,15,4,"Regen",6,"wolbecker"
"5/23/2016 3:00",4,2,15,6,"Klarer Himmel",6,"wolbecker"
"5/23/2016 4:00",9,3,15,4,"Nebel",12,"wolbecker"
"5/23/2016 5:00",40,48,15,6,"wolkig",88,"wolbecker"
"5/23/2016 6:00",153,169,15,4,"wolkig",322,"wolbecker"
"5/23/2016 7:00",641,291,15,6,"wolkig",932,"wolbecker"
"5/23/2016 8:00",569,258,15,11,"Regen",827,"wolbecker"
"5/23/2016 9:00",468,161,15,11,"Regen",629,"wolbecker"
"5/23/2016 10:00",312,180,16,13,"Regen",492,"wolbecker"
"5/23/2016 11:00",332,252,15,17,"wolkig",584,"wolbecker"
"5/23/2016 12:00",313,319,15,15,"wolkig",632,"wolbecker"
"5/23/2016 13:00",349,365,15,15,"wolkig",714,"wolbecker"
"5/23/2016 14:00",341,367,15,13,"wolkig",708,"wolbecker"
"5/23/2016 15:00",456,411,15,13,"wolkig",867,"wolbecker"
"5/23/2016 16:00",468,551,15,11,"wolkig",1019,"wolbecker"
"5/23/2016 17:00",481,591,15,7,"wolkig",1072,"wolbecker"
"5/23/2016 18:00",365,563,13,20,"Regen",928,"wolbecker"
"5/23/2016 19:00",282,400,12,17,"Regen",682,"wolbecker"
"5/23/2016 20:00",199,238,12,17,"Regen",437,"wolbecker"
"5/23/2016 21:00",120,151,11,20,"wolkig",271,"wolbecker"
"5/23/2016 22:00",100,106,11,17,"wolkig",206,"wolbecker"
"5/23/2016 23:00",71,52,11,20,"wolkig",123,"wolbecker"
"5/24/2016 0:00",25,23,11,15,"wolkig",48,"wolbecker"
"5/24/2016 1:00",14,12,11,17,"wolkig",26,"wolbecker"
"5/24/2016 2:00",5,6,10,19,"wolkig",11,"wolbecker"
"5/24/2016 3:00",3,4,10,17,"wolkig",7,"wolbecker"
"5/24/2016 4:00",4,3,10,15,"wolkig",7,"wolbecker"
"5/24/2016 5:00",34,43,10,17,"wolkig",77,"wolbecker"
"5/24/2016 6:00",164,185,10,13,"wolkig",349,"wolbecker"
"5/24/2016 7:00",691,349,10,17,"wolkig",1040,"wolbecker"
"5/24/2016 8:00",678,281,10,15,"wolkig",959,"wolbecker"
"5/24/2016 9:00",514,174,11,17,"wolkig",688,"wolbecker"
"5/24/2016 10:00",346,208,11,19,"wolkig",554,"wolbecker"
"5/24/2016 11:00",335,247,11,15,"wolkig",582,"wolbecker"
"5/24/2016 12:00",309,359,12,15,"wolkig",668,"wolbecker"
"5/24/2016 13:00",364,379,11,19,"Regen",743,"wolbecker"
"5/24/2016 14:00",337,394,11,15,"wolkig",731,"wolbecker"
"5/24/2016 15:00",418,473,12,17,"wolkig",891,"wolbecker"
"5/24/2016 16:00",413,612,12,15,"Regen",1025,"wolbecker"
"5/24/2016 17:00",510,619,11,17,"Regen",1129,"wolbecker"
"5/24/2016 18:00",461,581,11,7,"wolkig",1042,"wolbecker"
"5/24/2016 19:00",333,480,11,9,"wolkig",813,"wolbecker"
"5/24/2016 20:00",241,269,10,9,"wolkig",510,"wolbecker"
"5/24/2016 21:00",176,210,10,11,"wolkig",386,"wolbecker"
"5/24/2016 22:00",180,154,10,6,"wolkig",334,"wolbecker"
"5/24/2016 23:00",84,88,10,7,"wolkig",172,"wolbecker"
"5/25/2016 0:00",37,39,10,9,"wolkig",76,"wolbecker"
"5/25/2016 1:00",7,23,10,6,"wolkig",30,"wolbecker"
"5/25/2016 2:00",7,4,10,6,"Regen",11,"wolbecker"
"5/25/2016 3:00",7,1,10,6,"wolkig",8,"wolbecker"
"5/25/2016 4:00",6,8,10,9,"wolkig",14,"wolbecker"
"5/25/2016 5:00",37,55,10,7,"wolkig",92,"wolbecker"
"5/25/2016 6:00",169,183,10,7,"wolkig",352,"wolbecker"
"5/25/2016 7:00",703,344,10,7,"wolkig",1047,"wolbecker"
"5/25/2016 8:00",603,318,11,7,"wolkig",921,"wolbecker"
"5/25/2016 9:00",565,236,11,7,"wolkig",801,"wolbecker"
"5/25/2016 10:00",417,268,12,7,"wolkig",685,"wolbecker"
"5/25/2016 11:00",408,346,13,9,"wolkig",754,"wolbecker"
"5/25/2016 12:00",411,428,13,9,"wolkig",839,"wolbecker"
"5/25/2016 13:00",430,417,14,9,"wolkig",847,"wolbecker"
"5/25/2016 14:00",383,475,15,11,"wolkig",858,"wolbecker"
"5/25/2016 15:00",411,513,15,11,"wolkig",924,"wolbecker"
"5/25/2016 16:00",432,592,16,9,"wolkig",1024,"wolbecker"
"5/25/2016 17:00",557,600,16,6,"wolkig",1157,"wolbecker"
"5/25/2016 18:00",447,544,15,4,"wolkig",991,"wolbecker"
"5/25/2016 19:00",343,472,15,4,"wolkig",815,"wolbecker"
"5/25/2016 20:00",282,326,14,2,"wolkig",608,"wolbecker"
"5/25/2016 21:00",173,249,13,4,"wolkig",422,"wolbecker"
"5/25/2016 22:00",163,161,13,2,"wolkig",324,"wolbecker"
"5/25/2016 23:00",137,169,13,4,"wolkig",306,"wolbecker"
"5/26/2016 0:00",127,147,13,4,"wolkig",274,"wolbecker"
"5/26/2016 1:00",116,186,12,6,"wolkig",302,"wolbecker"
"5/26/2016 2:00",116,141,11,2,"wolkig",257,"wolbecker"
"5/26/2016 3:00",91,63,12,4,"wolkig",154,"wolbecker"
"5/26/2016 4:00",95,41,12,4,"wolkig",136,"wolbecker"
"5/26/2016 5:00",72,31,12,2,"wolkig",103,"wolbecker"
"5/26/2016 6:00",30,42,12,4,"wolkig",72,"wolbecker"
"5/26/2016 7:00",43,72,13,4,"wolkig",115,"wolbecker"
"5/26/2016 8:00",66,110,15,2,"Klarer Himmel",176,"wolbecker"
"5/26/2016 9:00",109,99,17,4,"teilweise bewölkt",208,"wolbecker"
"5/26/2016 10:00",185,149,17,4,"teilweise bewölkt",334,"wolbecker"
"5/26/2016 11:00",162,179,18,9,"teilweise bewölkt",341,"wolbecker"
"5/26/2016 12:00",196,174,19,6,"teilweise bewölkt",370,"wolbecker"
"5/26/2016 13:00",214,235,19,6,"Klarer Himmel",449,"wolbecker"
"5/26/2016 14:00",242,227,18,9,"wolkig",469,"wolbecker"
"5/26/2016 15:00",291,228,18,11,"wolkig",519,"wolbecker"
"5/26/2016 16:00",277,283,19,7,"wolkig",560,"wolbecker"
"5/26/2016 17:00",278,312,20,6,"teilweise bewölkt",590,"wolbecker"
"5/26/2016 18:00",296,275,20,6,"teilweise bewölkt",571,"wolbecker"
"5/26/2016 19:00",313,242,19,11,"wolkig",555,"wolbecker"
"5/26/2016 20:00",221,204,17,13,"Klarer Himmel",425,"wolbecker"
"5/26/2016 21:00",174,131,16,7,"Klarer Himmel",305,"wolbecker"
"5/26/2016 22:00",156,102,15,9,"Klarer Himmel",258,"wolbecker"
"5/26/2016 23:00",101,71,14,9,NA,172,"wolbecker"
"5/27/2016 0:00",43,58,14,9,NA,101,"wolbecker"
"5/27/2016 1:00",22,30,13,11,NA,52,"wolbecker"
"5/27/2016 2:00",7,20,12,9,NA,27,"wolbecker"
"5/27/2016 3:00",8,5,12,7,NA,13,"wolbecker"
"5/27/2016 4:00",4,5,12,9,NA,9,"wolbecker"
"5/27/2016 5:00",25,37,11,7,NA,62,"wolbecker"
"5/27/2016 6:00",96,98,13,7,NA,194,"wolbecker"
"5/27/2016 7:00",298,168,13,11,NA,466,"wolbecker"
"5/27/2016 8:00",378,169,14,13,NA,547,"wolbecker"
"5/27/2016 9:00",416,167,15,11,"wolkig",583,"wolbecker"
"5/27/2016 10:00",380,252,16,13,"wolkig",632,"wolbecker"
"5/27/2016 11:00",402,269,16,15,"wolkig",671,"wolbecker"
"5/27/2016 12:00",442,350,16,19,"wolkig",792,"wolbecker"
"5/27/2016 13:00",360,422,18,15,"wolkig",782,"wolbecker"
"5/27/2016 14:00",397,448,18,13,"wolkig",845,"wolbecker"
"5/27/2016 15:00",337,454,19,15,"wolkig",791,"wolbecker"
"5/27/2016 16:00",347,465,19,11,"wolkig",812,"wolbecker"
"5/27/2016 17:00",386,502,20,13,"wolkig",888,"wolbecker"
"5/27/2016 18:00",297,470,21,11,"teilweise bewölkt",767,"wolbecker"
"5/27/2016 19:00",264,523,19,11,"wolkig",787,"wolbecker"
"5/27/2016 20:00",231,412,19,6,"wolkig",643,"wolbecker"
"5/27/2016 21:00",241,239,17,6,"teilweise bewölkt",480,"wolbecker"
"5/27/2016 22:00",259,142,15,4,"Klarer Himmel",401,"wolbecker"
"5/27/2016 23:00",287,108,14,4,"Klarer Himmel",395,"wolbecker"
"5/28/2016 0:00",233,70,14,2,"Klarer Himmel",303,"wolbecker"
"5/28/2016 1:00",145,58,14,6,"Klarer Himmel",203,"wolbecker"
"5/28/2016 2:00",86,32,14,6,"Klarer Himmel",118,"wolbecker"
"5/28/2016 3:00",46,22,14,6,NA,68,"wolbecker"
"5/28/2016 4:00",42,16,14,2,NA,58,"wolbecker"
"5/28/2016 5:00",32,20,14,4,NA,52,"wolbecker"
"5/28/2016 6:00",40,23,15,6,NA,63,"wolbecker"
"5/28/2016 7:00",83,54,16,4,NA,137,"wolbecker"
"5/28/2016 8:00",154,110,18,7,"teilweise bewölkt",264,"wolbecker"
"5/28/2016 9:00",317,158,20,6,"teilweise bewölkt",475,"wolbecker"
"5/28/2016 10:00",436,250,20,13,"teilweise bewölkt",686,"wolbecker"
"5/28/2016 11:00",498,364,22,9,"teilweise bewölkt",862,"wolbecker"
"5/28/2016 12:00",431,427,22,11,"teilweise bewölkt",858,"wolbecker"
"5/28/2016 13:00",417,505,23,7,"teilweise bewölkt",922,"wolbecker"
"5/28/2016 14:00",316,539,23,7,"teilweise bewölkt",855,"wolbecker"
"5/28/2016 15:00",276,457,22,15,"teilweise bewölkt",733,"wolbecker"
"5/28/2016 16:00",273,414,21,20,"wolkig",687,"wolbecker"
"5/28/2016 17:00",284,415,21,15,"teilweise bewölkt",699,"wolbecker"
"5/28/2016 18:00",282,378,21,9,"Regen",660,"wolbecker"
"5/28/2016 19:00",298,285,21,6,"wolkig",583,"wolbecker"
"5/28/2016 20:00",256,283,20,6,"Klarer Himmel",539,"wolbecker"
"5/28/2016 21:00",203,194,18,6,"Klarer Himmel",397,"wolbecker"
"5/28/2016 22:00",216,142,17,7,"Klarer Himmel",358,"wolbecker"
"5/28/2016 23:00",243,142,17,6,"Klarer Himmel",385,"wolbecker"
"5/29/2016 0:00",223,104,16,7,"Klarer Himmel",327,"wolbecker"
"5/29/2016 1:00",199,61,16,6,"Klarer Himmel",260,"wolbecker"
"5/29/2016 2:00",151,26,16,7,"teilweise bewölkt",177,"wolbecker"
"5/29/2016 3:00",86,19,16,4,"Regen",105,"wolbecker"
"5/29/2016 4:00",68,17,16,9,"Regen",85,"wolbecker"
"5/29/2016 5:00",48,14,15,7,"wolkig",62,"wolbecker"
"5/29/2016 6:00",22,10,16,9,"Regen",32,"wolbecker"
"5/29/2016 7:00",25,25,16,13,"wolkig",50,"wolbecker"
"5/29/2016 8:00",37,39,16,11,"wolkig",76,"wolbecker"
"5/29/2016 9:00",65,68,16,13,"Regen",133,"wolbecker"
"5/29/2016 10:00",80,84,17,9,"Regen",164,"wolbecker"
"5/29/2016 11:00",120,80,18,20,"wolkig",200,"wolbecker"
"5/29/2016 12:00",134,115,17,15,"wolkig",249,"wolbecker"
"5/29/2016 13:00",159,170,17,13,"wolkig",329,"wolbecker"
"5/29/2016 14:00",169,184,17,13,"wolkig",353,"wolbecker"
"5/29/2016 15:00",201,184,17,22,"wolkig",385,"wolbecker"
"5/29/2016 16:00",220,200,17,20,"wolkig",420,"wolbecker"
"5/29/2016 17:00",268,220,16,17,"wolkig",488,"wolbecker"
"5/29/2016 18:00",263,183,16,13,"wolkig",446,"wolbecker"
"5/29/2016 19:00",223,155,16,13,"wolkig",378,"wolbecker"
"5/29/2016 20:00",183,135,16,9,"wolkig",318,"wolbecker"
"5/29/2016 21:00",161,63,16,9,"wolkig",224,"wolbecker"
"5/29/2016 22:00",102,70,16,9,"wolkig",172,"wolbecker"
"5/29/2016 23:00",67,38,16,7,"wolkig",105,"wolbecker"
"5/30/2016 0:00",24,12,16,9,"wolkig",36,"wolbecker"
"5/30/2016 1:00",18,6,16,9,"wolkig",24,"wolbecker"
"5/30/2016 2:00",13,3,16,17,"wolkig",16,"wolbecker"
"5/30/2016 3:00",5,1,16,13,"wolkig",6,"wolbecker"
"5/30/2016 4:00",7,4,16,22,"wolkig",11,"wolbecker"
"5/30/2016 5:00",43,49,15,7,"wolkig",92,"wolbecker"
"5/30/2016 6:00",144,188,15,15,"wolkig",332,"wolbecker"
"5/30/2016 7:00",608,273,16,19,"wolkig",881,"wolbecker"
"5/30/2016 8:00",598,213,16,11,"wolkig",811,"wolbecker"
"5/30/2016 9:00",499,180,17,13,"wolkig",679,"wolbecker"
"5/30/2016 10:00",396,222,19,20,"wolkig",618,"wolbecker"
"5/30/2016 11:00",279,232,20,11,"wolkig",511,"wolbecker"
"5/30/2016 12:00",326,340,22,20,"wolkig",666,"wolbecker"
"5/30/2016 13:00",343,346,23,22,"wolkig",689,"wolbecker"
"5/30/2016 14:00",332,366,24,22,"wolkig",698,"wolbecker"
"5/30/2016 15:00",398,408,24,13,"teilweise bewölkt",806,"wolbecker"
"5/30/2016 16:00",435,525,25,13,"wolkig",960,"wolbecker"
"5/30/2016 17:00",477,540,21,13,"Regen",1017,"wolbecker"
"5/30/2016 18:00",428,541,21,7,"Regen",969,"wolbecker"
"5/30/2016 19:00",205,330,19,11,"Gewitter",535,"wolbecker"
"5/30/2016 20:00",199,268,19,6,"wolkig",467,"wolbecker"
"5/30/2016 21:00",149,142,18,7,"teilweise bewölkt",291,"wolbecker"
"5/30/2016 22:00",100,142,18,7,"teilweise bewölkt",242,"wolbecker"
"5/30/2016 23:00",57,58,17,6,"Klarer Himmel",115,"wolbecker"
"5/31/2016 0:00",23,21,16,4,"Klarer Himmel",44,"wolbecker"
"5/31/2016 1:00",10,28,16,6,"Klarer Himmel",38,"wolbecker"
"5/31/2016 2:00",5,8,15,6,"Klarer Himmel",13,"wolbecker"
"5/31/2016 3:00",1,2,15,4,"Klarer Himmel",3,"wolbecker"
"5/31/2016 4:00",6,7,14,6,"teilweise bewölkt",13,"wolbecker"
"5/31/2016 5:00",47,50,14,4,"Nebel",97,"wolbecker"
"5/31/2016 6:00",176,194,15,6,"teilweise bewölkt",370,"wolbecker"
"5/31/2016 7:00",759,379,17,7,"teilweise bewölkt",1138,"wolbecker"
"5/31/2016 8:00",721,316,18,7,"teilweise bewölkt",1037,"wolbecker"
"5/31/2016 9:00",575,236,20,9,"teilweise bewölkt",811,"wolbecker"
"5/31/2016 10:00",415,250,20,11,"teilweise bewölkt",665,"wolbecker"
"5/31/2016 11:00",370,243,19,13,"wolkig",613,"wolbecker"
"5/31/2016 12:00",337,393,20,11,"wolkig",730,"wolbecker"
"5/31/2016 13:00",383,425,21,13,"wolkig",808,"wolbecker"
"5/31/2016 14:00",442,412,22,7,"wolkig",854,"wolbecker"
"5/31/2016 15:00",465,488,23,7,"wolkig",953,"wolbecker"
"5/31/2016 16:00",506,632,23,7,"Klarer Himmel",1138,"wolbecker"
"5/31/2016 17:00",568,648,23,7,"Klarer Himmel",1216,"wolbecker"
"5/31/2016 18:00",490,621,24,7,"Klarer Himmel",1111,"wolbecker"
"5/31/2016 19:00",434,515,23,4,"Klarer Himmel",949,"wolbecker"
"5/31/2016 20:00",250,360,23,2,"Klarer Himmel",610,"wolbecker"
"5/31/2016 21:00",224,229,21,6,"Klarer Himmel",453,"wolbecker"
"5/31/2016 22:00",197,175,21,6,"Klarer Himmel",372,"wolbecker"
"5/31/2016 23:00",95,105,19,7,"Klarer Himmel",200,"wolbecker"
"6/1/2016 0:00",42,41,18,6,"wolkig",83,"wolbecker"
"6/1/2016 1:00",29,26,17,4,"Gewitter",55,"wolbecker"
"6/1/2016 2:00",4,7,16,9,"wolkig",11,"wolbecker"
"6/1/2016 3:00",7,7,16,6,"Klarer Himmel",14,"wolbecker"
"6/1/2016 4:00",11,10,15,0,"Nebel",21,"wolbecker"
"6/1/2016 5:00",46,51,16,4,"wolkig",97,"wolbecker"
"6/1/2016 6:00",140,181,16,6,"wolkig",321,"wolbecker"
"6/1/2016 7:00",686,333,17,6,"wolkig",1019,"wolbecker"
"6/1/2016 8:00",656,246,18,6,"wolkig",902,"wolbecker"
"6/1/2016 9:00",516,190,19,7,"wolkig",706,"wolbecker"
"6/1/2016 10:00",371,252,19,13,"wolkig",623,"wolbecker"
"6/1/2016 11:00",409,284,19,11,"Regen",693,"wolbecker"
"6/1/2016 12:00",345,323,20,9,"wolkig",668,"wolbecker"
"6/1/2016 13:00",338,408,21,9,"wolkig",746,"wolbecker"
"6/1/2016 14:00",336,422,22,17,"wolkig",758,"wolbecker"
"6/1/2016 15:00",368,424,23,11,"wolkig",792,"wolbecker"
"6/1/2016 16:00",441,595,21,6,"wolkig",1036,"wolbecker"
"6/1/2016 17:00",446,605,20,11,"Regen",1051,"wolbecker"
"6/1/2016 18:00",346,475,19,7,"Gewitter",821,"wolbecker"
"6/1/2016 19:00",277,388,19,6,"Regen",665,"wolbecker"
"6/1/2016 20:00",209,275,19,7,"wolkig",484,"wolbecker"
"6/1/2016 21:00",161,181,18,2,"Regen",342,"wolbecker"
"6/1/2016 22:00",131,141,18,9,"Regen",272,"wolbecker"
"6/1/2016 23:00",79,111,18,9,"wolkig",190,"wolbecker"
"6/2/2016 0:00",52,97,18,4,"wolkig",149,"wolbecker"
"6/2/2016 1:00",28,53,19,11,"wolkig",81,"wolbecker"
"6/2/2016 2:00",41,19,18,11,"wolkig",60,"wolbecker"
"6/2/2016 3:00",28,6,18,7,"wolkig",34,"wolbecker"
"6/2/2016 4:00",26,15,17,6,"teilweise bewölkt",41,"wolbecker"
"6/2/2016 5:00",42,47,16,7,"teilweise bewölkt",89,"wolbecker"
"6/2/2016 6:00",150,188,17,6,"teilweise bewölkt",338,"wolbecker"
"6/2/2016 7:00",698,342,18,7,NA,1040,"wolbecker"
"6/2/2016 8:00",610,270,19,6,"teilweise bewölkt",880,"wolbecker"
"6/2/2016 9:00",570,204,19,7,"teilweise bewölkt",774,"wolbecker"
"6/2/2016 10:00",431,224,20,9,"wolkig",655,"wolbecker"
"6/2/2016 11:00",386,304,21,11,"wolkig",690,"wolbecker"
"6/2/2016 12:00",344,408,22,7,"teilweise bewölkt",752,"wolbecker"
"6/2/2016 13:00",376,450,22,6,"teilweise bewölkt",826,"wolbecker"
"6/2/2016 14:00",356,434,24,7,"teilweise bewölkt",790,"wolbecker"
"6/2/2016 15:00",452,510,18,22,"Gewitter",962,"wolbecker"
"6/2/2016 16:00",227,383,16,7,"Regen",610,"wolbecker"
"6/2/2016 17:00",412,443,16,6,"wolkig",855,"wolbecker"
"6/2/2016 18:00",413,523,17,7,"wolkig",936,"wolbecker"
"6/2/2016 19:00",374,408,17,9,"teilweise bewölkt",782,"wolbecker"
"6/2/2016 20:00",220,281,18,7,"Klarer Himmel",501,"wolbecker"
"6/2/2016 21:00",182,213,16,6,"Nebel",395,"wolbecker"
"6/2/2016 22:00",168,155,16,4,"Nebel",323,"wolbecker"
"6/2/2016 23:00",114,136,16,2,"Nebel",250,"wolbecker"
"6/3/2016 0:00",51,78,15,4,"Nebel",129,"wolbecker"
"6/3/2016 1:00",32,28,16,4,"Nebel",60,"wolbecker"
"6/3/2016 2:00",20,13,17,6,"Nebel",33,"wolbecker"
"6/3/2016 3:00",16,16,16,6,"Nebel",32,"wolbecker"
"6/3/2016 4:00",18,11,16,4,"wolkig",29,"wolbecker"
"6/3/2016 5:00",44,48,16,2,"Nebel",92,"wolbecker"
"6/3/2016 6:00",142,171,16,2,"Nebel",313,"wolbecker"
"6/3/2016 7:00",635,297,15,6,"wolkig",932,"wolbecker"
"6/3/2016 8:00",548,228,15,6,"Nebel",776,"wolbecker"
"6/3/2016 9:00",439,187,16,4,"wolkig",626,"wolbecker"
"6/3/2016 10:00",382,221,17,2,"wolkig",603,"wolbecker"
"6/3/2016 11:00",359,290,20,4,"wolkig",649,"wolbecker"
"6/3/2016 12:00",352,405,22,7,"wolkig",757,"wolbecker"
"6/3/2016 13:00",408,515,23,7,"wolkig",923,"wolbecker"
"6/3/2016 14:00",394,464,24,13,"teilweise bewölkt",858,"wolbecker"
"6/3/2016 15:00",392,417,25,13,"teilweise bewölkt",809,"wolbecker"
"6/3/2016 16:00",372,515,25,17,"Klarer Himmel",887,"wolbecker"
"6/3/2016 17:00",421,474,25,13,"Klarer Himmel",895,"wolbecker"
"6/3/2016 18:00",418,475,26,11,"Klarer Himmel",893,"wolbecker"
"6/3/2016 19:00",371,425,25,13,"Klarer Himmel",796,"wolbecker"
"6/3/2016 20:00",283,287,22,6,"teilweise bewölkt",570,"wolbecker"
"6/3/2016 21:00",208,233,20,7,"Klarer Himmel",441,"wolbecker"
"6/3/2016 22:00",182,208,18,6,"Klarer Himmel",390,"wolbecker"
"6/3/2016 23:00",151,151,18,7,"Klarer Himmel",302,"wolbecker"
"6/4/2016 0:00",100,135,17,4,"Klarer Himmel",235,"wolbecker"
"6/4/2016 1:00",71,141,17,4,"Klarer Himmel",212,"wolbecker"
"6/4/2016 2:00",58,81,17,6,"Klarer Himmel",139,"wolbecker"
"6/4/2016 3:00",48,44,15,4,"Nebel",92,"wolbecker"
"6/4/2016 4:00",38,25,15,7,"Nebel",63,"wolbecker"
"6/4/2016 5:00",47,21,15,4,"Nebel",68,"wolbecker"
"6/4/2016 6:00",42,32,16,0,"Nebel",74,"wolbecker"
"6/4/2016 7:00",110,66,19,4,"Klarer Himmel",176,"wolbecker"
"6/4/2016 8:00",185,115,21,7,"Klarer Himmel",300,"wolbecker"
"6/4/2016 9:00",337,194,24,11,"Klarer Himmel",531,"wolbecker"
"6/4/2016 10:00",445,255,25,15,"Klarer Himmel",700,"wolbecker"
"6/4/2016 11:00",482,315,25,19,"teilweise bewölkt",797,"wolbecker"
"6/4/2016 12:00",496,385,25,15,"wolkig",881,"wolbecker"
"6/4/2016 13:00",443,421,26,17,"wolkig",864,"wolbecker"
"6/4/2016 14:00",493,490,27,17,"wolkig",983,"wolbecker"
"6/4/2016 15:00",425,390,26,20,"teilweise bewölkt",815,"wolbecker"
"6/4/2016 16:00",343,403,26,22,"teilweise bewölkt",746,"wolbecker"
"6/4/2016 17:00",328,476,26,13,"wolkig",804,"wolbecker"
"6/4/2016 18:00",352,558,25,17,"wolkig",910,"wolbecker"
"6/4/2016 19:00",362,390,24,9,"wolkig",752,"wolbecker"
"6/4/2016 20:00",241,240,22,6,"teilweise bewölkt",481,"wolbecker"
"6/4/2016 21:00",182,210,20,7,"teilweise bewölkt",392,"wolbecker"
"6/4/2016 22:00",203,211,19,9,"Klarer Himmel",414,"wolbecker"
"6/4/2016 23:00",135,171,18,7,"Klarer Himmel",306,"wolbecker"
"6/5/2016 0:00",176,146,18,6,"Klarer Himmel",322,"wolbecker"
"6/5/2016 1:00",114,139,18,2,"Klarer Himmel",253,"wolbecker"
"6/5/2016 2:00",97,84,16,4,"Klarer Himmel",181,"wolbecker"
"6/5/2016 3:00",77,60,15,4,"Klarer Himmel",137,"wolbecker"
"6/5/2016 4:00",45,25,15,2,"Nebel",70,"wolbecker"
"6/5/2016 5:00",29,15,15,4,"Nebel",44,"wolbecker"
"6/5/2016 6:00",35,20,17,2,"Klarer Himmel",55,"wolbecker"
"6/5/2016 7:00",29,34,19,4,"Klarer Himmel",63,"wolbecker"
"6/5/2016 8:00",46,54,21,7,"Klarer Himmel",100,"wolbecker"
"6/5/2016 9:00",125,80,23,6,"Klarer Himmel",205,"wolbecker"
"6/5/2016 10:00",163,159,24,13,"Klarer Himmel",322,"wolbecker"
"6/5/2016 11:00",189,134,25,13,"Klarer Himmel",323,"wolbecker"
"6/5/2016 12:00",209,215,26,13,"teilweise bewölkt",424,"wolbecker"
"6/5/2016 13:00",284,281,27,15,"Klarer Himmel",565,"wolbecker"
"6/5/2016 14:00",270,289,27,17,"Klarer Himmel",559,"wolbecker"
"6/5/2016 15:00",283,260,27,13,"teilweise bewölkt",543,"wolbecker"
"6/5/2016 16:00",280,252,27,15,"teilweise bewölkt",532,"wolbecker"
"6/5/2016 17:00",328,278,28,15,"teilweise bewölkt",606,"wolbecker"
"6/5/2016 18:00",341,267,27,15,"teilweise bewölkt",608,"wolbecker"
"6/5/2016 19:00",303,260,26,13,"Klarer Himmel",563,"wolbecker"
"6/5/2016 20:00",271,157,24,13,"Klarer Himmel",428,"wolbecker"
"6/5/2016 21:00",186,142,22,15,"Klarer Himmel",328,"wolbecker"
"6/5/2016 22:00",165,102,21,13,"Klarer Himmel",267,"wolbecker"
"6/5/2016 23:00",93,60,19,9,"Klarer Himmel",153,"wolbecker"
"6/6/2016 0:00",41,25,18,7,"Klarer Himmel",66,"wolbecker"
"6/6/2016 1:00",10,7,17,6,"Klarer Himmel",17,"wolbecker"
"6/6/2016 2:00",8,5,15,6,"Klarer Himmel",13,"wolbecker"
"6/6/2016 3:00",1,3,14,7,"Klarer Himmel",4,"wolbecker"
"6/6/2016 4:00",9,7,14,9,NA,16,"wolbecker"
"6/6/2016 5:00",52,47,14,11,"wolkig",99,"wolbecker"
"6/6/2016 6:00",180,190,14,11,"wolkig",370,"wolbecker"
"6/6/2016 7:00",668,330,14,11,"wolkig",998,"wolbecker"
"6/6/2016 8:00",689,264,15,9,"wolkig",953,"wolbecker"
"6/6/2016 9:00",553,213,16,11,"wolkig",766,"wolbecker"
"6/6/2016 10:00",420,237,17,7,"wolkig",657,"wolbecker"
"6/6/2016 11:00",408,266,19,9,"teilweise bewölkt",674,"wolbecker"
"6/6/2016 12:00",375,424,20,9,"teilweise bewölkt",799,"wolbecker"
"6/6/2016 13:00",424,428,23,9,"teilweise bewölkt",852,"wolbecker"
"6/6/2016 14:00",398,451,24,13,NA,849,"wolbecker"
"6/6/2016 15:00",455,551,25,11,NA,1006,"wolbecker"
"6/6/2016 16:00",492,671,26,11,"teilweise bewölkt",1163,"wolbecker"
"6/6/2016 17:00",605,632,26,9,"teilweise bewölkt",1237,"wolbecker"
"6/6/2016 18:00",499,623,26,11,"teilweise bewölkt",1122,"wolbecker"
"6/6/2016 19:00",430,529,26,9,"wolkig",959,"wolbecker"
"6/6/2016 20:00",281,353,24,7,"wolkig",634,"wolbecker"
"6/6/2016 21:00",222,285,22,7,"wolkig",507,"wolbecker"
"6/6/2016 22:00",148,199,20,6,"Klarer Himmel",347,"wolbecker"
"6/6/2016 23:00",103,85,19,4,"Klarer Himmel",188,"wolbecker"
"6/7/2016 0:00",60,52,18,4,NA,112,"wolbecker"
"6/7/2016 1:00",30,19,17,4,NA,49,"wolbecker"
"6/7/2016 2:00",7,12,16,4,NA,19,"wolbecker"
"6/7/2016 3:00",9,9,16,4,"Nebel",18,"wolbecker"
"6/7/2016 4:00",5,8,16,0,"Nebel",13,"wolbecker"
"6/7/2016 5:00",58,49,15,4,"Nebel",107,"wolbecker"
"6/7/2016 6:00",196,221,16,2,NA,417,"wolbecker"
"6/7/2016 7:00",750,362,18,4,NA,1112,"wolbecker"
"6/7/2016 8:00",762,320,21,4,"Klarer Himmel",1082,"wolbecker"
"6/7/2016 9:00",594,244,23,2,"Klarer Himmel",838,"wolbecker"
"6/7/2016 10:00",424,241,25,4,"Klarer Himmel",665,"wolbecker"
"6/7/2016 11:00",380,292,26,6,"Klarer Himmel",672,"wolbecker"
"6/7/2016 12:00",394,423,27,6,"wolkig",817,"wolbecker"
"6/7/2016 13:00",409,447,27,9,"wolkig",856,"wolbecker"
"6/7/2016 14:00",416,502,28,11,"teilweise bewölkt",918,"wolbecker"
"6/7/2016 15:00",445,590,22,9,"wolkig",1035,"wolbecker"
"6/7/2016 16:00",195,391,18,15,"Gewitter",586,"wolbecker"
"6/7/2016 17:00",449,587,20,9,"wolkig",1036,"wolbecker"
"6/7/2016 18:00",387,499,20,15,"wolkig",886,"wolbecker"
"6/7/2016 19:00",337,408,20,4,"wolkig",745,"wolbecker"
"6/7/2016 20:00",178,252,19,4,"teilweise bewölkt",430,"wolbecker"
"6/7/2016 21:00",165,179,18,6,"Nebel",344,"wolbecker"
"6/7/2016 22:00",140,148,16,6,"Nebel",288,"wolbecker"
"6/7/2016 23:00",99,87,16,2,"Nebel",186,"wolbecker"
"6/8/2016 0:00",37,38,15,4,"Nebel",75,"wolbecker"
"6/8/2016 1:00",18,17,15,4,"Nebel",35,"wolbecker"
"6/8/2016 2:00",9,10,14,2,"Nebel",19,"wolbecker"
"6/8/2016 3:00",2,4,13,4,"Nebel",6,"wolbecker"
"6/8/2016 4:00",10,10,13,6,"Klarer Himmel",20,"wolbecker"
"6/8/2016 5:00",48,49,13,7,"Klarer Himmel",97,"wolbecker"
"6/8/2016 6:00",182,201,13,7,"Klarer Himmel",383,"wolbecker"
"6/8/2016 7:00",754,363,14,9,"Klarer Himmel",1117,"wolbecker"
"6/8/2016 8:00",660,275,15,13,"wolkig",935,"wolbecker"
"6/8/2016 9:00",619,245,16,11,"wolkig",864,"wolbecker"
"6/8/2016 10:00",486,247,17,9,"wolkig",733,"wolbecker"
"6/8/2016 11:00",449,327,18,13,"wolkig",776,"wolbecker"
"6/8/2016 12:00",428,430,18,13,"wolkig",858,"wolbecker"
"6/8/2016 13:00",429,482,19,17,"wolkig",911,"wolbecker"
"6/8/2016 14:00",378,497,20,13,"wolkig",875,"wolbecker"
"6/8/2016 15:00",415,516,21,15,"wolkig",931,"wolbecker"
"6/8/2016 16:00",498,639,21,20,"wolkig",1137,"wolbecker"
"6/8/2016 17:00",619,698,19,24,"wolkig",1317,"wolbecker"
"6/8/2016 18:00",555,634,17,20,"wolkig",1189,"wolbecker"
"6/8/2016 19:00",448,590,17,15,"wolkig",1038,"wolbecker"
"6/8/2016 20:00",285,373,17,15,"Klarer Himmel",658,"wolbecker"
"6/8/2016 21:00",216,291,15,7,"Klarer Himmel",507,"wolbecker"
"6/8/2016 22:00",192,227,14,11,"Klarer Himmel",419,"wolbecker"
"6/8/2016 23:00",145,139,13,11,"Klarer Himmel",284,"wolbecker"
"6/9/2016 0:00",78,100,12,13,"teilweise bewölkt",178,"wolbecker"
"6/9/2016 1:00",35,79,12,11,"wolkig",114,"wolbecker"
"6/9/2016 2:00",34,34,12,11,"wolkig",68,"wolbecker"
"6/9/2016 3:00",37,9,12,11,"wolkig",46,"wolbecker"
"6/9/2016 4:00",32,8,12,9,"wolkig",40,"wolbecker"
"6/9/2016 5:00",61,51,12,7,"wolkig",112,"wolbecker"
"6/9/2016 6:00",166,209,12,13,"wolkig",375,"wolbecker"
"6/9/2016 7:00",745,328,12,9,"wolkig",1073,"wolbecker"
"6/9/2016 8:00",626,299,12,13,"wolkig",925,"wolbecker"
"6/9/2016 9:00",491,190,13,13,"Regen",681,"wolbecker"
"6/9/2016 10:00",409,203,13,13,"wolkig",612,"wolbecker"
"6/9/2016 11:00",359,259,13,13,"wolkig",618,"wolbecker"
"6/9/2016 12:00",334,377,14,13,"wolkig",711,"wolbecker"
"6/9/2016 13:00",379,444,15,11,"wolkig",823,"wolbecker"
"6/9/2016 14:00",373,378,16,11,"wolkig",751,"wolbecker"
"6/9/2016 15:00",454,520,17,13,"wolkig",974,"wolbecker"
"6/9/2016 16:00",463,626,18,15,"wolkig",1089,"wolbecker"
"6/9/2016 17:00",567,668,19,13,"wolkig",1235,"wolbecker"
"6/9/2016 18:00",519,625,19,11,"teilweise bewölkt",1144,"wolbecker"
"6/9/2016 19:00",423,489,18,7,"teilweise bewölkt",912,"wolbecker"
"6/9/2016 20:00",227,351,18,6,"teilweise bewölkt",578,"wolbecker"
"6/9/2016 21:00",217,255,14,0,"Klarer Himmel",472,"wolbecker"
"6/9/2016 22:00",171,197,13,6,"Klarer Himmel",368,"wolbecker"
"6/9/2016 23:00",137,89,12,11,"Klarer Himmel",226,"wolbecker"
"6/10/2016 0:00",68,43,11,11,"Klarer Himmel",111,"wolbecker"
"6/10/2016 1:00",18,26,10,6,"Klarer Himmel",44,"wolbecker"
"6/10/2016 2:00",14,17,9,6,"Klarer Himmel",31,"wolbecker"
"6/10/2016 3:00",12,6,9,4,"Klarer Himmel",18,"wolbecker"
"6/10/2016 4:00",12,7,9,6,"Klarer Himmel",19,"wolbecker"
"6/10/2016 5:00",57,43,9,4,"Nebel",100,"wolbecker"
"6/10/2016 6:00",155,187,9,6,NA,342,"wolbecker"
"6/10/2016 7:00",700,328,11,7,"teilweise bewölkt",1028,"wolbecker"
"6/10/2016 8:00",588,261,13,7,"teilweise bewölkt",849,"wolbecker"
"6/10/2016 9:00",505,230,14,6,"teilweise bewölkt",735,"wolbecker"
"6/10/2016 10:00",387,266,16,7,"teilweise bewölkt",653,"wolbecker"
"6/10/2016 11:00",406,294,17,7,"teilweise bewölkt",700,"wolbecker"
"6/10/2016 12:00",410,445,18,9,"Klarer Himmel",855,"wolbecker"
"6/10/2016 13:00",460,556,19,11,"Klarer Himmel",1016,"wolbecker"
"6/10/2016 14:00",425,582,20,11,"Klarer Himmel",1007,"wolbecker"
"6/10/2016 15:00",444,534,20,11,"wolkig",978,"wolbecker"
"6/10/2016 16:00",426,535,21,17,"wolkig",961,"wolbecker"
"6/10/2016 17:00",452,526,21,13,"wolkig",978,"wolbecker"
"6/10/2016 18:00",350,505,21,11,"wolkig",855,"wolbecker"
"6/10/2016 19:00",335,446,20,11,"wolkig",781,"wolbecker"
"6/10/2016 20:00",260,307,18,13,"wolkig",567,"wolbecker"
"6/10/2016 21:00",205,182,17,9,"Klarer Himmel",387,"wolbecker"
"6/10/2016 22:00",146,178,16,11,"Klarer Himmel",324,"wolbecker"
"6/10/2016 23:00",124,191,15,7,"Klarer Himmel",315,"wolbecker"
"6/11/2016 0:00",121,116,14,9,"Klarer Himmel",237,"wolbecker"
"6/11/2016 1:00",93,107,12,4,"Klarer Himmel",200,"wolbecker"
"6/11/2016 2:00",59,42,12,6,"Klarer Himmel",101,"wolbecker"
"6/11/2016 3:00",48,43,12,6,"Klarer Himmel",91,"wolbecker"
"6/11/2016 4:00",39,31,12,6,"Klarer Himmel",70,"wolbecker"
"6/11/2016 5:00",38,22,12,6,"Klarer Himmel",60,"wolbecker"
"6/11/2016 6:00",36,36,12,4,"Klarer Himmel",72,"wolbecker"
"6/11/2016 7:00",106,58,13,7,"Klarer Himmel",164,"wolbecker"
"6/11/2016 8:00",146,109,14,6,"Regen",255,"wolbecker"
"6/11/2016 9:00",320,128,15,4,"Regen",448,"wolbecker"
"6/11/2016 10:00",381,187,16,6,"Regen",568,"wolbecker"
"6/11/2016 11:00",383,262,17,6,"Regen",645,"wolbecker"
"6/11/2016 12:00",456,328,18,4,"wolkig",784,"wolbecker"
"6/11/2016 13:00",367,406,20,4,"wolkig",773,"wolbecker"
"6/11/2016 14:00",342,351,20,6,"wolkig",693,"wolbecker"
"6/11/2016 15:00",314,389,21,7,"wolkig",703,"wolbecker"
"6/11/2016 16:00",290,340,21,11,"wolkig",630,"wolbecker"
"6/11/2016 17:00",253,363,21,9,"wolkig",616,"wolbecker"
"6/11/2016 18:00",274,410,21,7,"Klarer Himmel",684,"wolbecker"
"6/11/2016 19:00",234,337,20,11,"Klarer Himmel",571,"wolbecker"
"6/11/2016 20:00",208,259,19,6,"Klarer Himmel",467,"wolbecker"
"6/11/2016 21:00",191,154,18,4,"Klarer Himmel",345,"wolbecker"
"6/11/2016 22:00",127,123,17,4,"Klarer Himmel",250,"wolbecker"
"6/11/2016 23:00",159,125,14,2,"Klarer Himmel",284,"wolbecker"
"6/12/2016 0:00",154,121,14,0,"Klarer Himmel",275,"wolbecker"
"6/12/2016 1:00",103,109,13,2,"Klarer Himmel",212,"wolbecker"
"6/12/2016 2:00",55,81,12,0,"Klarer Himmel",136,"wolbecker"
"6/12/2016 3:00",82,48,12,0,"Klarer Himmel",130,"wolbecker"
"6/12/2016 4:00",52,36,12,0,"Klarer Himmel",88,"wolbecker"
"6/12/2016 5:00",33,12,12,0,"Klarer Himmel",45,"wolbecker"
"6/12/2016 6:00",20,22,13,0,"Klarer Himmel",42,"wolbecker"
"6/12/2016 7:00",27,33,16,0,"Klarer Himmel",60,"wolbecker"
"6/12/2016 8:00",56,60,17,0,"wolkig",116,"wolbecker"
"6/12/2016 9:00",132,65,18,0,"wolkig",197,"wolbecker"
"6/12/2016 10:00",147,139,20,4,"wolkig",286,"wolbecker"
"6/12/2016 11:00",163,117,19,9,"wolkig",280,"wolbecker"
"6/12/2016 12:00",174,187,19,9,"wolkig",361,"wolbecker"
"6/12/2016 13:00",215,181,20,9,"wolkig",396,"wolbecker"
"6/12/2016 14:00",245,188,22,6,"wolkig",433,"wolbecker"
"6/12/2016 15:00",230,162,20,9,"Regen",392,"wolbecker"
"6/12/2016 16:00",110,110,19,6,"wolkig",220,"wolbecker"
"6/12/2016 17:00",137,165,18,15,"Regen",302,"wolbecker"
"6/12/2016 18:00",184,147,17,13,"Regen",331,"wolbecker"
"6/12/2016 19:00",206,175,15,6,"Regen",381,"wolbecker"
"6/12/2016 20:00",286,190,15,6,"wolkig",476,"wolbecker"
"6/12/2016 21:00",71,43,15,6,"wolkig",114,"wolbecker"
"6/12/2016 22:00",73,47,15,4,"wolkig",120,"wolbecker"
"6/12/2016 23:00",239,253,14,4,"wolkig",492,"wolbecker"
"6/13/2016 0:00",53,24,14,0,"wolkig",77,"wolbecker"
"6/13/2016 1:00",12,10,14,2,"Regen",22,"wolbecker"
"6/13/2016 2:00",1,7,14,4,"wolkig",8,"wolbecker"
"6/13/2016 3:00",2,4,15,6,"Regen",6,"wolbecker"
"6/13/2016 4:00",4,4,14,6,"Regen",8,"wolbecker"
"6/13/2016 5:00",41,35,14,4,"Regen",76,"wolbecker"
"6/13/2016 6:00",106,115,14,6,"Regen",221,"wolbecker"
"6/13/2016 7:00",507,273,15,6,"Regen",780,"wolbecker"
"6/13/2016 8:00",589,233,15,9,"wolkig",822,"wolbecker"
"6/13/2016 9:00",436,170,16,11,"wolkig",606,"wolbecker"
"6/13/2016 10:00",254,142,16,11,"wolkig",396,"wolbecker"
"6/13/2016 11:00",284,181,17,9,"Regen",465,"wolbecker"
"6/13/2016 12:00",304,286,18,11,"wolkig",590,"wolbecker"
"6/13/2016 13:00",297,315,19,7,"wolkig",612,"wolbecker"
"6/13/2016 14:00",309,318,15,11,"Gewitter",627,"wolbecker"
"6/13/2016 15:00",335,351,17,2,"wolkig",686,"wolbecker"
"6/13/2016 16:00",388,481,18,11,"wolkig",869,"wolbecker"
"6/13/2016 17:00",424,528,19,13,"Regen",952,"wolbecker"
"6/13/2016 18:00",410,489,19,11,"wolkig",899,"wolbecker"
"6/13/2016 19:00",240,403,19,19,"teilweise bewölkt",643,"wolbecker"
"6/13/2016 20:00",210,287,17,13,"wolkig",497,"wolbecker"
"6/13/2016 21:00",164,161,16,13,"wolkig",325,"wolbecker"
"6/13/2016 22:00",70,118,15,11,"wolkig",188,"wolbecker"
"6/13/2016 23:00",80,96,15,9,"wolkig",176,"wolbecker"
"6/14/2016 0:00",34,31,15,11,"wolkig",65,"wolbecker"
"6/14/2016 1:00",13,16,15,13,"wolkig",29,"wolbecker"
"6/14/2016 2:00",6,13,14,9,"wolkig",19,"wolbecker"
"6/14/2016 3:00",7,8,14,6,"wolkig",15,"wolbecker"
"6/14/2016 4:00",6,5,14,6,"wolkig",11,"wolbecker"
"6/14/2016 5:00",35,43,14,6,"wolkig",78,"wolbecker"
"6/14/2016 6:00",124,139,14,7,"wolkig",263,"wolbecker"
"6/14/2016 7:00",503,250,14,9,"Regen",753,"wolbecker"
"6/14/2016 8:00",589,239,14,9,"wolkig",828,"wolbecker"
"6/14/2016 9:00",459,174,16,13,"wolkig",633,"wolbecker"
"6/14/2016 10:00",354,200,15,13,"wolkig",554,"wolbecker"
"6/14/2016 11:00",300,223,16,15,"wolkig",523,"wolbecker"
"6/14/2016 12:00",301,311,17,15,"wolkig",612,"wolbecker"
"6/14/2016 13:00",385,385,17,17,"Regen",770,"wolbecker"
"6/14/2016 14:00",342,353,18,17,"wolkig",695,"wolbecker"
"6/14/2016 15:00",393,422,18,17,"teilweise bewölkt",815,"wolbecker"
"6/14/2016 16:00",424,497,19,9,"teilweise bewölkt",921,"wolbecker"
"6/14/2016 17:00",472,553,19,11,"wolkig",1025,"wolbecker"
"6/14/2016 18:00",420,550,20,17,"wolkig",970,"wolbecker"
"6/14/2016 19:00",350,446,19,9,"wolkig",796,"wolbecker"
"6/14/2016 20:00",248,349,17,7,"wolkig",597,"wolbecker"
"6/14/2016 21:00",170,226,15,6,"wolkig",396,"wolbecker"
"6/14/2016 22:00",155,140,15,11,"wolkig",295,"wolbecker"
"6/14/2016 23:00",115,73,14,4,"teilweise bewölkt",188,"wolbecker"
"6/15/2016 0:00",27,29,13,6,"teilweise bewölkt",56,"wolbecker"
"6/15/2016 1:00",22,26,13,6,"Nebel",48,"wolbecker"
"6/15/2016 2:00",3,9,13,2,"Nebel",12,"wolbecker"
"6/15/2016 3:00",5,6,13,4,"Nebel",11,"wolbecker"
"6/15/2016 4:00",10,11,13,4,NA,21,"wolbecker"
"6/15/2016 5:00",45,49,13,6,NA,94,"wolbecker"
"6/15/2016 6:00",151,194,13,7,"Klarer Himmel",345,"wolbecker"
"6/15/2016 7:00",668,345,14,4,"wolkig",1013,"wolbecker"
"6/15/2016 8:00",641,266,14,4,"wolkig",907,"wolbecker"
"6/15/2016 9:00",531,227,15,7,"wolkig",758,"wolbecker"
"6/15/2016 10:00",433,230,16,9,"wolkig",663,"wolbecker"
"6/15/2016 11:00",324,283,17,6,"Regen",607,"wolbecker"
"6/15/2016 12:00",303,312,13,9,"Regen",615,"wolbecker"
"6/15/2016 13:00",349,412,15,6,"Regen",761,"wolbecker"
"6/15/2016 14:00",289,371,17,4,"Regen",660,"wolbecker"
"6/15/2016 15:00",350,449,18,7,"wolkig",799,"wolbecker"
"6/15/2016 16:00",388,519,18,11,"wolkig",907,"wolbecker"
"6/15/2016 17:00",492,568,18,11,"Regen",1060,"wolbecker"
"6/15/2016 18:00",404,507,17,13,"wolkig",911,"wolbecker"
"6/15/2016 19:00",322,430,17,7,"wolkig",752,"wolbecker"
"6/15/2016 20:00",261,280,16,11,"wolkig",541,"wolbecker"
"6/15/2016 21:00",160,201,15,9,"wolkig",361,"wolbecker"
"6/15/2016 22:00",146,138,14,4,"wolkig",284,"wolbecker"
"6/15/2016 23:00",112,111,14,6,"Klarer Himmel",223,"wolbecker"
"6/16/2016 0:00",63,62,13,6,"Klarer Himmel",125,"wolbecker"
"6/16/2016 1:00",35,34,13,6,"Klarer Himmel",69,"wolbecker"
"6/16/2016 2:00",11,22,13,7,"Klarer Himmel",33,"wolbecker"
"6/16/2016 3:00",11,21,12,4,"Klarer Himmel",32,"wolbecker"
"6/16/2016 4:00",10,26,10,4,"Nebel",36,"wolbecker"
"6/16/2016 5:00",41,63,10,6,"Nebel",104,"wolbecker"
"6/16/2016 6:00",138,205,12,7,"Nebel",343,"wolbecker"
"6/16/2016 7:00",673,346,12,9,"wolkig",1019,"wolbecker"
"6/16/2016 8:00",643,266,15,4,"wolkig",909,"wolbecker"
"6/16/2016 9:00",595,216,17,4,"teilweise bewölkt",811,"wolbecker"
"6/16/2016 10:00",376,296,18,4,"wolkig",672,"wolbecker"
"6/16/2016 11:00",375,287,19,6,"wolkig",662,"wolbecker"
"6/16/2016 12:00",353,424,19,7,"wolkig",777,"wolbecker"
"6/16/2016 13:00",403,432,20,7,"wolkig",835,"wolbecker"
"6/16/2016 14:00",426,450,20,4,"wolkig",876,"wolbecker"
"6/16/2016 15:00",414,504,20,4,"wolkig",918,"wolbecker"
"6/16/2016 16:00",427,584,20,6,"Regen",1011,"wolbecker"
"6/16/2016 17:00",499,602,20,7,"Gewitter",1101,"wolbecker"
"6/16/2016 18:00",415,528,17,13,"Regen",943,"wolbecker"
"6/16/2016 19:00",395,472,17,11,"Regen",867,"wolbecker"
"6/16/2016 20:00",411,362,16,7,"wolkig",773,"wolbecker"
"6/16/2016 21:00",108,118,15,6,"wolkig",226,"wolbecker"
"6/16/2016 22:00",95,86,14,4,"Klarer Himmel",181,"wolbecker"
"6/16/2016 23:00",309,358,13,2,"Klarer Himmel",667,"wolbecker"
"6/17/2016 0:00",74,73,13,2,"wolkig",147,"wolbecker"
"6/17/2016 1:00",18,35,14,2,"wolkig",53,"wolbecker"
"6/17/2016 2:00",19,20,14,0,"wolkig",39,"wolbecker"
"6/17/2016 3:00",8,11,14,2,"wolkig",19,"wolbecker"
"6/17/2016 4:00",10,10,14,4,"Regen",20,"wolbecker"
"6/17/2016 5:00",44,41,13,4,"Nebel",85,"wolbecker"
"6/17/2016 6:00",114,166,14,4,"wolkig",280,"wolbecker"
"6/17/2016 7:00",594,275,15,7,"teilweise bewölkt",869,"wolbecker"
"6/17/2016 8:00",523,230,15,11,"wolkig",753,"wolbecker"
"6/17/2016 9:00",425,180,16,9,"teilweise bewölkt",605,"wolbecker"
"6/17/2016 10:00",234,158,15,13,"Regen",392,"wolbecker"
"6/17/2016 11:00",301,231,15,11,"Regen",532,"wolbecker"
"6/17/2016 12:00",282,325,15,13,"Regen",607,"wolbecker"
"6/17/2016 13:00",363,475,16,9,"Regen",838,"wolbecker"
"6/17/2016 14:00",360,425,16,11,"wolkig",785,"wolbecker"
"6/17/2016 15:00",354,413,16,15,"wolkig",767,"wolbecker"
"6/17/2016 16:00",287,387,17,15,"wolkig",674,"wolbecker"
"6/17/2016 17:00",400,452,18,17,"teilweise bewölkt",852,"wolbecker"
"6/17/2016 18:00",310,416,17,11,"Regen",726,"wolbecker"
"6/17/2016 19:00",252,367,17,13,"Klarer Himmel",619,"wolbecker"
"6/17/2016 20:00",200,226,17,7,"Klarer Himmel",426,"wolbecker"
"6/17/2016 21:00",145,140,16,7,"wolkig",285,"wolbecker"
"6/17/2016 22:00",139,156,15,7,"Klarer Himmel",295,"wolbecker"
"6/17/2016 23:00",119,112,14,6,"Klarer Himmel",231,"wolbecker"
"6/18/2016 0:00",91,93,15,7,"Klarer Himmel",184,"wolbecker"
"6/18/2016 1:00",60,80,13,6,"wolkig",140,"wolbecker"
"6/18/2016 2:00",31,36,14,7,"teilweise bewölkt",67,"wolbecker"
"6/18/2016 3:00",39,29,14,7,"wolkig",68,"wolbecker"
"6/18/2016 4:00",38,22,14,6,"wolkig",60,"wolbecker"
"6/18/2016 5:00",36,24,13,7,"wolkig",60,"wolbecker"
"6/18/2016 6:00",54,39,13,4,"Regen",93,"wolbecker"
"6/18/2016 7:00",104,75,14,7,"Regen",179,"wolbecker"
"6/18/2016 8:00",151,102,15,6,"wolkig",253,"wolbecker"
"6/18/2016 9:00",281,129,15,4,"wolkig",410,"wolbecker"
"6/18/2016 10:00",346,177,16,6,"wolkig",523,"wolbecker"
"6/18/2016 11:00",412,216,16,9,"Regen",628,"wolbecker"
"6/18/2016 12:00",309,265,15,9,"wolkig",574,"wolbecker"
"6/18/2016 13:00",297,314,16,15,"Regen",611,"wolbecker"
"6/18/2016 14:00",282,307,16,13,"Regen",589,"wolbecker"
"6/18/2016 15:00",265,319,18,9,"wolkig",584,"wolbecker"
"6/18/2016 16:00",275,321,18,9,"Regen",596,"wolbecker"
"6/18/2016 17:00",150,273,15,9,"wolkig",423,"wolbecker"
"6/18/2016 18:00",180,298,15,9,"wolkig",478,"wolbecker"
"6/18/2016 19:00",162,221,16,11,"wolkig",383,"wolbecker"
"6/18/2016 20:00",139,170,15,13,"Regen",309,"wolbecker"
"6/18/2016 21:00",142,124,14,9,"wolkig",266,"wolbecker"
"6/18/2016 22:00",105,77,14,15,"wolkig",182,"wolbecker"
"6/18/2016 23:00",103,105,14,11,"wolkig",208,"wolbecker"
"6/19/2016 0:00",73,93,14,11,"Regen",166,"wolbecker"
"6/19/2016 1:00",65,79,13,7,"Regen",144,"wolbecker"
"6/19/2016 2:00",52,54,13,11,"wolkig",106,"wolbecker"
"6/19/2016 3:00",34,25,12,15,"Regen",59,"wolbecker"
"6/19/2016 4:00",46,24,12,9,"wolkig",70,"wolbecker"
"6/19/2016 5:00",26,16,12,11,"wolkig",42,"wolbecker"
"6/19/2016 6:00",20,16,12,9,"wolkig",36,"wolbecker"
"6/19/2016 7:00",24,31,12,13,"wolkig",55,"wolbecker"
"6/19/2016 8:00",32,44,13,11,"wolkig",76,"wolbecker"
"6/19/2016 9:00",125,83,14,9,"teilweise bewölkt",208,"wolbecker"
"6/19/2016 10:00",136,100,14,13,"wolkig",236,"wolbecker"
"6/19/2016 11:00",151,116,14,13,"wolkig",267,"wolbecker"
"6/19/2016 12:00",163,153,14,13,"Regen",316,"wolbecker"
"6/19/2016 13:00",207,155,17,7,"teilweise bewölkt",362,"wolbecker"
"6/19/2016 14:00",205,198,16,15,"wolkig",403,"wolbecker"
"6/19/2016 15:00",234,208,18,9,"teilweise bewölkt",442,"wolbecker"
"6/19/2016 16:00",205,241,18,13,"teilweise bewölkt",446,"wolbecker"
"6/19/2016 17:00",253,234,18,7,"teilweise bewölkt",487,"wolbecker"
"6/19/2016 18:00",236,249,18,7,"teilweise bewölkt",485,"wolbecker"
"6/19/2016 19:00",216,180,17,6,"teilweise bewölkt",396,"wolbecker"
"6/19/2016 20:00",215,168,16,6,"teilweise bewölkt",383,"wolbecker"
"6/19/2016 21:00",140,91,14,9,"teilweise bewölkt",231,"wolbecker"
"6/19/2016 22:00",119,57,11,4,"Klarer Himmel",176,"wolbecker"
"6/19/2016 23:00",76,53,11,4,"Klarer Himmel",129,"wolbecker"
"6/20/2016 0:00",47,19,10,4,"Klarer Himmel",66,"wolbecker"
"6/20/2016 1:00",13,11,9,2,"Nebel",24,"wolbecker"
"6/20/2016 2:00",6,8,9,4,"Nebel",14,"wolbecker"
"6/20/2016 3:00",3,1,9,4,"Nebel",4,"wolbecker"
"6/20/2016 4:00",8,9,9,7,"teilweise bewölkt",17,"wolbecker"
"6/20/2016 5:00",51,49,9,6,"teilweise bewölkt",100,"wolbecker"
"6/20/2016 6:00",152,185,10,11,"Klarer Himmel",337,"wolbecker"
"6/20/2016 7:00",657,311,13,11,"Klarer Himmel",968,"wolbecker"
"6/20/2016 8:00",612,293,16,19,"wolkig",905,"wolbecker"
"6/20/2016 9:00",519,218,18,22,"wolkig",737,"wolbecker"
"6/20/2016 10:00",459,228,19,22,"wolkig",687,"wolbecker"
"6/20/2016 11:00",400,288,19,26,"wolkig",688,"wolbecker"
"6/20/2016 12:00",356,378,20,26,"wolkig",734,"wolbecker"
"6/20/2016 13:00",440,385,19,22,"Regen",825,"wolbecker"
"6/20/2016 14:00",391,404,20,15,"Regen",795,"wolbecker"
"6/20/2016 15:00",405,441,20,19,"Regen",846,"wolbecker"
"6/20/2016 16:00",412,512,19,13,"Regen",924,"wolbecker"
"6/20/2016 17:00",440,587,18,11,"Regen",1027,"wolbecker"
"6/20/2016 18:00",317,461,17,15,"Regen",778,"wolbecker"
"6/20/2016 19:00",206,312,16,13,"Regen",518,"wolbecker"
"6/20/2016 20:00",147,215,16,20,"Regen",362,"wolbecker"
"6/20/2016 21:00",101,131,15,17,"Regen",232,"wolbecker"
"6/20/2016 22:00",88,105,15,17,"Regen",193,"wolbecker"
"6/20/2016 23:00",75,55,15,15,"Regen",130,"wolbecker"
"6/21/2016 0:00",28,30,16,17,"wolkig",58,"wolbecker"
"6/21/2016 1:00",17,10,16,19,"wolkig",27,"wolbecker"
"6/21/2016 2:00",3,11,15,11,"wolkig",14,"wolbecker"
"6/21/2016 3:00",3,6,15,13,"wolkig",9,"wolbecker"
"6/21/2016 4:00",9,3,15,9,"wolkig",12,"wolbecker"
"6/21/2016 5:00",48,41,15,9,"wolkig",89,"wolbecker"
"6/21/2016 6:00",143,177,16,9,"Regen",320,"wolbecker"
"6/21/2016 7:00",636,298,16,13,"wolkig",934,"wolbecker"
"6/21/2016 8:00",606,248,17,17,"wolkig",854,"wolbecker"
"6/21/2016 9:00",499,182,17,13,"wolkig",681,"wolbecker"
"6/21/2016 10:00",369,207,17,15,"wolkig",576,"wolbecker"
"6/21/2016 11:00",310,239,18,13,"wolkig",549,"wolbecker"
"6/21/2016 12:00",314,336,19,15,"wolkig",650,"wolbecker"
"6/21/2016 13:00",363,382,19,13,"wolkig",745,"wolbecker"
"6/21/2016 14:00",366,409,19,13,"wolkig",775,"wolbecker"
"6/21/2016 15:00",416,489,20,9,"wolkig",905,"wolbecker"
"6/21/2016 16:00",517,627,21,7,"wolkig",1144,"wolbecker"
"6/21/2016 17:00",720,812,21,11,"Regen",1532,"wolbecker"
"6/21/2016 18:00",222,330,20,11,"Regen",552,"wolbecker"
"6/21/2016 19:00",164,182,20,7,"wolkig",346,"wolbecker"
"6/21/2016 20:00",339,413,19,4,"wolkig",752,"wolbecker"
"6/21/2016 21:00",188,187,19,2,"wolkig",375,"wolbecker"
"6/21/2016 22:00",136,137,18,7,"wolkig",273,"wolbecker"
"6/21/2016 23:00",83,97,18,9,"wolkig",180,"wolbecker"
"6/22/2016 0:00",52,59,18,7,"wolkig",111,"wolbecker"
"6/22/2016 1:00",28,22,18,9,"wolkig",50,"wolbecker"
"6/22/2016 2:00",5,11,18,9,"Regen",16,"wolbecker"
"6/22/2016 3:00",7,12,18,7,"wolkig",19,"wolbecker"
"6/22/2016 4:00",6,6,17,9,"wolkig",12,"wolbecker"
"6/22/2016 5:00",47,55,17,7,"teilweise bewölkt",102,"wolbecker"
"6/22/2016 6:00",162,187,17,6,"wolkig",349,"wolbecker"
"6/22/2016 7:00",715,320,18,7,"wolkig",1035,"wolbecker"
"6/22/2016 8:00",697,296,18,11,"wolkig",993,"wolbecker"
"6/22/2016 9:00",565,222,19,13,"teilweise bewölkt",787,"wolbecker"
"6/22/2016 10:00",439,245,21,17,"teilweise bewölkt",684,"wolbecker"
"6/22/2016 11:00",469,328,21,13,"teilweise bewölkt",797,"wolbecker"
"6/22/2016 12:00",407,420,22,17,"wolkig",827,"wolbecker"
"6/22/2016 13:00",471,483,24,17,"wolkig",954,"wolbecker"
"6/22/2016 14:00",418,515,24,17,"teilweise bewölkt",933,"wolbecker"
"6/22/2016 15:00",414,495,24,13,"wolkig",909,"wolbecker"
"6/22/2016 16:00",465,591,24,15,"wolkig",1056,"wolbecker"
"6/22/2016 17:00",575,577,24,7,"wolkig",1152,"wolbecker"
"6/22/2016 18:00",476,647,24,7,"teilweise bewölkt",1123,"wolbecker"
"6/22/2016 19:00",383,527,24,6,"teilweise bewölkt",910,"wolbecker"
"6/22/2016 20:00",309,373,23,4,"Klarer Himmel",682,"wolbecker"
"6/22/2016 21:00",195,302,21,4,"Klarer Himmel",497,"wolbecker"
"6/22/2016 22:00",224,198,19,2,"Klarer Himmel",422,"wolbecker"
"6/22/2016 23:00",102,125,19,6,"teilweise bewölkt",227,"wolbecker"
"6/23/2016 0:00",60,123,19,4,"teilweise bewölkt",183,"wolbecker"
"6/23/2016 1:00",32,52,17,4,"Klarer Himmel",84,"wolbecker"
"6/23/2016 2:00",25,12,16,4,"Klarer Himmel",37,"wolbecker"
"6/23/2016 3:00",43,21,18,4,"wolkig",64,"wolbecker"
"6/23/2016 4:00",35,9,18,6,"wolkig",44,"wolbecker"
"6/23/2016 5:00",56,55,18,6,"Klarer Himmel",111,"wolbecker"
"6/23/2016 6:00",173,203,19,4,"teilweise bewölkt",376,"wolbecker"
"6/23/2016 7:00",729,324,21,9,"Klarer Himmel",1053,"wolbecker"
"6/23/2016 8:00",641,304,23,9,"Klarer Himmel",945,"wolbecker"
"6/23/2016 9:00",559,232,25,13,"Klarer Himmel",791,"wolbecker"
"6/23/2016 10:00",383,246,27,13,"Klarer Himmel",629,"wolbecker"
"6/23/2016 11:00",403,344,28,15,"Klarer Himmel",747,"wolbecker"
"6/23/2016 12:00",361,472,29,19,"teilweise bewölkt",833,"wolbecker"
"6/23/2016 13:00",377,503,31,19,"teilweise bewölkt",880,"wolbecker"
"6/23/2016 14:00",373,482,31,15,"Klarer Himmel",855,"wolbecker"
"6/23/2016 15:00",462,557,32,17,"Klarer Himmel",1019,"wolbecker"
"6/23/2016 16:00",476,636,32,15,"Klarer Himmel",1112,"wolbecker"
"6/23/2016 17:00",593,560,33,7,"Klarer Himmel",1153,"wolbecker"
"6/23/2016 18:00",568,504,28,4,"Gewitter",1072,"wolbecker"
"6/23/2016 19:00",337,302,20,15,"Gewitter",639,"wolbecker"
"6/23/2016 20:00",257,219,21,15,"Gewitter",476,"wolbecker"
"6/23/2016 21:00",166,164,21,11,"wolkig",330,"wolbecker"
"6/23/2016 22:00",152,195,21,6,"wolkig",347,"wolbecker"
"6/23/2016 23:00",64,159,21,28,"Regen",223,"wolbecker"
"6/24/2016 0:00",36,72,20,13,"Gewitter",108,"wolbecker"
"6/24/2016 1:00",42,36,20,11,"teilweise bewölkt",78,"wolbecker"
"6/24/2016 2:00",13,22,19,9,"teilweise bewölkt",35,"wolbecker"
"6/24/2016 3:00",11,14,19,6,"Gewitter",25,"wolbecker"
"6/24/2016 4:00",9,8,19,4,"Gewitter",17,"wolbecker"
"6/24/2016 5:00",29,28,19,15,"Gewitter",57,"wolbecker"
"6/24/2016 6:00",126,139,19,6,"Gewitter",265,"wolbecker"
"6/24/2016 7:00",448,192,20,6,"Regen",640,"wolbecker"
"6/24/2016 8:00",371,154,19,9,"Regen",525,"wolbecker"
"6/24/2016 9:00",369,158,22,4,"teilweise bewölkt",527,"wolbecker"
"6/24/2016 10:00",339,193,22,6,"Klarer Himmel",532,"wolbecker"
"6/24/2016 11:00",367,257,25,6,"Klarer Himmel",624,"wolbecker"
"6/24/2016 12:00",330,336,27,4,"teilweise bewölkt",666,"wolbecker"
"6/24/2016 13:00",344,440,27,6,"wolkig",784,"wolbecker"
"6/24/2016 14:00",381,437,25,11,"wolkig",818,"wolbecker"
"6/24/2016 15:00",297,424,25,20,"wolkig",721,"wolbecker"
"6/24/2016 16:00",309,402,24,19,"wolkig",711,"wolbecker"
"6/24/2016 17:00",317,402,23,15,"wolkig",719,"wolbecker"
"6/24/2016 18:00",296,363,23,13,"wolkig",659,"wolbecker"
"6/24/2016 19:00",287,342,22,9,"wolkig",629,"wolbecker"
"6/24/2016 20:00",214,240,22,6,"wolkig",454,"wolbecker"
"6/24/2016 21:00",145,142,21,6,"wolkig",287,"wolbecker"
"6/24/2016 22:00",128,155,20,7,"wolkig",283,"wolbecker"
"6/24/2016 23:00",100,152,19,2,"teilweise bewölkt",252,"wolbecker"
"6/25/2016 0:00",93,113,18,4,"wolkig",206,"wolbecker"
"6/25/2016 1:00",55,93,18,0,"teilweise bewölkt",148,"wolbecker"
"6/25/2016 2:00",55,51,18,7,"teilweise bewölkt",106,"wolbecker"
"6/25/2016 3:00",44,36,18,7,"wolkig",80,"wolbecker"
"6/25/2016 4:00",47,26,18,7,"wolkig",73,"wolbecker"
"6/25/2016 5:00",41,17,18,6,"wolkig",58,"wolbecker"
"6/25/2016 6:00",33,35,18,4,"wolkig",68,"wolbecker"
"6/25/2016 7:00",102,59,18,9,"wolkig",161,"wolbecker"
"6/25/2016 8:00",111,78,18,6,"Regen",189,"wolbecker"
"6/25/2016 9:00",123,65,17,28,"Regen",188,"wolbecker"
"6/25/2016 10:00",119,95,17,4,"Regen",214,"wolbecker"
"6/25/2016 11:00",164,117,17,9,"Regen",281,"wolbecker"
"6/25/2016 12:00",149,138,17,15,"Regen",287,"wolbecker"
"6/25/2016 13:00",145,153,16,11,"Regen",298,"wolbecker"
"6/25/2016 14:00",139,168,16,11,"Regen",307,"wolbecker"
"6/25/2016 15:00",105,136,16,15,"Regen",241,"wolbecker"
"6/25/2016 16:00",137,159,15,15,"Regen",296,"wolbecker"
"6/25/2016 17:00",129,153,15,17,"Regen",282,"wolbecker"
"6/25/2016 18:00",167,179,15,9,"Regen",346,"wolbecker"
"6/25/2016 19:00",126,165,15,6,"Regen",291,"wolbecker"
"6/25/2016 20:00",120,150,15,4,"Regen",270,"wolbecker"
"6/25/2016 21:00",99,110,15,13,"wolkig",209,"wolbecker"
"6/25/2016 22:00",79,77,14,11,"wolkig",156,"wolbecker"
"6/25/2016 23:00",85,132,15,9,"wolkig",217,"wolbecker"
"6/26/2016 0:00",89,91,14,7,"teilweise bewölkt",180,"wolbecker"
"6/26/2016 1:00",58,57,14,13,"wolkig",115,"wolbecker"
"6/26/2016 2:00",43,39,14,7,"teilweise bewölkt",82,"wolbecker"
"6/26/2016 3:00",52,29,13,9,"teilweise bewölkt",81,"wolbecker"
"6/26/2016 4:00",35,25,12,7,"Nebel",60,"wolbecker"
"6/26/2016 5:00",30,12,12,7,"teilweise bewölkt",42,"wolbecker"
"6/26/2016 6:00",20,20,12,11,"teilweise bewölkt",40,"wolbecker"
"6/26/2016 7:00",33,23,13,9,"teilweise bewölkt",56,"wolbecker"
"6/26/2016 8:00",35,44,15,17,"wolkig",79,"wolbecker"
"6/26/2016 9:00",98,76,15,17,"wolkig",174,"wolbecker"
"6/26/2016 10:00",162,125,16,22,"wolkig",287,"wolbecker"
"6/26/2016 11:00",174,104,17,24,"teilweise bewölkt",278,"wolbecker"
"6/26/2016 12:00",209,155,17,20,"wolkig",364,"wolbecker"
"6/26/2016 13:00",186,168,18,19,"teilweise bewölkt",354,"wolbecker"
"6/26/2016 14:00",229,210,18,15,"wolkig",439,"wolbecker"
"6/26/2016 15:00",223,203,20,17,"wolkig",426,"wolbecker"
"6/26/2016 16:00",216,251,13,7,"Regen",467,"wolbecker"
"6/26/2016 17:00",307,322,17,9,"teilweise bewölkt",629,"wolbecker"
"6/26/2016 18:00",130,118,17,9,"teilweise bewölkt",248,"wolbecker"
"6/26/2016 19:00",102,82,18,13,"teilweise bewölkt",184,"wolbecker"
"6/26/2016 20:00",279,249,17,13,"teilweise bewölkt",528,"wolbecker"
"6/26/2016 21:00",168,119,16,9,"teilweise bewölkt",287,"wolbecker"
"6/26/2016 22:00",139,91,15,9,"teilweise bewölkt",230,"wolbecker"
"6/26/2016 23:00",71,63,15,7,"Klarer Himmel",134,"wolbecker"
"6/27/2016 0:00",24,20,14,9,"Klarer Himmel",44,"wolbecker"
"6/27/2016 1:00",7,11,13,9,"teilweise bewölkt",18,"wolbecker"
"6/27/2016 2:00",7,5,13,7,"teilweise bewölkt",12,"wolbecker"
"6/27/2016 3:00",2,5,13,9,"teilweise bewölkt",7,"wolbecker"
"6/27/2016 4:00",6,9,12,9,"Klarer Himmel",15,"wolbecker"
"6/27/2016 5:00",48,42,12,9,NA,90,"wolbecker"
"6/27/2016 6:00",178,178,13,13,NA,356,"wolbecker"
"6/27/2016 7:00",619,295,14,20,"teilweise bewölkt",914,"wolbecker"
"6/27/2016 8:00",599,274,15,22,"teilweise bewölkt",873,"wolbecker"
"6/27/2016 9:00",521,233,16,22,"teilweise bewölkt",754,"wolbecker"
"6/27/2016 10:00",457,223,17,20,"wolkig",680,"wolbecker"
"6/27/2016 11:00",379,260,19,19,"wolkig",639,"wolbecker"
"6/27/2016 12:00",353,350,18,26,"wolkig",703,"wolbecker"
"6/27/2016 13:00",388,371,19,24,"wolkig",759,"wolbecker"
"6/27/2016 14:00",375,364,18,22,"wolkig",739,"wolbecker"
"6/27/2016 15:00",428,403,18,20,"wolkig",831,"wolbecker"
"6/27/2016 16:00",340,578,16,15,"Regen",918,"wolbecker"
"6/27/2016 17:00",441,591,17,15,"wolkig",1032,"wolbecker"
"6/27/2016 18:00",389,480,17,9,"Regen",869,"wolbecker"
"6/27/2016 19:00",233,323,17,9,"Regen",556,"wolbecker"
"6/27/2016 20:00",149,248,15,6,"wolkig",397,"wolbecker"
"6/27/2016 21:00",132,164,15,9,"teilweise bewölkt",296,"wolbecker"
"6/27/2016 22:00",86,118,14,11,"teilweise bewölkt",204,"wolbecker"
"6/27/2016 23:00",70,78,13,7,"Klarer Himmel",148,"wolbecker"
"6/28/2016 0:00",31,32,12,7,"Nebel",63,"wolbecker"
"6/28/2016 1:00",19,18,11,4,"Nebel",37,"wolbecker"
"6/28/2016 2:00",7,6,11,0,"Nebel",13,"wolbecker"
"6/28/2016 3:00",7,5,10,2,"Nebel",12,"wolbecker"
"6/28/2016 4:00",0,8,10,2,"Nebel",8,"wolbecker"
"6/28/2016 5:00",40,44,10,2,"Nebel",84,"wolbecker"
"6/28/2016 6:00",178,197,11,4,"Nebel",375,"wolbecker"
"6/28/2016 7:00",592,338,13,4,"teilweise bewölkt",930,"wolbecker"
"6/28/2016 8:00",679,261,15,6,"teilweise bewölkt",940,"wolbecker"
"6/28/2016 9:00",582,239,16,7,"teilweise bewölkt",821,"wolbecker"
"6/28/2016 10:00",455,227,17,6,"teilweise bewölkt",682,"wolbecker"
"6/28/2016 11:00",416,284,19,4,"teilweise bewölkt",700,"wolbecker"
"6/28/2016 12:00",371,418,20,9,"teilweise bewölkt",789,"wolbecker"
"6/28/2016 13:00",404,435,20,9,"teilweise bewölkt",839,"wolbecker"
"6/28/2016 14:00",380,454,21,7,"wolkig",834,"wolbecker"
"6/28/2016 15:00",455,486,21,11,"wolkig",941,"wolbecker"
"6/28/2016 16:00",462,604,21,7,"wolkig",1066,"wolbecker"
"6/28/2016 17:00",587,618,21,7,"wolkig",1205,"wolbecker"
"6/28/2016 18:00",476,612,21,7,"wolkig",1088,"wolbecker"
"6/28/2016 19:00",367,480,21,7,"teilweise bewölkt",847,"wolbecker"
"6/28/2016 20:00",247,356,20,6,"Klarer Himmel",603,"wolbecker"
"6/28/2016 21:00",205,227,19,4,"Klarer Himmel",432,"wolbecker"
"6/28/2016 22:00",170,171,18,6,"Klarer Himmel",341,"wolbecker"
"6/28/2016 23:00",86,100,18,7,"Klarer Himmel",186,"wolbecker"
"6/29/2016 0:00",49,42,17,7,"Klarer Himmel",91,"wolbecker"
"6/29/2016 1:00",16,21,17,7,"wolkig",37,"wolbecker"
"6/29/2016 2:00",5,11,15,9,"Regen",16,"wolbecker"
"6/29/2016 3:00",1,4,15,9,"Regen",5,"wolbecker"
"6/29/2016 4:00",4,9,15,13,"Regen",13,"wolbecker"
"6/29/2016 5:00",44,49,14,9,NA,93,"wolbecker"
"6/29/2016 6:00",176,162,15,13,"teilweise bewölkt",338,"wolbecker"
"6/29/2016 7:00",659,330,15,19,"teilweise bewölkt",989,"wolbecker"
"6/29/2016 8:00",668,289,16,24,"wolkig",957,"wolbecker"
"6/29/2016 9:00",535,215,16,24,"wolkig",750,"wolbecker"
"6/29/2016 10:00",427,253,16,26,"wolkig",680,"wolbecker"
"6/29/2016 11:00",402,254,17,24,"teilweise bewölkt",656,"wolbecker"
"6/29/2016 12:00",367,386,17,20,"wolkig",753,"wolbecker"
"6/29/2016 13:00",423,410,18,19,"wolkig",833,"wolbecker"
"6/29/2016 14:00",353,398,19,26,"teilweise bewölkt",751,"wolbecker"
"6/29/2016 15:00",390,447,20,26,"teilweise bewölkt",837,"wolbecker"
"6/29/2016 16:00",434,535,21,22,"wolkig",969,"wolbecker"
"6/29/2016 17:00",540,581,20,20,"wolkig",1121,"wolbecker"
"6/29/2016 18:00",448,562,20,19,"wolkig",1010,"wolbecker"
"6/29/2016 19:00",424,426,20,11,"Klarer Himmel",850,"wolbecker"
"6/29/2016 20:00",267,355,19,9,"Klarer Himmel",622,"wolbecker"
"6/29/2016 21:00",197,217,18,6,"Klarer Himmel",414,"wolbecker"
"6/29/2016 22:00",189,180,17,7,"Klarer Himmel",369,"wolbecker"
"6/29/2016 23:00",85,118,16,6,"Klarer Himmel",203,"wolbecker"
"6/30/2016 0:00",74,81,15,6,"Klarer Himmel",155,"wolbecker"
"6/30/2016 1:00",32,33,16,9,"Klarer Himmel",65,"wolbecker"
"6/30/2016 2:00",12,28,16,7,"Klarer Himmel",40,"wolbecker"
"6/30/2016 3:00",9,18,16,9,"Klarer Himmel",27,"wolbecker"
"6/30/2016 4:00",8,23,17,13,"Klarer Himmel",31,"wolbecker"
"6/30/2016 5:00",42,55,17,11,"Klarer Himmel",97,"wolbecker"
"6/30/2016 6:00",169,172,16,9,"wolkig",341,"wolbecker"
"6/30/2016 7:00",617,260,16,11,"wolkig",877,"wolbecker"
"6/30/2016 8:00",614,248,16,15,"wolkig",862,"wolbecker"
"6/30/2016 9:00",520,208,17,19,"wolkig",728,"wolbecker"
"6/30/2016 10:00",361,219,17,19,"wolkig",580,"wolbecker"
"6/30/2016 11:00",367,284,17,17,"wolkig",651,"wolbecker"
"6/30/2016 12:00",339,365,18,20,"Regen",704,"wolbecker"
"6/30/2016 13:00",411,404,19,20,"wolkig",815,"wolbecker"
"6/30/2016 14:00",359,409,19,20,"wolkig",768,"wolbecker"
"6/30/2016 15:00",412,469,19,15,"Regen",881,"wolbecker"
"6/30/2016 16:00",462,553,19,20,"Regen",1015,"wolbecker"
"6/30/2016 17:00",435,592,19,13,"wolkig",1027,"wolbecker"
"6/30/2016 18:00",490,567,20,17,"wolkig",1057,"wolbecker"
"6/30/2016 19:00",335,443,20,13,"wolkig",778,"wolbecker"
"6/30/2016 20:00",243,310,20,15,"wolkig",553,"wolbecker"
"6/30/2016 21:00",136,200,19,15,"wolkig",336,"wolbecker"
"6/30/2016 22:00",105,149,18,15,"wolkig",254,"wolbecker"
"6/30/2016 23:00",105,86,17,13,"Klarer Himmel",191,"wolbecker"
"7/1/2016 0:00",61,68,17,9,"wolkig",129,"wolbecker"
"7/1/2016 1:00",25,11,17,13,"wolkig",36,"wolbecker"
"7/1/2016 2:00",16,15,16,9,"wolkig",31,"wolbecker"
"7/1/2016 3:00",10,12,16,11,"wolkig",22,"wolbecker"
"7/1/2016 4:00",3,12,16,11,"Klarer Himmel",15,"wolbecker"
"7/1/2016 5:00",42,44,16,11,"wolkig",86,"wolbecker"
"7/1/2016 6:00",142,152,17,13,"wolkig",294,"wolbecker"
"7/1/2016 7:00",583,296,18,15,"wolkig",879,"wolbecker"
"7/1/2016 8:00",558,231,19,19,"wolkig",789,"wolbecker"
"7/1/2016 9:00",466,208,20,17,"wolkig",674,"wolbecker"
"7/1/2016 10:00",382,273,17,20,"Regen",655,"wolbecker"
"7/1/2016 11:00",370,282,17,17,"wolkig",652,"wolbecker"
"7/1/2016 12:00",423,398,20,22,"wolkig",821,"wolbecker"
"7/1/2016 13:00",383,496,20,19,"wolkig",879,"wolbecker"
"7/1/2016 14:00",445,510,20,17,"wolkig",955,"wolbecker"
"7/1/2016 15:00",415,428,20,20,"Regen",843,"wolbecker"
"7/1/2016 16:00",352,488,21,19,"wolkig",840,"wolbecker"
"7/1/2016 17:00",399,487,21,19,"wolkig",886,"wolbecker"
"7/1/2016 18:00",364,439,22,22,"wolkig",803,"wolbecker"
"7/1/2016 19:00",309,383,21,17,"wolkig",692,"wolbecker"
"7/1/2016 20:00",282,292,20,13,"Klarer Himmel",574,"wolbecker"
"7/1/2016 21:00",165,182,19,15,"wolkig",347,"wolbecker"
"7/1/2016 22:00",148,173,19,13,"Klarer Himmel",321,"wolbecker"
"7/1/2016 23:00",121,169,19,15,"wolkig",290,"wolbecker"
"7/2/2016 0:00",112,130,17,20,"Regen",242,"wolbecker"
"7/2/2016 1:00",80,75,16,11,"Regen",155,"wolbecker"
"7/2/2016 2:00",46,47,16,11,"Regen",93,"wolbecker"
"7/2/2016 3:00",26,16,15,11,"Regen",42,"wolbecker"
"7/2/2016 4:00",24,14,14,32,"Regen",38,"wolbecker"
"7/2/2016 5:00",32,12,14,15,"Regen",44,"wolbecker"
"7/2/2016 6:00",35,31,14,17,"wolkig",66,"wolbecker"
"7/2/2016 7:00",84,63,14,20,"wolkig",147,"wolbecker"
"7/2/2016 8:00",152,106,14,19,"wolkig",258,"wolbecker"
"7/2/2016 9:00",338,158,15,22,"wolkig",496,"wolbecker"
"7/2/2016 10:00",398,238,15,19,"wolkig",636,"wolbecker"
"7/2/2016 11:00",417,241,14,20,"Regen",658,"wolbecker"
"7/2/2016 12:00",409,329,17,22,"teilweise bewölkt",738,"wolbecker"
"7/2/2016 13:00",346,398,15,22,"Regen",744,"wolbecker"
"7/2/2016 14:00",301,399,19,22,"teilweise bewölkt",700,"wolbecker"
"7/2/2016 15:00",307,341,14,6,"Regen",648,"wolbecker"
"7/2/2016 16:00",284,330,16,15,"teilweise bewölkt",614,"wolbecker"
"7/2/2016 17:00",187,260,15,26,"Regen",447,"wolbecker"
"7/2/2016 18:00",281,329,16,17,"teilweise bewölkt",610,"wolbecker"
"7/2/2016 19:00",261,307,16,19,"teilweise bewölkt",568,"wolbecker"
"7/2/2016 20:00",261,299,15,13,"teilweise bewölkt",560,"wolbecker"
"7/2/2016 21:00",93,60,14,11,"teilweise bewölkt",153,"wolbecker"
"7/2/2016 22:00",82,43,13,11,"teilweise bewölkt",125,"wolbecker"
"7/2/2016 23:00",81,57,13,9,"Klarer Himmel",138,"wolbecker"
"7/3/2016 0:00",277,260,12,9,"Klarer Himmel",537,"wolbecker"
"7/3/2016 1:00",106,130,12,9,"teilweise bewölkt",236,"wolbecker"
"7/3/2016 2:00",63,83,11,9,"teilweise bewölkt",146,"wolbecker"
"7/3/2016 3:00",81,45,11,11,"Klarer Himmel",126,"wolbecker"
"7/3/2016 4:00",58,24,11,11,"teilweise bewölkt",82,"wolbecker"
"7/3/2016 5:00",30,19,11,9,"teilweise bewölkt",49,"wolbecker"
"7/3/2016 6:00",26,20,11,11,"teilweise bewölkt",46,"wolbecker"
"7/3/2016 7:00",13,22,13,17,"wolkig",35,"wolbecker"
"7/3/2016 8:00",29,44,13,19,"Regen",73,"wolbecker"
"7/3/2016 9:00",102,53,13,15,"wolkig",155,"wolbecker"
"7/3/2016 10:00",154,109,15,13,"wolkig",263,"wolbecker"
"7/3/2016 11:00",132,137,17,15,"teilweise bewölkt",269,"wolbecker"
"7/3/2016 12:00",196,133,15,7,"Gewitter",329,"wolbecker"
"7/3/2016 13:00",219,181,19,19,"teilweise bewölkt",400,"wolbecker"
"7/3/2016 14:00",225,196,17,28,"teilweise bewölkt",421,"wolbecker"
"7/3/2016 15:00",209,178,18,19,"wolkig",387,"wolbecker"
"7/3/2016 16:00",237,186,19,19,"teilweise bewölkt",423,"wolbecker"
"7/3/2016 17:00",274,236,19,17,"teilweise bewölkt",510,"wolbecker"
"7/3/2016 18:00",240,207,19,15,"teilweise bewölkt",447,"wolbecker"
"7/3/2016 19:00",249,171,16,11,"teilweise bewölkt",420,"wolbecker"
"7/3/2016 20:00",161,168,16,9,"wolkig",329,"wolbecker"
"7/3/2016 21:00",113,80,14,6,"teilweise bewölkt",193,"wolbecker"
"7/3/2016 22:00",73,48,13,6,"teilweise bewölkt",121,"wolbecker"
"7/3/2016 23:00",70,63,12,2,"Klarer Himmel",133,"wolbecker"
"7/4/2016 0:00",40,16,11,2,"Nebel",56,"wolbecker"
"7/4/2016 1:00",12,10,10,2,"Nebel",22,"wolbecker"
"7/4/2016 2:00",5,4,11,2,"Nebel",9,"wolbecker"
"7/4/2016 3:00",1,4,11,2,"Nebel",5,"wolbecker"
"7/4/2016 4:00",2,6,10,2,"Nebel",8,"wolbecker"
"7/4/2016 5:00",48,50,11,2,"Klarer Himmel",98,"wolbecker"
"7/4/2016 6:00",157,170,12,2,"Klarer Himmel",327,"wolbecker"
"7/4/2016 7:00",607,311,13,4,"Klarer Himmel",918,"wolbecker"
"7/4/2016 8:00",638,259,15,6,"Klarer Himmel",897,"wolbecker"
"7/4/2016 9:00",574,196,18,6,"wolkig",770,"wolbecker"
"7/4/2016 10:00",431,256,19,7,"teilweise bewölkt",687,"wolbecker"
"7/4/2016 11:00",435,336,20,9,"teilweise bewölkt",771,"wolbecker"
"7/4/2016 12:00",394,362,20,11,"teilweise bewölkt",756,"wolbecker"
"7/4/2016 13:00",424,405,21,9,"teilweise bewölkt",829,"wolbecker"
"7/4/2016 14:00",399,415,22,9,"teilweise bewölkt",814,"wolbecker"
"7/4/2016 15:00",402,453,22,9,"teilweise bewölkt",855,"wolbecker"
"7/4/2016 16:00",439,540,22,11,"teilweise bewölkt",979,"wolbecker"
"7/4/2016 17:00",576,585,22,11,"teilweise bewölkt",1161,"wolbecker"
"7/4/2016 18:00",461,582,22,11,"teilweise bewölkt",1043,"wolbecker"
"7/4/2016 19:00",336,534,21,6,"wolkig",870,"wolbecker"
"7/4/2016 20:00",215,274,20,9,"teilweise bewölkt",489,"wolbecker"
"7/4/2016 21:00",216,216,18,6,"Klarer Himmel",432,"wolbecker"
"7/4/2016 22:00",153,169,17,2,"Klarer Himmel",322,"wolbecker"
"7/4/2016 23:00",94,94,15,2,"Klarer Himmel",188,"wolbecker"
"7/5/2016 0:00",40,38,15,4,"wolkig",78,"wolbecker"
"7/5/2016 1:00",13,9,14,2,"Klarer Himmel",22,"wolbecker"
"7/5/2016 2:00",9,7,13,2,"Nebel",16,"wolbecker"
"7/5/2016 3:00",4,9,13,6,"Nebel",13,"wolbecker"
"7/5/2016 4:00",6,10,13,2,"Nebel",16,"wolbecker"
"7/5/2016 5:00",42,48,14,6,"wolkig",90,"wolbecker"
"7/5/2016 6:00",169,189,15,6,"Klarer Himmel",358,"wolbecker"
"7/5/2016 7:00",620,316,17,15,"Klarer Himmel",936,"wolbecker"
"7/5/2016 8:00",720,304,18,20,NA,1024,"wolbecker"
"7/5/2016 9:00",528,213,19,26,"teilweise bewölkt",741,"wolbecker"
"7/5/2016 10:00",422,256,19,20,"wolkig",678,"wolbecker"
"7/5/2016 11:00",339,248,19,26,"wolkig",587,"wolbecker"
"7/5/2016 12:00",307,362,18,28,"wolkig",669,"wolbecker"
"7/5/2016 13:00",368,378,17,26,"Regen",746,"wolbecker"
"7/5/2016 14:00",319,400,19,22,"wolkig",719,"wolbecker"
"7/5/2016 15:00",392,417,19,26,"wolkig",809,"wolbecker"
"7/5/2016 16:00",454,542,19,28,"wolkig",996,"wolbecker"
"7/5/2016 17:00",493,607,19,35,"teilweise bewölkt",1100,"wolbecker"
"7/5/2016 18:00",473,568,18,41,"teilweise bewölkt",1041,"wolbecker"
"7/5/2016 19:00",403,461,16,35,"wolkig",864,"wolbecker"
"7/5/2016 20:00",206,318,15,26,"wolkig",524,"wolbecker"
"7/5/2016 21:00",191,192,14,24,"wolkig",383,"wolbecker"
"7/5/2016 22:00",152,156,14,19,"wolkig",308,"wolbecker"
"7/5/2016 23:00",83,94,14,20,"wolkig",177,"wolbecker"
"7/6/2016 0:00",31,34,13,17,"wolkig",65,"wolbecker"
"7/6/2016 1:00",18,16,13,17,"wolkig",34,"wolbecker"
"7/6/2016 2:00",8,13,13,17,"wolkig",21,"wolbecker"
"7/6/2016 3:00",3,10,12,15,"wolkig",13,"wolbecker"
"7/6/2016 4:00",6,7,12,15,"wolkig",13,"wolbecker"
"7/6/2016 5:00",46,48,12,13,"teilweise bewölkt",94,"wolbecker"
"7/6/2016 6:00",179,181,12,17,"teilweise bewölkt",360,"wolbecker"
"7/6/2016 7:00",693,335,13,19,"teilweise bewölkt",1028,"wolbecker"
"7/6/2016 8:00",706,298,15,20,"teilweise bewölkt",1004,"wolbecker"
"7/6/2016 9:00",548,230,15,22,"teilweise bewölkt",778,"wolbecker"
"7/6/2016 10:00",463,232,16,20,"teilweise bewölkt",695,"wolbecker"
"7/6/2016 11:00",477,314,16,17,"wolkig",791,"wolbecker"
"7/6/2016 12:00",421,461,17,17,"wolkig",882,"wolbecker"
"7/6/2016 13:00",422,469,19,22,"teilweise bewölkt",891,"wolbecker"
"7/6/2016 14:00",395,497,19,19,"teilweise bewölkt",892,"wolbecker"
"7/6/2016 15:00",430,497,20,22,"teilweise bewölkt",927,"wolbecker"
"7/6/2016 16:00",450,614,19,22,"teilweise bewölkt",1064,"wolbecker"
"7/6/2016 17:00",570,609,19,20,"teilweise bewölkt",1179,"wolbecker"
"7/6/2016 18:00",456,611,19,19,"teilweise bewölkt",1067,"wolbecker"
"7/6/2016 19:00",379,451,19,17,"teilweise bewölkt",830,"wolbecker"
"7/6/2016 20:00",294,365,17,13,"teilweise bewölkt",659,"wolbecker"
"7/6/2016 21:00",186,215,15,9,"wolkig",401,"wolbecker"
"7/6/2016 22:00",151,141,14,9,"Klarer Himmel",292,"wolbecker"
"7/6/2016 23:00",131,117,13,9,"Klarer Himmel",248,"wolbecker"
"7/7/2016 0:00",55,53,13,6,"Klarer Himmel",108,"wolbecker"
"7/7/2016 1:00",23,31,11,6,"Klarer Himmel",54,"wolbecker"
"7/7/2016 2:00",12,26,10,2,"Klarer Himmel",38,"wolbecker"
"7/7/2016 3:00",12,21,9,2,"Klarer Himmel",33,"wolbecker"
"7/7/2016 4:00",7,11,9,4,"Nebel",18,"wolbecker"
"7/7/2016 5:00",58,57,8,0,"Nebel",115,"wolbecker"
"7/7/2016 6:00",148,161,10,6,"Klarer Himmel",309,"wolbecker"
"7/7/2016 7:00",613,312,13,6,"Klarer Himmel",925,"wolbecker"
"7/7/2016 8:00",716,303,15,7,"Klarer Himmel",1019,"wolbecker"
"7/7/2016 9:00",586,214,16,7,"teilweise bewölkt",800,"wolbecker"
"7/7/2016 10:00",390,246,17,9,"teilweise bewölkt",636,"wolbecker"
"7/7/2016 11:00",387,286,18,11,"teilweise bewölkt",673,"wolbecker"
"7/7/2016 12:00",397,440,19,11,"wolkig",837,"wolbecker"
"7/7/2016 13:00",451,449,20,13,"Klarer Himmel",900,"wolbecker"
"7/7/2016 14:00",409,456,21,9,"Klarer Himmel",865,"wolbecker"
"7/7/2016 15:00",451,529,22,15,"Klarer Himmel",980,"wolbecker"
"7/7/2016 16:00",478,585,22,15,"Klarer Himmel",1063,"wolbecker"
"7/7/2016 17:00",543,617,22,17,"Klarer Himmel",1160,"wolbecker"
"7/7/2016 18:00",490,628,22,15,"Klarer Himmel",1118,"wolbecker"
"7/7/2016 19:00",559,572,22,11,"Klarer Himmel",1131,"wolbecker"
"7/7/2016 20:00",441,469,20,6,"Klarer Himmel",910,"wolbecker"
"7/7/2016 21:00",100,94,17,2,"Klarer Himmel",194,"wolbecker"
"7/7/2016 22:00",53,109,16,4,"Klarer Himmel",162,"wolbecker"
"7/7/2016 23:00",431,503,15,4,"Klarer Himmel",934,"wolbecker"
"7/8/2016 0:00",112,87,15,4,"Klarer Himmel",199,"wolbecker"
"7/8/2016 1:00",53,48,15,7,"Klarer Himmel",101,"wolbecker"
"7/8/2016 2:00",20,25,15,4,"Klarer Himmel",45,"wolbecker"
"7/8/2016 3:00",4,26,15,6,"Klarer Himmel",30,"wolbecker"
"7/8/2016 4:00",10,15,15,2,"Klarer Himmel",25,"wolbecker"
"7/8/2016 5:00",49,30,15,2,"Klarer Himmel",79,"wolbecker"
"7/8/2016 6:00",136,147,16,6,"Klarer Himmel",283,"wolbecker"
"7/8/2016 7:00",553,274,17,4,"Klarer Himmel",827,"wolbecker"
"7/8/2016 8:00",581,245,18,6,"Klarer Himmel",826,"wolbecker"
"7/8/2016 9:00",509,207,19,7,"Klarer Himmel",716,"wolbecker"
"7/8/2016 10:00",400,334,21,11,"Klarer Himmel",734,"wolbecker"
"7/8/2016 11:00",432,340,22,17,"Klarer Himmel",772,"wolbecker"
"7/8/2016 12:00",416,392,22,24,"wolkig",808,"wolbecker"
"7/8/2016 13:00",387,489,20,20,"wolkig",876,"wolbecker"
"7/8/2016 14:00",401,446,21,33,"wolkig",847,"wolbecker"
"7/8/2016 15:00",403,444,20,26,"Regen",847,"wolbecker"
"7/8/2016 16:00",431,494,20,22,"wolkig",925,"wolbecker"
"7/8/2016 17:00",432,464,21,30,"wolkig",896,"wolbecker"
"7/8/2016 18:00",422,450,20,24,"wolkig",872,"wolbecker"
"7/8/2016 19:00",402,360,19,24,"teilweise bewölkt",762,"wolbecker"
"7/8/2016 20:00",282,264,19,17,"teilweise bewölkt",546,"wolbecker"
"7/8/2016 21:00",195,215,18,15,"teilweise bewölkt",410,"wolbecker"
"7/8/2016 22:00",156,222,16,20,"Regen",378,"wolbecker"
"7/8/2016 23:00",112,211,16,9,"teilweise bewölkt",323,"wolbecker"
"7/9/2016 0:00",73,227,15,7,"wolkig",300,"wolbecker"
"7/9/2016 1:00",76,102,15,9,"Klarer Himmel",178,"wolbecker"
"7/9/2016 2:00",42,53,15,7,"wolkig",95,"wolbecker"
"7/9/2016 3:00",34,48,14,6,"teilweise bewölkt",82,"wolbecker"
"7/9/2016 4:00",25,27,15,7,"wolkig",52,"wolbecker"
"7/9/2016 5:00",39,20,14,6,"Nebel",59,"wolbecker"
"7/9/2016 6:00",30,39,15,9,NA,69,"wolbecker"
"7/9/2016 7:00",75,57,17,13,"teilweise bewölkt",132,"wolbecker"
"7/9/2016 8:00",150,103,17,13,"teilweise bewölkt",253,"wolbecker"
"7/9/2016 9:00",310,156,19,15,"wolkig",466,"wolbecker"
"7/9/2016 10:00",473,214,20,20,"wolkig",687,"wolbecker"
"7/9/2016 11:00",473,279,20,17,"wolkig",752,"wolbecker"
"7/9/2016 12:00",457,370,21,15,"wolkig",827,"wolbecker"
"7/9/2016 13:00",416,392,21,17,"teilweise bewölkt",808,"wolbecker"
"7/9/2016 14:00",387,445,23,19,"teilweise bewölkt",832,"wolbecker"
"7/9/2016 15:00",379,357,23,17,"teilweise bewölkt",736,"wolbecker"
"7/9/2016 16:00",398,402,23,20,"wolkig",800,"wolbecker"
"7/9/2016 17:00",406,439,22,20,"Regen",845,"wolbecker"
"7/9/2016 18:00",412,374,22,11,"wolkig",786,"wolbecker"
"7/9/2016 19:00",416,354,22,9,"Klarer Himmel",770,"wolbecker"
"7/9/2016 20:00",310,270,22,7,"wolkig",580,"wolbecker"
"7/9/2016 21:00",233,242,20,7,"Klarer Himmel",475,"wolbecker"
"7/9/2016 22:00",178,215,20,9,"Klarer Himmel",393,"wolbecker"
"7/9/2016 23:00",91,240,20,11,"wolkig",331,"wolbecker"
"7/10/2016 0:00",113,362,20,7,"wolkig",475,"wolbecker"
"7/10/2016 1:00",81,162,18,6,"Klarer Himmel",243,"wolbecker"
"7/10/2016 2:00",73,92,18,9,"Klarer Himmel",165,"wolbecker"
"7/10/2016 3:00",52,59,19,11,"Klarer Himmel",111,"wolbecker"
"7/10/2016 4:00",44,28,17,9,"Klarer Himmel",72,"wolbecker"
"7/10/2016 5:00",36,12,17,4,"Klarer Himmel",48,"wolbecker"
"7/10/2016 6:00",16,19,18,7,"Klarer Himmel",35,"wolbecker"
"7/10/2016 7:00",26,25,19,9,"Klarer Himmel",51,"wolbecker"
"7/10/2016 8:00",40,48,22,11,"Klarer Himmel",88,"wolbecker"
"7/10/2016 9:00",151,79,24,15,"Klarer Himmel",230,"wolbecker"
"7/10/2016 10:00",187,117,25,17,"Klarer Himmel",304,"wolbecker"
"7/10/2016 11:00",224,156,26,19,"teilweise bewölkt",380,"wolbecker"
"7/10/2016 12:00",245,187,27,20,"wolkig",432,"wolbecker"
"7/10/2016 13:00",292,252,28,22,"teilweise bewölkt",544,"wolbecker"
"7/10/2016 14:00",322,269,28,24,"Klarer Himmel",591,"wolbecker"
"7/10/2016 15:00",319,296,29,20,"Klarer Himmel",615,"wolbecker"
"7/10/2016 16:00",335,344,29,17,"Klarer Himmel",679,"wolbecker"
"7/10/2016 17:00",311,298,29,20,"Klarer Himmel",609,"wolbecker"
"7/10/2016 18:00",330,262,29,13,"Klarer Himmel",592,"wolbecker"
"7/10/2016 19:00",312,240,28,7,"Klarer Himmel",552,"wolbecker"
"7/10/2016 20:00",283,242,26,7,"Klarer Himmel",525,"wolbecker"
"7/10/2016 21:00",140,121,25,6,"Klarer Himmel",261,"wolbecker"
"7/10/2016 22:00",92,79,24,15,"Klarer Himmel",171,"wolbecker"
"7/10/2016 23:00",95,96,21,15,"Klarer Himmel",191,"wolbecker"
"7/11/2016 0:00",57,54,20,7,"Klarer Himmel",111,"wolbecker"
"7/11/2016 1:00",18,17,20,6,"Klarer Himmel",35,"wolbecker"
"7/11/2016 2:00",11,7,20,15,"Klarer Himmel",18,"wolbecker"
"7/11/2016 3:00",2,10,19,15,"Klarer Himmel",12,"wolbecker"
"7/11/2016 4:00",5,6,19,13,"Klarer Himmel",11,"wolbecker"
"7/11/2016 5:00",50,41,19,13,NA,91,"wolbecker"
"7/11/2016 6:00",156,125,19,15,"wolkig",281,"wolbecker"
"7/11/2016 7:00",410,207,19,19,"wolkig",617,"wolbecker"
"7/11/2016 8:00",559,227,19,26,"wolkig",786,"wolbecker"
"7/11/2016 9:00",522,180,19,22,"wolkig",702,"wolbecker"
"7/11/2016 10:00",411,215,20,24,"wolkig",626,"wolbecker"
"7/11/2016 11:00",371,206,21,28,"wolkig",577,"wolbecker"
"7/11/2016 12:00",361,319,22,28,"teilweise bewölkt",680,"wolbecker"
"7/11/2016 13:00",357,367,22,30,"wolkig",724,"wolbecker"
"7/11/2016 14:00",394,367,22,28,"wolkig",761,"wolbecker"
"7/11/2016 15:00",370,400,23,32,"wolkig",770,"wolbecker"
"7/11/2016 16:00",392,547,23,28,"teilweise bewölkt",939,"wolbecker"
"7/11/2016 17:00",517,593,23,26,"teilweise bewölkt",1110,"wolbecker"
"7/11/2016 18:00",414,613,23,28,"Klarer Himmel",1027,"wolbecker"
"7/11/2016 19:00",298,439,22,24,"Klarer Himmel",737,"wolbecker"
"7/11/2016 20:00",194,291,22,20,"Klarer Himmel",485,"wolbecker"
"7/11/2016 21:00",149,183,21,17,"wolkig",332,"wolbecker"
"7/11/2016 22:00",147,141,19,11,"teilweise bewölkt",288,"wolbecker"
"7/11/2016 23:00",95,64,19,13,"teilweise bewölkt",159,"wolbecker"
"7/12/2016 0:00",41,28,18,11,"Klarer Himmel",69,"wolbecker"
"7/12/2016 1:00",18,13,17,11,"Klarer Himmel",31,"wolbecker"
"7/12/2016 2:00",13,9,16,11,"Klarer Himmel",22,"wolbecker"
"7/12/2016 3:00",1,9,16,11,"Klarer Himmel",10,"wolbecker"
"7/12/2016 4:00",7,10,16,9,"Klarer Himmel",17,"wolbecker"
"7/12/2016 5:00",39,49,15,11,"Klarer Himmel",88,"wolbecker"
"7/12/2016 6:00",156,154,15,15,"teilweise bewölkt",310,"wolbecker"
"7/12/2016 7:00",449,256,16,19,"teilweise bewölkt",705,"wolbecker"
"7/12/2016 8:00",625,238,17,19,"teilweise bewölkt",863,"wolbecker"
"7/12/2016 9:00",491,198,19,19,"teilweise bewölkt",689,"wolbecker"
"7/12/2016 10:00",414,239,19,20,"wolkig",653,"wolbecker"
"7/12/2016 11:00",408,258,19,22,"wolkig",666,"wolbecker"
"7/12/2016 12:00",334,346,21,17,"wolkig",680,"wolbecker"
"7/12/2016 13:00",372,373,22,19,"wolkig",745,"wolbecker"
"7/12/2016 14:00",323,346,21,15,"teilweise bewölkt",669,"wolbecker"
"7/12/2016 15:00",399,445,23,22,"teilweise bewölkt",844,"wolbecker"
"7/12/2016 16:00",417,570,21,19,"teilweise bewölkt",987,"wolbecker"
"7/12/2016 17:00",477,603,20,7,"wolkig",1080,"wolbecker"
"7/12/2016 18:00",438,590,20,6,"wolkig",1028,"wolbecker"
"7/12/2016 19:00",303,450,17,4,"wolkig",753,"wolbecker"
"7/12/2016 20:00",222,311,16,0,"teilweise bewölkt",533,"wolbecker"
"7/12/2016 21:00",182,194,17,7,"Regen",376,"wolbecker"
"7/12/2016 22:00",155,120,16,4,"wolkig",275,"wolbecker"
"7/12/2016 23:00",93,62,16,6,"wolkig",155,"wolbecker"
"7/13/2016 0:00",61,28,15,4,"Klarer Himmel",89,"wolbecker"
"7/13/2016 1:00",20,18,14,0,"Nebel",38,"wolbecker"
"7/13/2016 2:00",7,8,13,0,"Nebel",15,"wolbecker"
"7/13/2016 3:00",7,6,13,6,NA,13,"wolbecker"
"7/13/2016 4:00",2,8,12,2,"Nebel",10,"wolbecker"
"7/13/2016 5:00",38,49,12,2,"Nebel",87,"wolbecker"
"7/13/2016 6:00",135,141,13,0,"wolkig",276,"wolbecker"
"7/13/2016 7:00",475,228,14,4,"teilweise bewölkt",703,"wolbecker"
"7/13/2016 8:00",613,238,15,2,"wolkig",851,"wolbecker"
"7/13/2016 9:00",546,197,17,6,"teilweise bewölkt",743,"wolbecker"
"7/13/2016 10:00",435,253,18,9,"wolkig",688,"wolbecker"
"7/13/2016 11:00",461,266,19,15,"wolkig",727,"wolbecker"
"7/13/2016 12:00",394,403,19,9,"wolkig",797,"wolbecker"
"7/13/2016 13:00",389,459,20,15,"teilweise bewölkt",848,"wolbecker"
"7/13/2016 14:00",335,409,21,13,NA,744,"wolbecker"
"7/13/2016 15:00",358,462,21,19,"wolkig",820,"wolbecker"
"7/13/2016 16:00",396,586,17,19,"wolkig",982,"wolbecker"
"7/13/2016 17:00",481,576,15,11,"Regen",1057,"wolbecker"
"7/13/2016 18:00",355,526,15,6,"wolkig",881,"wolbecker"
"7/13/2016 19:00",322,379,15,7,"wolkig",701,"wolbecker"
"7/13/2016 20:00",224,267,15,9,"wolkig",491,"wolbecker"
"7/13/2016 21:00",135,174,15,9,"wolkig",309,"wolbecker"
"7/13/2016 22:00",163,133,14,11,"wolkig",296,"wolbecker"
"7/13/2016 23:00",91,87,13,6,"wolkig",178,"wolbecker"
"7/14/2016 0:00",46,45,13,6,"Klarer Himmel",91,"wolbecker"
"7/14/2016 1:00",23,38,12,9,"wolkig",61,"wolbecker"
"7/14/2016 2:00",13,26,11,7,"Klarer Himmel",39,"wolbecker"
"7/14/2016 3:00",11,11,10,7,"Klarer Himmel",22,"wolbecker"
"7/14/2016 4:00",16,14,10,4,"Nebel",30,"wolbecker"
"7/14/2016 5:00",50,46,10,6,"Nebel",96,"wolbecker"
"7/14/2016 6:00",138,152,11,4,"teilweise bewölkt",290,"wolbecker"
"7/14/2016 7:00",416,223,12,7,"teilweise bewölkt",639,"wolbecker"
"7/14/2016 8:00",586,243,14,13,"teilweise bewölkt",829,"wolbecker"
"7/14/2016 9:00",513,161,16,13,NA,674,"wolbecker"
"7/14/2016 10:00",387,235,16,11,"teilweise bewölkt",622,"wolbecker"
"7/14/2016 11:00",351,287,16,13,"teilweise bewölkt",638,"wolbecker"
"7/14/2016 12:00",290,309,18,19,"teilweise bewölkt",599,"wolbecker"
"7/14/2016 13:00",348,323,17,15,"teilweise bewölkt",671,"wolbecker"
"7/14/2016 14:00",347,376,16,2,"wolkig",723,"wolbecker"
"7/14/2016 15:00",340,430,16,15,"teilweise bewölkt",770,"wolbecker"
"7/14/2016 16:00",411,526,15,15,"teilweise bewölkt",937,"wolbecker"
"7/14/2016 17:00",450,579,17,19,"wolkig",1029,"wolbecker"
"7/14/2016 18:00",414,553,16,19,"wolkig",967,"wolbecker"
"7/14/2016 19:00",302,468,14,20,"wolkig",770,"wolbecker"
"7/14/2016 20:00",176,275,13,19,"wolkig",451,"wolbecker"
"7/14/2016 21:00",161,179,14,15,"wolkig",340,"wolbecker"
"7/14/2016 22:00",157,146,13,11,"teilweise bewölkt",303,"wolbecker"
"7/14/2016 23:00",111,76,12,11,"Klarer Himmel",187,"wolbecker"
"7/15/2016 0:00",42,46,11,9,"Klarer Himmel",88,"wolbecker"
"7/15/2016 1:00",22,27,12,11,"Klarer Himmel",49,"wolbecker"
"7/15/2016 2:00",7,15,12,13,"wolkig",22,"wolbecker"
"7/15/2016 3:00",4,14,12,11,"Klarer Himmel",18,"wolbecker"
"7/15/2016 4:00",6,11,12,13,"wolkig",17,"wolbecker"
"7/15/2016 5:00",44,47,12,9,"wolkig",91,"wolbecker"
"7/15/2016 6:00",120,125,13,13,"wolkig",245,"wolbecker"
"7/15/2016 7:00",376,181,13,17,"wolkig",557,"wolbecker"
"7/15/2016 8:00",522,183,15,17,"wolkig",705,"wolbecker"
"7/15/2016 9:00",454,184,15,17,"teilweise bewölkt",638,"wolbecker"
"7/15/2016 10:00",348,181,15,19,"teilweise bewölkt",529,"wolbecker"
"7/15/2016 11:00",363,242,16,19,NA,605,"wolbecker"
"7/15/2016 12:00",358,315,18,19,"wolkig",673,"wolbecker"
"7/15/2016 13:00",352,423,19,19,"wolkig",775,"wolbecker"
"7/15/2016 14:00",346,432,19,17,"teilweise bewölkt",778,"wolbecker"
"7/15/2016 15:00",376,420,19,15,"wolkig",796,"wolbecker"
"7/15/2016 16:00",364,451,19,6,"wolkig",815,"wolbecker"
"7/15/2016 17:00",390,482,20,20,"wolkig",872,"wolbecker"
"7/15/2016 18:00",329,471,19,11,"wolkig",800,"wolbecker"
"7/15/2016 19:00",362,355,19,7,"wolkig",717,"wolbecker"
"7/15/2016 20:00",336,265,18,7,"teilweise bewölkt",601,"wolbecker"
"7/15/2016 21:00",240,238,16,6,"teilweise bewölkt",478,"wolbecker"
"7/15/2016 22:00",160,240,13,0,"Nebel",400,"wolbecker"
"7/15/2016 23:00",99,221,12,2,"Nebel",320,"wolbecker"
"7/16/2016 0:00",83,166,11,4,"Nebel",249,"wolbecker"
"7/16/2016 1:00",60,127,11,0,"Nebel",187,"wolbecker"
"7/16/2016 2:00",47,68,12,6,"Nebel",115,"wolbecker"
"7/16/2016 3:00",45,31,13,7,"Klarer Himmel",76,"wolbecker"
"7/16/2016 4:00",31,22,14,7,"Klarer Himmel",53,"wolbecker"
"7/16/2016 5:00",43,19,15,6,"Regen",62,"wolbecker"
"7/16/2016 6:00",39,38,15,9,"wolkig",77,"wolbecker"
"7/16/2016 7:00",77,53,16,9,"wolkig",130,"wolbecker"
"7/16/2016 8:00",134,84,16,11,"wolkig",218,"wolbecker"
"7/16/2016 9:00",306,127,17,11,"wolkig",433,"wolbecker"
"7/16/2016 10:00",376,210,18,17,"wolkig",586,"wolbecker"
"7/16/2016 11:00",482,244,18,15,"wolkig",726,"wolbecker"
"7/16/2016 12:00",430,330,19,15,"wolkig",760,"wolbecker"
"7/16/2016 13:00",350,378,20,13,"wolkig",728,"wolbecker"
"7/16/2016 14:00",349,410,21,15,"wolkig",759,"wolbecker"
"7/16/2016 15:00",271,401,21,17,"wolkig",672,"wolbecker"
"7/16/2016 16:00",274,327,21,20,"wolkig",601,"wolbecker"
"7/16/2016 17:00",266,347,21,15,"wolkig",613,"wolbecker"
"7/16/2016 18:00",227,354,21,13,"wolkig",581,"wolbecker"
"7/16/2016 19:00",246,330,22,15,"wolkig",576,"wolbecker"
"7/16/2016 20:00",180,261,21,13,"wolkig",441,"wolbecker"
"7/16/2016 21:00",152,149,20,6,"wolkig",301,"wolbecker"
"7/16/2016 22:00",111,114,19,4,"teilweise bewölkt",225,"wolbecker"
"7/16/2016 23:00",112,129,19,4,"wolkig",241,"wolbecker"
"7/17/2016 0:00",113,112,19,7,"Klarer Himmel",225,"wolbecker"
"7/17/2016 1:00",77,90,19,7,"wolkig",167,"wolbecker"
"7/17/2016 2:00",75,61,19,7,"wolkig",136,"wolbecker"
"7/17/2016 3:00",58,41,19,9,"wolkig",99,"wolbecker"
"7/17/2016 4:00",41,20,19,9,"wolkig",61,"wolbecker"
"7/17/2016 5:00",32,13,19,9,"wolkig",45,"wolbecker"
"7/17/2016 6:00",29,12,19,11,"teilweise bewölkt",41,"wolbecker"
"7/17/2016 7:00",23,32,19,15,"wolkig",55,"wolbecker"
"7/17/2016 8:00",37,48,19,13,"wolkig",85,"wolbecker"
"7/17/2016 9:00",126,102,20,17,"wolkig",228,"wolbecker"
"7/17/2016 10:00",151,151,21,19,"wolkig",302,"wolbecker"
"7/17/2016 11:00",157,165,22,19,"wolkig",322,"wolbecker"
"7/17/2016 12:00",216,160,22,24,"wolkig",376,"wolbecker"
"7/17/2016 13:00",241,166,24,24,"wolkig",407,"wolbecker"
"7/17/2016 14:00",276,194,24,20,"teilweise bewölkt",470,"wolbecker"
"7/17/2016 15:00",294,216,25,28,"wolkig",510,"wolbecker"
"7/17/2016 16:00",274,219,24,20,"wolkig",493,"wolbecker"
"7/17/2016 17:00",238,254,24,22,"Klarer Himmel",492,"wolbecker"
"7/17/2016 18:00",236,239,23,20,"wolkig",475,"wolbecker"
"7/17/2016 19:00",226,242,22,15,"Klarer Himmel",468,"wolbecker"
"7/17/2016 20:00",181,168,21,9,"Klarer Himmel",349,"wolbecker"
"7/17/2016 21:00",147,114,19,7,"Klarer Himmel",261,"wolbecker"
"7/17/2016 22:00",125,83,17,6,"Klarer Himmel",208,"wolbecker"
"7/17/2016 23:00",85,43,16,6,"Klarer Himmel",128,"wolbecker"
"7/18/2016 0:00",32,24,15,6,"Klarer Himmel",56,"wolbecker"
"7/18/2016 1:00",24,11,14,7,"Klarer Himmel",35,"wolbecker"
"7/18/2016 2:00",10,1,16,6,"Klarer Himmel",11,"wolbecker"
"7/18/2016 3:00",1,4,13,2,"wolkig",5,"wolbecker"
"7/18/2016 4:00",10,6,12,0,"Nebel",16,"wolbecker"
"7/18/2016 5:00",44,44,13,4,"Nebel",88,"wolbecker"
"7/18/2016 6:00",149,130,15,4,"wolkig",279,"wolbecker"
"7/18/2016 7:00",411,217,16,6,"Regen",628,"wolbecker"
"7/18/2016 8:00",528,218,18,7,"teilweise bewölkt",746,"wolbecker"
"7/18/2016 9:00",431,187,20,7,"teilweise bewölkt",618,"wolbecker"
"7/18/2016 10:00",389,199,22,17,"teilweise bewölkt",588,"wolbecker"
"7/18/2016 11:00",371,262,23,15,"teilweise bewölkt",633,"wolbecker"
"7/18/2016 12:00",339,331,25,22,"teilweise bewölkt",670,"wolbecker"
"7/18/2016 13:00",343,317,25,17,"teilweise bewölkt",660,"wolbecker"
"7/18/2016 14:00",336,326,26,17,"teilweise bewölkt",662,"wolbecker"
"7/18/2016 15:00",368,465,27,19,"Klarer Himmel",833,"wolbecker"
"7/18/2016 16:00",411,515,27,15,"Klarer Himmel",926,"wolbecker"
"7/18/2016 17:00",513,596,26,15,"Klarer Himmel",1109,"wolbecker"
"7/18/2016 18:00",403,517,26,17,"Klarer Himmel",920,"wolbecker"
"7/18/2016 19:00",298,412,25,9,"Klarer Himmel",710,"wolbecker"
"7/18/2016 20:00",284,307,24,7,"Klarer Himmel",591,"wolbecker"
"7/18/2016 21:00",174,197,20,2,"Klarer Himmel",371,"wolbecker"
"7/18/2016 22:00",176,172,17,0,"Klarer Himmel",348,"wolbecker"
"7/18/2016 23:00",87,87,16,0,"Klarer Himmel",174,"wolbecker"
"7/19/2016 0:00",34,50,15,0,"Klarer Himmel",84,"wolbecker"
"7/19/2016 1:00",27,21,14,0,"Klarer Himmel",48,"wolbecker"
"7/19/2016 2:00",12,21,13,2,"Klarer Himmel",33,"wolbecker"
"7/19/2016 3:00",4,3,13,2,"Klarer Himmel",7,"wolbecker"
"7/19/2016 4:00",7,10,12,0,"Nebel",17,"wolbecker"
"7/19/2016 5:00",42,38,12,4,"Nebel",80,"wolbecker"
"7/19/2016 6:00",165,144,13,0,"Klarer Himmel",309,"wolbecker"
"7/19/2016 7:00",455,226,18,2,"Klarer Himmel",681,"wolbecker"
"7/19/2016 8:00",582,253,20,6,"Klarer Himmel",835,"wolbecker"
"7/19/2016 9:00",461,188,23,4,"Klarer Himmel",649,"wolbecker"
"7/19/2016 10:00",400,213,24,6,"Klarer Himmel",613,"wolbecker"
"7/19/2016 11:00",392,265,25,6,"Klarer Himmel",657,"wolbecker"
"7/19/2016 12:00",292,378,27,4,"Klarer Himmel",670,"wolbecker"
"7/19/2016 13:00",312,392,28,4,"Klarer Himmel",704,"wolbecker"
"7/19/2016 14:00",290,370,28,6,"Klarer Himmel",660,"wolbecker"
"7/19/2016 15:00",380,477,29,6,"Klarer Himmel",857,"wolbecker"
"7/19/2016 16:00",399,581,30,6,"Klarer Himmel",980,"wolbecker"
"7/19/2016 17:00",509,587,29,4,"Klarer Himmel",1096,"wolbecker"
"7/19/2016 18:00",493,564,30,2,"Klarer Himmel",1057,"wolbecker"
"7/19/2016 19:00",418,445,29,7,"Klarer Himmel",863,"wolbecker"
"7/19/2016 20:00",370,310,26,7,"Klarer Himmel",680,"wolbecker"
"7/19/2016 21:00",267,249,24,6,"Klarer Himmel",516,"wolbecker"
"7/19/2016 22:00",240,175,23,6,"Klarer Himmel",415,"wolbecker"
"7/19/2016 23:00",126,114,21,6,"Klarer Himmel",240,"wolbecker"
"7/20/2016 0:00",58,70,20,6,"Klarer Himmel",128,"wolbecker"
"7/20/2016 1:00",27,28,21,7,"Klarer Himmel",55,"wolbecker"
"7/20/2016 2:00",19,12,20,6,"Klarer Himmel",31,"wolbecker"
"7/20/2016 3:00",6,15,20,7,"Klarer Himmel",21,"wolbecker"
"7/20/2016 4:00",5,8,20,7,"Klarer Himmel",13,"wolbecker"
"7/20/2016 5:00",55,36,20,9,"Klarer Himmel",91,"wolbecker"
"7/20/2016 6:00",161,151,21,9,"Klarer Himmel",312,"wolbecker"
"7/20/2016 7:00",418,245,22,9,"Klarer Himmel",663,"wolbecker"
"7/20/2016 8:00",586,234,24,7,"Klarer Himmel",820,"wolbecker"
"7/20/2016 9:00",508,201,25,11,"Klarer Himmel",709,"wolbecker"
"7/20/2016 10:00",393,267,28,13,"Klarer Himmel",660,"wolbecker"
"7/20/2016 11:00",400,297,29,13,"Klarer Himmel",697,"wolbecker"
"7/20/2016 12:00",329,407,31,13,"Klarer Himmel",736,"wolbecker"
"7/20/2016 13:00",319,437,32,19,"Klarer Himmel",756,"wolbecker"
"7/20/2016 14:00",293,439,33,17,"Klarer Himmel",732,"wolbecker"
"7/20/2016 15:00",322,513,34,15,"Klarer Himmel",835,"wolbecker"
"7/20/2016 16:00",372,588,34,17,"Klarer Himmel",960,"wolbecker"
"7/20/2016 17:00",452,536,33,11,"Klarer Himmel",988,"wolbecker"
"7/20/2016 18:00",536,484,31,6,"Klarer Himmel",1020,"wolbecker"
"7/20/2016 19:00",517,379,30,4,"wolkig",896,"wolbecker"
"7/20/2016 20:00",263,176,23,22,"Gewitter",439,"wolbecker"
"7/20/2016 21:00",199,163,21,7,"wolkig",362,"wolbecker"
"7/20/2016 22:00",167,149,21,6,"Klarer Himmel",316,"wolbecker"
"7/20/2016 23:00",105,83,20,4,"Klarer Himmel",188,"wolbecker"
"7/21/2016 0:00",47,77,20,4,"wolkig",124,"wolbecker"
"7/21/2016 1:00",46,27,20,2,"Klarer Himmel",73,"wolbecker"
"7/21/2016 2:00",21,17,19,0,"Nebel",38,"wolbecker"
"7/21/2016 3:00",15,22,18,0,"Nebel",37,"wolbecker"
"7/21/2016 4:00",13,16,18,0,"Nebel",29,"wolbecker"
"7/21/2016 5:00",49,40,17,4,"Nebel",89,"wolbecker"
"7/21/2016 6:00",132,146,18,4,"Nebel",278,"wolbecker"
"7/21/2016 7:00",358,207,20,6,NA,565,"wolbecker"
"7/21/2016 8:00",517,213,22,9,NA,730,"wolbecker"
"7/21/2016 9:00",470,185,23,7,"Klarer Himmel",655,"wolbecker"
"7/21/2016 10:00",390,98,25,7,"Klarer Himmel",488,"wolbecker"
"7/21/2016 11:00",376,250,25,11,"teilweise bewölkt",626,"wolbecker"
"7/21/2016 12:00",297,353,26,9,"teilweise bewölkt",650,"wolbecker"
"7/21/2016 13:00",326,346,27,7,"teilweise bewölkt",672,"wolbecker"
"7/21/2016 14:00",327,350,29,7,"teilweise bewölkt",677,"wolbecker"
"7/21/2016 15:00",347,411,29,6,"teilweise bewölkt",758,"wolbecker"
"7/21/2016 16:00",379,525,30,4,"teilweise bewölkt",904,"wolbecker"
"7/21/2016 17:00",442,521,28,2,"wolkig",963,"wolbecker"
"7/21/2016 18:00",357,544,18,24,"Gewitter",901,"wolbecker"
"7/21/2016 19:00",242,282,21,4,"Regen",524,"wolbecker"
"7/21/2016 20:00",189,272,21,4,"Nebel",461,"wolbecker"
"7/21/2016 21:00",169,208,20,0,"Nebel",377,"wolbecker"
"7/21/2016 22:00",139,165,19,2,"Nebel",304,"wolbecker"
"7/21/2016 23:00",93,87,19,6,"teilweise bewölkt",180,"wolbecker"
"7/22/2016 0:00",59,44,18,2,"Klarer Himmel",103,"wolbecker"
"7/22/2016 1:00",42,20,18,2,NA,62,"wolbecker"
"7/22/2016 2:00",26,6,18,2,NA,32,"wolbecker"
"7/22/2016 3:00",15,13,19,2,NA,28,"wolbecker"
"7/22/2016 4:00",10,10,18,0,"Nebel",20,"wolbecker"
"7/22/2016 5:00",42,36,18,0,"Nebel",78,"wolbecker"
"7/22/2016 6:00",119,117,19,0,"Nebel",236,"wolbecker"
"7/22/2016 7:00",347,163,20,6,"Nebel",510,"wolbecker"
"7/22/2016 8:00",443,171,20,7,"wolkig",614,"wolbecker"
"7/22/2016 9:00",385,198,21,13,"Regen",583,"wolbecker"
"7/22/2016 10:00",362,198,21,19,"Regen",560,"wolbecker"
"7/22/2016 11:00",343,232,22,13,"wolkig",575,"wolbecker"
"7/22/2016 12:00",269,319,18,15,"Gewitter",588,"wolbecker"
"7/22/2016 13:00",304,348,21,19,"wolkig",652,"wolbecker"
"7/22/2016 14:00",350,376,23,13,"Klarer Himmel",726,"wolbecker"
"7/22/2016 15:00",386,401,24,7,"wolkig",787,"wolbecker"
"7/22/2016 16:00",319,431,24,6,"wolkig",750,"wolbecker"
"7/22/2016 17:00",333,439,25,7,"Klarer Himmel",772,"wolbecker"
"7/22/2016 18:00",321,447,25,7,"Klarer Himmel",768,"wolbecker"
"7/22/2016 19:00",288,433,25,7,"Klarer Himmel",721,"wolbecker"
"7/22/2016 20:00",247,282,23,9,"Klarer Himmel",529,"wolbecker"
"7/22/2016 21:00",183,164,21,11,"Klarer Himmel",347,"wolbecker"
"7/22/2016 22:00",162,152,20,4,"Klarer Himmel",314,"wolbecker"
"7/22/2016 23:00",154,128,20,13,"Klarer Himmel",282,"wolbecker"
"7/23/2016 0:00",123,113,19,7,"Klarer Himmel",236,"wolbecker"
"7/23/2016 1:00",91,69,19,7,"Klarer Himmel",160,"wolbecker"
"7/23/2016 2:00",73,59,19,6,"Klarer Himmel",132,"wolbecker"
"7/23/2016 3:00",51,40,18,4,NA,91,"wolbecker"
"7/23/2016 4:00",31,19,18,6,NA,50,"wolbecker"
"7/23/2016 5:00",44,32,18,7,"Nebel",76,"wolbecker"
"7/23/2016 6:00",42,27,18,2,"Nebel",69,"wolbecker"
"7/23/2016 7:00",92,53,19,7,"Nebel",145,"wolbecker"
"7/23/2016 8:00",148,104,19,11,"wolkig",252,"wolbecker"
"7/23/2016 9:00",274,131,20,15,"wolkig",405,"wolbecker"
"7/23/2016 10:00",379,177,21,11,"wolkig",556,"wolbecker"
"7/23/2016 11:00",419,253,21,13,"wolkig",672,"wolbecker"
"7/23/2016 12:00",347,325,22,9,"wolkig",672,"wolbecker"
"7/23/2016 13:00",383,351,22,9,"wolkig",734,"wolbecker"
"7/23/2016 14:00",299,337,24,6,"wolkig",636,"wolbecker"
"7/23/2016 15:00",243,335,24,7,"wolkig",578,"wolbecker"
"7/23/2016 16:00",234,332,24,4,"wolkig",566,"wolbecker"
"7/23/2016 17:00",240,303,25,4,"teilweise bewölkt",543,"wolbecker"
"7/23/2016 18:00",219,331,25,4,"wolkig",550,"wolbecker"
"7/23/2016 19:00",246,314,24,6,"wolkig",560,"wolbecker"
"7/23/2016 20:00",211,220,22,4,"Klarer Himmel",431,"wolbecker"
"7/23/2016 21:00",167,183,20,0,"Klarer Himmel",350,"wolbecker"
"7/23/2016 22:00",179,145,19,2,"Klarer Himmel",324,"wolbecker"
"7/23/2016 23:00",121,119,18,0,"Klarer Himmel",240,"wolbecker"
"7/24/2016 0:00",123,123,17,0,"Klarer Himmel",246,"wolbecker"
"7/24/2016 1:00",114,105,16,0,"Nebel",219,"wolbecker"
"7/24/2016 2:00",59,52,16,0,"Nebel",111,"wolbecker"
"7/24/2016 3:00",62,41,15,0,"Nebel",103,"wolbecker"
"7/24/2016 4:00",45,17,15,0,"Nebel",62,"wolbecker"
"7/24/2016 5:00",43,16,15,0,"Nebel",59,"wolbecker"
"7/24/2016 6:00",18,23,16,0,"Nebel",41,"wolbecker"
"7/24/2016 7:00",31,31,18,0,NA,62,"wolbecker"
"7/24/2016 8:00",45,62,19,6,"Klarer Himmel",107,"wolbecker"
"7/24/2016 9:00",109,81,22,4,"Klarer Himmel",190,"wolbecker"
"7/24/2016 10:00",180,114,23,7,"teilweise bewölkt",294,"wolbecker"
"7/24/2016 11:00",172,152,25,7,"teilweise bewölkt",324,"wolbecker"
"7/24/2016 12:00",173,221,26,7,"teilweise bewölkt",394,"wolbecker"
"7/24/2016 13:00",198,237,26,7,"teilweise bewölkt",435,"wolbecker"
"7/24/2016 14:00",205,265,27,6,"teilweise bewölkt",470,"wolbecker"
"7/24/2016 15:00",251,260,27,7,"teilweise bewölkt",511,"wolbecker"
"7/24/2016 16:00",278,257,27,11,"teilweise bewölkt",535,"wolbecker"
"7/24/2016 17:00",309,256,26,7,"wolkig",565,"wolbecker"
"7/24/2016 18:00",277,248,27,7,"wolkig",525,"wolbecker"
"7/24/2016 19:00",302,184,26,6,"Klarer Himmel",486,"wolbecker"
"7/24/2016 20:00",253,148,25,4,"Klarer Himmel",401,"wolbecker"
"7/24/2016 21:00",187,128,22,0,"Klarer Himmel",315,"wolbecker"
"7/24/2016 22:00",141,78,21,0,"Klarer Himmel",219,"wolbecker"
"7/24/2016 23:00",72,58,22,4,"Klarer Himmel",130,"wolbecker"
"7/25/2016 0:00",48,33,22,6,"Klarer Himmel",81,"wolbecker"
"7/25/2016 1:00",17,15,21,2,"Klarer Himmel",32,"wolbecker"
"7/25/2016 2:00",11,10,20,0,"Klarer Himmel",21,"wolbecker"
"7/25/2016 3:00",4,1,20,4,"Klarer Himmel",5,"wolbecker"
"7/25/2016 4:00",6,16,20,0,"wolkig",22,"wolbecker"
"7/25/2016 5:00",38,51,19,4,"wolkig",89,"wolbecker"
"7/25/2016 6:00",151,132,20,9,"wolkig",283,"wolbecker"
"7/25/2016 7:00",366,206,20,6,"wolkig",572,"wolbecker"
"7/25/2016 8:00",452,183,21,4,"wolkig",635,"wolbecker"
"7/25/2016 9:00",401,162,23,11,"wolkig",563,"wolbecker"
"7/25/2016 10:00",349,203,24,15,"wolkig",552,"wolbecker"
"7/25/2016 11:00",324,219,25,19,"wolkig",543,"wolbecker"
"7/25/2016 12:00",339,322,25,17,"wolkig",661,"wolbecker"
"7/25/2016 13:00",306,308,26,19,"teilweise bewölkt",614,"wolbecker"
"7/25/2016 14:00",333,304,25,13,"wolkig",637,"wolbecker"
"7/25/2016 15:00",334,395,24,17,"wolkig",729,"wolbecker"
"7/25/2016 16:00",406,464,24,17,"wolkig",870,"wolbecker"
"7/25/2016 17:00",413,534,25,17,"wolkig",947,"wolbecker"
"7/25/2016 18:00",386,506,25,17,"teilweise bewölkt",892,"wolbecker"
"7/25/2016 19:00",315,364,23,13,"teilweise bewölkt",679,"wolbecker"
"7/25/2016 20:00",231,242,22,7,"teilweise bewölkt",473,"wolbecker"
"7/25/2016 21:00",143,181,21,13,"teilweise bewölkt",324,"wolbecker"
"7/25/2016 22:00",131,131,19,13,"wolkig",262,"wolbecker"
"7/25/2016 23:00",90,64,18,6,"Klarer Himmel",154,"wolbecker"
"7/26/2016 0:00",56,57,17,0,"Klarer Himmel",113,"wolbecker"
"7/26/2016 1:00",21,23,18,4,"wolkig",44,"wolbecker"
"7/26/2016 2:00",18,16,18,7,"wolkig",34,"wolbecker"
"7/26/2016 3:00",4,8,16,4,"teilweise bewölkt",12,"wolbecker"
"7/26/2016 4:00",4,6,16,4,"teilweise bewölkt",10,"wolbecker"
"7/26/2016 5:00",42,48,15,0,"Nebel",90,"wolbecker"
"7/26/2016 6:00",137,115,15,2,"Nebel",252,"wolbecker"
"7/26/2016 7:00",394,243,16,0,"Klarer Himmel",637,"wolbecker"
"7/26/2016 8:00",474,244,18,4,"wolkig",718,"wolbecker"
"7/26/2016 9:00",407,165,19,4,"wolkig",572,"wolbecker"
"7/26/2016 10:00",363,191,20,6,"wolkig",554,"wolbecker"
"7/26/2016 11:00",349,288,22,6,"wolkig",637,"wolbecker"
"7/26/2016 12:00",341,317,23,7,"wolkig",658,"wolbecker"
"7/26/2016 13:00",350,369,23,9,"wolkig",719,"wolbecker"
"7/26/2016 14:00",352,299,24,9,"wolkig",651,"wolbecker"
"7/26/2016 15:00",363,411,24,7,"Klarer Himmel",774,"wolbecker"
"7/26/2016 16:00",420,539,24,4,"Klarer Himmel",959,"wolbecker"
"7/26/2016 17:00",478,564,24,6,"Klarer Himmel",1042,"wolbecker"
"7/26/2016 18:00",422,546,24,4,"Klarer Himmel",968,"wolbecker"
"7/26/2016 19:00",316,395,23,7,"Klarer Himmel",711,"wolbecker"
"7/26/2016 20:00",218,277,22,4,"Klarer Himmel",495,"wolbecker"
"7/26/2016 21:00",183,170,20,2,"Klarer Himmel",353,"wolbecker"
"7/26/2016 22:00",189,137,20,4,"Klarer Himmel",326,"wolbecker"
"7/26/2016 23:00",75,87,19,9,"Klarer Himmel",162,"wolbecker"
"7/27/2016 0:00",52,86,18,4,"Klarer Himmel",138,"wolbecker"
"7/27/2016 1:00",22,30,18,4,"Klarer Himmel",52,"wolbecker"
"7/27/2016 2:00",10,10,18,6,"Klarer Himmel",20,"wolbecker"
"7/27/2016 3:00",35,11,17,0,"Klarer Himmel",46,"wolbecker"
"7/27/2016 4:00",15,14,17,6,"Klarer Himmel",29,"wolbecker"
"7/27/2016 5:00",48,31,17,6,"Klarer Himmel",79,"wolbecker"
"7/27/2016 6:00",141,150,17,7,"Klarer Himmel",291,"wolbecker"
"7/27/2016 7:00",412,244,17,6,"Klarer Himmel",656,"wolbecker"
"7/27/2016 8:00",510,238,19,7,"Klarer Himmel",748,"wolbecker"
"7/27/2016 9:00",444,200,20,11,"wolkig",644,"wolbecker"
"7/27/2016 10:00",440,247,22,13,"wolkig",687,"wolbecker"
"7/27/2016 11:00",403,293,22,19,"wolkig",696,"wolbecker"
"7/27/2016 12:00",390,367,22,22,"teilweise bewölkt",757,"wolbecker"
"7/27/2016 13:00",353,395,22,22,"wolkig",748,"wolbecker"
"7/27/2016 14:00",324,388,23,24,"wolkig",712,"wolbecker"
"7/27/2016 15:00",347,373,23,24,"wolkig",720,"wolbecker"
"7/27/2016 16:00",408,531,23,24,"wolkig",939,"wolbecker"
"7/27/2016 17:00",480,529,23,26,"wolkig",1009,"wolbecker"
"7/27/2016 18:00",382,529,22,22,"wolkig",911,"wolbecker"
"7/27/2016 19:00",315,355,21,13,"Klarer Himmel",670,"wolbecker"
"7/27/2016 20:00",243,237,21,11,"wolkig",480,"wolbecker"
"7/27/2016 21:00",164,181,20,17,"Regen",345,"wolbecker"
"7/27/2016 22:00",135,119,18,15,"Regen",254,"wolbecker"
"7/27/2016 23:00",87,76,17,9,"wolkig",163,"wolbecker"
"7/28/2016 0:00",46,102,18,11,"wolkig",148,"wolbecker"
"7/28/2016 1:00",24,39,18,11,"wolkig",63,"wolbecker"
"7/28/2016 2:00",15,21,18,15,"wolkig",36,"wolbecker"
"7/28/2016 3:00",20,15,16,7,"Klarer Himmel",35,"wolbecker"
"7/28/2016 4:00",22,23,17,4,"Klarer Himmel",45,"wolbecker"
"7/28/2016 5:00",51,42,15,0,"Nebel",93,"wolbecker"
"7/28/2016 6:00",134,153,16,2,"wolkig",287,"wolbecker"
"7/28/2016 7:00",327,177,17,4,"wolkig",504,"wolbecker"
"7/28/2016 8:00",354,164,18,4,"wolkig",518,"wolbecker"
"7/28/2016 9:00",306,136,17,7,"Regen",442,"wolbecker"
"7/28/2016 10:00",255,151,17,6,"wolkig",406,"wolbecker"
"7/28/2016 11:00",261,168,18,4,"Regen",429,"wolbecker"
"7/28/2016 12:00",264,234,19,6,"Regen",498,"wolbecker"
"7/28/2016 13:00",265,290,20,11,"Regen",555,"wolbecker"
"7/28/2016 14:00",243,249,19,17,"Regen",492,"wolbecker"
"7/28/2016 15:00",296,327,20,17,"wolkig",623,"wolbecker"
"7/28/2016 16:00",327,428,21,13,"teilweise bewölkt",755,"wolbecker"
"7/28/2016 17:00",420,463,22,11,"wolkig",883,"wolbecker"
"7/28/2016 18:00",359,452,22,6,"wolkig",811,"wolbecker"
"7/28/2016 19:00",283,374,22,6,"wolkig",657,"wolbecker"
"7/28/2016 20:00",175,235,20,11,"wolkig",410,"wolbecker"
"7/28/2016 21:00",140,157,19,0,"wolkig",297,"wolbecker"
"7/28/2016 22:00",130,104,19,11,"wolkig",234,"wolbecker"
"7/28/2016 23:00",95,75,18,0,"wolkig",170,"wolbecker"
"7/29/2016 0:00",54,53,19,4,"wolkig",107,"wolbecker"
"7/29/2016 1:00",18,31,18,4,"wolkig",49,"wolbecker"
"7/29/2016 2:00",8,26,18,7,"Klarer Himmel",34,"wolbecker"
"7/29/2016 3:00",6,8,17,13,"wolkig",14,"wolbecker"
"7/29/2016 4:00",10,15,17,6,"wolkig",25,"wolbecker"
"7/29/2016 5:00",40,26,17,7,"wolkig",66,"wolbecker"
"7/29/2016 6:00",115,101,17,7,"Regen",216,"wolbecker"
"7/29/2016 7:00",277,182,17,13,"wolkig",459,"wolbecker"
"7/29/2016 8:00",359,165,17,13,"wolkig",524,"wolbecker"
"7/29/2016 9:00",348,148,17,9,"wolkig",496,"wolbecker"
"7/29/2016 10:00",306,212,19,15,"wolkig",518,"wolbecker"
"7/29/2016 11:00",341,221,20,17,"wolkig",562,"wolbecker"
"7/29/2016 12:00",357,308,21,17,"wolkig",665,"wolbecker"
"7/29/2016 13:00",252,310,17,11,"Regen",562,"wolbecker"
"7/29/2016 14:00",279,320,21,9,"wolkig",599,"wolbecker"
"7/29/2016 15:00",325,350,22,13,"teilweise bewölkt",675,"wolbecker"
"7/29/2016 16:00",306,368,23,26,"wolkig",674,"wolbecker"
"7/29/2016 17:00",325,425,23,24,"teilweise bewölkt",750,"wolbecker"
"7/29/2016 18:00",332,379,23,22,"teilweise bewölkt",711,"wolbecker"
"7/29/2016 19:00",236,335,22,24,"teilweise bewölkt",571,"wolbecker"
"7/29/2016 20:00",211,226,21,13,"wolkig",437,"wolbecker"
"7/29/2016 21:00",152,178,19,17,"wolkig",330,"wolbecker"
"7/29/2016 22:00",114,141,19,13,"Klarer Himmel",255,"wolbecker"
"7/29/2016 23:00",115,89,18,9,"Klarer Himmel",204,"wolbecker"
"7/30/2016 0:00",103,109,18,9,"Klarer Himmel",212,"wolbecker"
"7/30/2016 1:00",74,65,17,9,"wolkig",139,"wolbecker"
"7/30/2016 2:00",61,56,17,7,"Klarer Himmel",117,"wolbecker"
"7/30/2016 3:00",72,30,16,9,"Klarer Himmel",102,"wolbecker"
"7/30/2016 4:00",36,23,16,11,"wolkig",59,"wolbecker"
"7/30/2016 5:00",54,29,15,7,"teilweise bewölkt",83,"wolbecker"
"7/30/2016 6:00",41,35,16,11,"Klarer Himmel",76,"wolbecker"
"7/30/2016 7:00",64,50,16,13,"Klarer Himmel",114,"wolbecker"
"7/30/2016 8:00",127,82,17,17,"teilweise bewölkt",209,"wolbecker"
"7/30/2016 9:00",296,153,18,22,"teilweise bewölkt",449,"wolbecker"
"7/30/2016 10:00",408,199,19,19,"teilweise bewölkt",607,"wolbecker"
"7/30/2016 11:00",437,297,18,24,"wolkig",734,"wolbecker"
"7/30/2016 12:00",323,266,18,19,"wolkig",589,"wolbecker"
"7/30/2016 13:00",351,328,21,20,"wolkig",679,"wolbecker"
"7/30/2016 14:00",290,367,20,17,"wolkig",657,"wolbecker"
"7/30/2016 15:00",289,311,21,15,"wolkig",600,"wolbecker"
"7/30/2016 16:00",242,319,20,9,"Regen",561,"wolbecker"
"7/30/2016 17:00",198,312,18,11,"Regen",510,"wolbecker"
"7/30/2016 18:00",190,295,18,9,"Regen",485,"wolbecker"
"7/30/2016 19:00",179,233,17,4,"wolkig",412,"wolbecker"
"7/30/2016 20:00",153,199,17,0,"wolkig",352,"wolbecker"
"7/30/2016 21:00",121,116,17,4,"wolkig",237,"wolbecker"
"7/30/2016 22:00",101,88,17,6,"wolkig",189,"wolbecker"
"7/30/2016 23:00",109,93,17,7,"wolkig",202,"wolbecker"
"7/31/2016 0:00",112,80,16,0,"wolkig",192,"wolbecker"
"7/31/2016 1:00",73,90,16,4,"Nebel",163,"wolbecker"
"7/31/2016 2:00",77,60,15,2,"Nebel",137,"wolbecker"
"7/31/2016 3:00",55,25,15,0,"Nebel",80,"wolbecker"
"7/31/2016 4:00",59,20,15,2,"wolkig",79,"wolbecker"
"7/31/2016 5:00",54,18,15,6,"Nebel",72,"wolbecker"
"7/31/2016 6:00",19,9,16,4,"Nebel",28,"wolbecker"
"7/31/2016 7:00",26,21,16,9,"Nebel",47,"wolbecker"
"7/31/2016 8:00",33,31,17,11,"wolkig",64,"wolbecker"
"7/31/2016 9:00",83,51,17,11,"wolkig",134,"wolbecker"
"7/31/2016 10:00",115,94,18,17,"wolkig",209,"wolbecker"
"7/31/2016 11:00",144,100,19,15,"wolkig",244,"wolbecker"
"7/31/2016 12:00",147,127,19,11,"Regen",274,"wolbecker"
"7/31/2016 13:00",138,155,19,17,"wolkig",293,"wolbecker"
"7/31/2016 14:00",189,114,20,11,"wolkig",303,"wolbecker"
"7/31/2016 15:00",154,165,20,9,"Regen",319,"wolbecker"
"7/31/2016 16:00",237,196,20,13,"wolkig",433,"wolbecker"
"7/31/2016 17:00",193,193,18,19,"wolkig",386,"wolbecker"
"7/31/2016 18:00",168,203,19,15,"wolkig",371,"wolbecker"
"7/31/2016 19:00",221,176,19,19,"teilweise bewölkt",397,"wolbecker"
"7/31/2016 20:00",151,126,17,7,"teilweise bewölkt",277,"wolbecker"
"7/31/2016 21:00",116,103,16,13,"teilweise bewölkt",219,"wolbecker"
"7/31/2016 22:00",82,39,15,9,"Klarer Himmel",121,"wolbecker"
"7/31/2016 23:00",57,34,14,7,"Klarer Himmel",91,"wolbecker"
"8/1/2016 0:00",25,18,13,7,"Klarer Himmel",43,"wolbecker"
"8/1/2016 1:00",14,9,12,7,"Klarer Himmel",23,"wolbecker"
"8/1/2016 2:00",8,7,12,6,"Klarer Himmel",15,"wolbecker"
"8/1/2016 3:00",1,2,13,9,"Klarer Himmel",3,"wolbecker"
"8/1/2016 4:00",7,6,11,7,"Klarer Himmel",13,"wolbecker"
"8/1/2016 5:00",41,30,12,6,"Nebel",71,"wolbecker"
"8/1/2016 6:00",126,132,12,6,"Klarer Himmel",258,"wolbecker"
"8/1/2016 7:00",329,195,13,7,"Klarer Himmel",524,"wolbecker"
"8/1/2016 8:00",427,190,14,7,"Klarer Himmel",617,"wolbecker"
"8/1/2016 9:00",348,147,17,9,"Regen",495,"wolbecker"
"8/1/2016 10:00",249,163,14,9,"Regen",412,"wolbecker"
"8/1/2016 11:00",265,234,15,4,"Regen",499,"wolbecker"
"8/1/2016 12:00",254,203,17,9,"wolkig",457,"wolbecker"
"8/1/2016 13:00",274,279,19,15,"teilweise bewölkt",553,"wolbecker"
"8/1/2016 14:00",298,297,19,11,"teilweise bewölkt",595,"wolbecker"
"8/1/2016 15:00",221,285,15,17,"Regen",506,"wolbecker"
"8/1/2016 16:00",282,345,17,9,"teilweise bewölkt",627,"wolbecker"
"8/1/2016 17:00",432,458,19,11,"teilweise bewölkt",890,"wolbecker"
"8/1/2016 18:00",365,453,19,9,"teilweise bewölkt",818,"wolbecker"
"8/1/2016 19:00",251,372,19,9,"teilweise bewölkt",623,"wolbecker"
"8/1/2016 20:00",192,198,17,4,"Nebel",390,"wolbecker"
"8/1/2016 21:00",127,128,15,2,"Nebel",255,"wolbecker"
"8/1/2016 22:00",101,90,13,2,"Nebel",191,"wolbecker"
"8/1/2016 23:00",65,50,14,4,"Nebel",115,"wolbecker"
"8/2/2016 0:00",43,41,14,2,"Nebel",84,"wolbecker"
"8/2/2016 1:00",14,18,14,0,"Regen",32,"wolbecker"
"8/2/2016 2:00",9,7,14,7,"Regen",16,"wolbecker"
"8/2/2016 3:00",6,1,15,7,"Regen",7,"wolbecker"
"8/2/2016 4:00",3,6,15,9,"Regen",9,"wolbecker"
"8/2/2016 5:00",30,29,14,6,"Regen",59,"wolbecker"
"8/2/2016 6:00",103,93,14,7,"Regen",196,"wolbecker"
"8/2/2016 7:00",231,153,14,4,"Regen",384,"wolbecker"
"8/2/2016 8:00",338,143,14,6,"Regen",481,"wolbecker"
"8/2/2016 9:00",268,151,15,7,"wolkig",419,"wolbecker"
"8/2/2016 10:00",248,136,15,6,"Regen",384,"wolbecker"
"8/2/2016 11:00",241,167,16,9,"wolkig",408,"wolbecker"
"8/2/2016 12:00",249,221,17,11,"wolkig",470,"wolbecker"
"8/2/2016 13:00",253,229,18,9,"wolkig",482,"wolbecker"
"8/2/2016 14:00",257,244,17,9,"wolkig",501,"wolbecker"
"8/2/2016 15:00",275,314,18,11,"Regen",589,"wolbecker"
"8/2/2016 16:00",322,405,17,15,"wolkig",727,"wolbecker"
"8/2/2016 17:00",350,427,18,9,"wolkig",777,"wolbecker"
"8/2/2016 18:00",292,395,18,13,"wolkig",687,"wolbecker"
"8/2/2016 19:00",219,274,17,9,"Regen",493,"wolbecker"
"8/2/2016 20:00",142,156,17,7,"Regen",298,"wolbecker"
"8/2/2016 21:00",107,93,17,9,"Regen",200,"wolbecker"
"8/2/2016 22:00",93,88,17,11,"Regen",181,"wolbecker"
"8/2/2016 23:00",47,58,18,11,"wolkig",105,"wolbecker"
"8/3/2016 0:00",29,21,18,13,"Regen",50,"wolbecker"
"8/3/2016 1:00",13,16,18,13,"wolkig",29,"wolbecker"
"8/3/2016 2:00",11,7,18,11,"Regen",18,"wolbecker"
"8/3/2016 3:00",3,6,18,13,"Regen",9,"wolbecker"
"8/3/2016 4:00",6,7,18,13,"wolkig",13,"wolbecker"
"8/3/2016 5:00",37,23,18,15,"wolkig",60,"wolbecker"
"8/3/2016 6:00",105,97,18,15,"Regen",202,"wolbecker"
"8/3/2016 7:00",227,142,18,15,"Regen",369,"wolbecker"
"8/3/2016 8:00",372,164,18,19,"Regen",536,"wolbecker"
"8/3/2016 9:00",299,131,19,19,"Regen",430,"wolbecker"
"8/3/2016 10:00",250,140,19,19,"Regen",390,"wolbecker"
"8/3/2016 11:00",285,165,19,17,"Regen",450,"wolbecker"
"8/3/2016 12:00",275,221,19,22,"Regen",496,"wolbecker"
"8/3/2016 13:00",213,237,19,20,"Regen",450,"wolbecker"
"8/3/2016 14:00",206,248,19,22,"Regen",454,"wolbecker"
"8/3/2016 15:00",210,261,19,19,"Regen",471,"wolbecker"
"8/3/2016 16:00",248,343,19,20,"wolkig",591,"wolbecker"
"8/3/2016 17:00",293,313,19,19,"wolkig",606,"wolbecker"
"8/3/2016 18:00",225,344,19,13,"Regen",569,"wolbecker"
"8/3/2016 19:00",206,249,19,15,"Regen",455,"wolbecker"
"8/3/2016 20:00",157,164,19,15,"Regen",321,"wolbecker"
"8/3/2016 21:00",104,102,19,15,"Regen",206,"wolbecker"
"8/3/2016 22:00",101,81,19,17,"Regen",182,"wolbecker"
"8/3/2016 23:00",63,53,15,19,"Regen",116,"wolbecker"
"8/4/2016 0:00",40,51,16,6,"Klarer Himmel",91,"wolbecker"
"8/4/2016 1:00",18,46,17,15,"teilweise bewölkt",64,"wolbecker"
"8/4/2016 2:00",22,21,17,17,"teilweise bewölkt",43,"wolbecker"
"8/4/2016 3:00",13,15,17,19,"teilweise bewölkt",28,"wolbecker"
"8/4/2016 4:00",19,18,16,11,"teilweise bewölkt",37,"wolbecker"
"8/4/2016 5:00",44,34,16,17,"wolkig",78,"wolbecker"
"8/4/2016 6:00",120,128,16,19,"wolkig",248,"wolbecker"
"8/4/2016 7:00",326,183,16,19,"wolkig",509,"wolbecker"
"8/4/2016 8:00",387,211,16,20,"wolkig",598,"wolbecker"
"8/4/2016 9:00",343,164,17,19,"wolkig",507,"wolbecker"
"8/4/2016 10:00",268,178,18,20,"wolkig",446,"wolbecker"
"8/4/2016 11:00",311,180,19,24,"wolkig",491,"wolbecker"
"8/4/2016 12:00",303,264,19,22,"wolkig",567,"wolbecker"
"8/4/2016 13:00",306,309,20,19,"wolkig",615,"wolbecker"
"8/4/2016 14:00",308,314,19,19,"wolkig",622,"wolbecker"
"8/4/2016 15:00",355,374,19,22,"wolkig",729,"wolbecker"
"8/4/2016 16:00",384,415,19,19,"wolkig",799,"wolbecker"
"8/4/2016 17:00",388,485,20,19,"wolkig",873,"wolbecker"
"8/4/2016 18:00",366,458,20,17,"wolkig",824,"wolbecker"
"8/4/2016 19:00",281,400,19,13,"wolkig",681,"wolbecker"
"8/4/2016 20:00",187,218,18,7,"wolkig",405,"wolbecker"
"8/4/2016 21:00",142,148,18,15,"Regen",290,"wolbecker"
"8/4/2016 22:00",138,93,17,11,"wolkig",231,"wolbecker"
"8/4/2016 23:00",82,64,16,7,"Klarer Himmel",146,"wolbecker"
"8/5/2016 0:00",62,44,15,6,"Klarer Himmel",106,"wolbecker"
"8/5/2016 1:00",27,29,14,4,"Klarer Himmel",56,"wolbecker"
"8/5/2016 2:00",8,12,14,6,"Klarer Himmel",20,"wolbecker"
"8/5/2016 3:00",7,15,14,6,"Klarer Himmel",22,"wolbecker"
"8/5/2016 4:00",6,7,14,7,"Klarer Himmel",13,"wolbecker"
"8/5/2016 5:00",41,37,13,7,"Nebel",78,"wolbecker"
"8/5/2016 6:00",114,116,14,9,"wolkig",230,"wolbecker"
"8/5/2016 7:00",325,153,15,11,"wolkig",478,"wolbecker"
"8/5/2016 8:00",387,174,15,13,"wolkig",561,"wolbecker"
"8/5/2016 9:00",312,157,16,11,"wolkig",469,"wolbecker"
"8/5/2016 10:00",291,172,17,13,"wolkig",463,"wolbecker"
"8/5/2016 11:00",312,244,19,15,"wolkig",556,"wolbecker"
"8/5/2016 12:00",350,278,20,22,"teilweise bewölkt",628,"wolbecker"
"8/5/2016 13:00",310,342,22,20,"teilweise bewölkt",652,"wolbecker"
"8/5/2016 14:00",349,380,20,32,"Regen",729,"wolbecker"
"8/5/2016 15:00",305,388,19,13,"Regen",693,"wolbecker"
"8/5/2016 16:00",306,412,21,13,"teilweise bewölkt",718,"wolbecker"
"8/5/2016 17:00",329,397,22,22,"teilweise bewölkt",726,"wolbecker"
"8/5/2016 18:00",258,419,21,13,"teilweise bewölkt",677,"wolbecker"
"8/5/2016 19:00",257,303,20,15,"wolkig",560,"wolbecker"
"8/5/2016 20:00",187,201,19,11,"wolkig",388,"wolbecker"
"8/5/2016 21:00",139,157,17,11,"Klarer Himmel",296,"wolbecker"
"8/5/2016 22:00",102,105,16,11,"Klarer Himmel",207,"wolbecker"
"8/5/2016 23:00",132,116,15,7,"Klarer Himmel",248,"wolbecker"
"8/6/2016 0:00",96,112,15,6,"Klarer Himmel",208,"wolbecker"
"8/6/2016 1:00",59,79,14,4,"Klarer Himmel",138,"wolbecker"
"8/6/2016 2:00",60,48,13,7,"teilweise bewölkt",108,"wolbecker"
"8/6/2016 3:00",66,32,14,6,"teilweise bewölkt",98,"wolbecker"
"8/6/2016 4:00",39,24,13,7,"teilweise bewölkt",63,"wolbecker"
"8/6/2016 5:00",49,14,14,7,"Klarer Himmel",63,"wolbecker"
"8/6/2016 6:00",40,30,14,6,"Klarer Himmel",70,"wolbecker"
"8/6/2016 7:00",81,36,15,7,"wolkig",117,"wolbecker"
"8/6/2016 8:00",119,97,16,9,"Klarer Himmel",216,"wolbecker"
"8/6/2016 9:00",254,120,18,15,"wolkig",374,"wolbecker"
"8/6/2016 10:00",419,193,18,19,"wolkig",612,"wolbecker"
"8/6/2016 11:00",418,242,18,17,"Regen",660,"wolbecker"
"8/6/2016 12:00",401,280,18,13,"wolkig",681,"wolbecker"
"8/6/2016 13:00",316,339,18,15,"Regen",655,"wolbecker"
"8/6/2016 14:00",128,261,19,11,"teilweise bewölkt",389,"wolbecker"
"8/6/2016 15:00",229,304,20,20,"teilweise bewölkt",533,"wolbecker"
"8/6/2016 16:00",203,247,20,20,"teilweise bewölkt",450,"wolbecker"
"8/6/2016 17:00",206,288,20,15,"wolkig",494,"wolbecker"
"8/6/2016 18:00",194,294,21,15,"teilweise bewölkt",488,"wolbecker"
"8/6/2016 19:00",209,226,21,11,"teilweise bewölkt",435,"wolbecker"
"8/6/2016 20:00",159,165,19,11,"teilweise bewölkt",324,"wolbecker"
"8/6/2016 21:00",135,131,17,11,"teilweise bewölkt",266,"wolbecker"
"8/6/2016 22:00",103,94,14,6,"Klarer Himmel",197,"wolbecker"
"8/6/2016 23:00",121,86,14,4,"Klarer Himmel",207,"wolbecker"
"8/7/2016 0:00",86,114,12,2,"Klarer Himmel",200,"wolbecker"
"8/7/2016 1:00",95,82,12,4,"Nebel",177,"wolbecker"
"8/7/2016 2:00",65,47,11,4,"Nebel",112,"wolbecker"
"8/7/2016 3:00",61,43,11,2,"Nebel",104,"wolbecker"
"8/7/2016 4:00",50,24,11,4,"Nebel",74,"wolbecker"
"8/7/2016 5:00",41,14,10,2,"Nebel",55,"wolbecker"
"8/7/2016 6:00",17,17,11,7,"Klarer Himmel",34,"wolbecker"
"8/7/2016 7:00",18,27,13,7,"Klarer Himmel",45,"wolbecker"
"8/7/2016 8:00",42,44,16,13,"Klarer Himmel",86,"wolbecker"
"8/7/2016 9:00",92,65,17,13,"Klarer Himmel",157,"wolbecker"
"8/7/2016 10:00",144,117,19,15,"Klarer Himmel",261,"wolbecker"
"8/7/2016 11:00",187,148,22,20,"Klarer Himmel",335,"wolbecker"
"8/7/2016 12:00",213,192,23,20,"Klarer Himmel",405,"wolbecker"
"8/7/2016 13:00",208,189,24,22,"Klarer Himmel",397,"wolbecker"
"8/7/2016 14:00",265,247,25,24,"wolkig",512,"wolbecker"
"8/7/2016 15:00",298,259,24,22,"wolkig",557,"wolbecker"
"8/7/2016 16:00",258,257,23,20,"wolkig",515,"wolbecker"
"8/7/2016 17:00",263,242,23,22,NA,505,"wolbecker"
"8/7/2016 18:00",231,214,23,20,"wolkig",445,"wolbecker"
"8/7/2016 19:00",200,184,22,13,"wolkig",384,"wolbecker"
"8/7/2016 20:00",175,123,22,11,"wolkig",298,"wolbecker"
"8/7/2016 21:00",141,82,21,7,"wolkig",223,"wolbecker"
"8/7/2016 22:00",124,48,21,13,"wolkig",172,"wolbecker"
"8/7/2016 23:00",57,45,22,17,"wolkig",102,"wolbecker"
"8/8/2016 0:00",35,22,22,19,"wolkig",57,"wolbecker"
"8/8/2016 1:00",14,18,21,19,"wolkig",32,"wolbecker"
"8/8/2016 2:00",6,13,20,13,"wolkig",19,"wolbecker"
"8/8/2016 3:00",5,3,20,26,"wolkig",8,"wolbecker"
"8/8/2016 4:00",8,12,19,24,"wolkig",20,"wolbecker"
"8/8/2016 5:00",39,33,18,17,"teilweise bewölkt",72,"wolbecker"
"8/8/2016 6:00",154,125,18,19,"teilweise bewölkt",279,"wolbecker"
"8/8/2016 7:00",317,211,18,24,"teilweise bewölkt",528,"wolbecker"
"8/8/2016 8:00",435,205,18,22,"wolkig",640,"wolbecker"
"8/8/2016 9:00",327,142,18,19,"wolkig",469,"wolbecker"
"8/8/2016 10:00",288,158,17,24,"wolkig",446,"wolbecker"
"8/8/2016 11:00",315,239,18,19,"wolkig",554,"wolbecker"
"8/8/2016 12:00",265,256,18,24,"wolkig",521,"wolbecker"
"8/8/2016 13:00",198,253,17,20,"wolkig",451,"wolbecker"
"8/8/2016 14:00",226,232,20,20,"teilweise bewölkt",458,"wolbecker"
"8/8/2016 15:00",320,317,21,24,"teilweise bewölkt",637,"wolbecker"
"8/8/2016 16:00",381,432,21,28,"teilweise bewölkt",813,"wolbecker"
"8/8/2016 17:00",444,495,21,28,"teilweise bewölkt",939,"wolbecker"
"8/8/2016 18:00",349,455,19,26,"Klarer Himmel",804,"wolbecker"
"8/8/2016 19:00",246,405,18,15,"Klarer Himmel",651,"wolbecker"
"8/8/2016 20:00",182,245,16,9,"Klarer Himmel",427,"wolbecker"
"8/8/2016 21:00",148,130,14,6,"Klarer Himmel",278,"wolbecker"
"8/8/2016 22:00",116,93,15,11,"Klarer Himmel",209,"wolbecker"
"8/8/2016 23:00",71,54,14,7,"Klarer Himmel",125,"wolbecker"
"8/9/2016 0:00",29,42,14,7,"Klarer Himmel",71,"wolbecker"
"8/9/2016 1:00",12,10,14,6,"Klarer Himmel",22,"wolbecker"
"8/9/2016 2:00",4,17,13,6,"Klarer Himmel",21,"wolbecker"
"8/9/2016 3:00",2,9,13,6,"Klarer Himmel",11,"wolbecker"
"8/9/2016 4:00",4,11,13,6,"Klarer Himmel",15,"wolbecker"
"8/9/2016 5:00",36,41,13,6,"Klarer Himmel",77,"wolbecker"
"8/9/2016 6:00",136,123,12,6,"Klarer Himmel",259,"wolbecker"
"8/9/2016 7:00",336,227,13,6,"Klarer Himmel",563,"wolbecker"
"8/9/2016 8:00",426,203,15,11,"Klarer Himmel",629,"wolbecker"
"8/9/2016 9:00",387,181,15,17,"wolkig",568,"wolbecker"
"8/9/2016 10:00",312,193,15,15,"wolkig",505,"wolbecker"
"8/9/2016 11:00",324,255,16,13,"wolkig",579,"wolbecker"
"8/9/2016 12:00",280,287,17,15,"teilweise bewölkt",567,"wolbecker"
"8/9/2016 13:00",257,326,18,19,"teilweise bewölkt",583,"wolbecker"
"8/9/2016 14:00",304,292,16,24,"wolkig",596,"wolbecker"
"8/9/2016 15:00",316,363,18,17,"wolkig",679,"wolbecker"
"8/9/2016 16:00",350,469,17,17,"wolkig",819,"wolbecker"
"8/9/2016 17:00",467,453,16,17,"wolkig",920,"wolbecker"
"8/9/2016 18:00",353,479,16,11,"wolkig",832,"wolbecker"
"8/9/2016 19:00",279,357,16,15,"teilweise bewölkt",636,"wolbecker"
"8/9/2016 20:00",190,237,13,4,"wolkig",427,"wolbecker"
"8/9/2016 21:00",153,144,14,7,"Klarer Himmel",297,"wolbecker"
"8/9/2016 22:00",128,116,13,7,"Klarer Himmel",244,"wolbecker"
"8/9/2016 23:00",62,78,13,9,"Regen",140,"wolbecker"
"8/10/2016 0:00",40,28,13,6,"wolkig",68,"wolbecker"
"8/10/2016 1:00",21,14,12,9,"wolkig",35,"wolbecker"
"8/10/2016 2:00",5,8,12,7,"Regen",13,"wolbecker"
"8/10/2016 3:00",6,6,11,7,"Regen",12,"wolbecker"
"8/10/2016 4:00",4,14,11,6,"Regen",18,"wolbecker"
"8/10/2016 5:00",36,23,10,7,"Regen",59,"wolbecker"
"8/10/2016 6:00",122,118,10,7,"Klarer Himmel",240,"wolbecker"
"8/10/2016 7:00",275,218,11,7,"wolkig",493,"wolbecker"
"8/10/2016 8:00",442,209,12,15,"teilweise bewölkt",651,"wolbecker"
"8/10/2016 9:00",407,144,13,13,"teilweise bewölkt",551,"wolbecker"
"8/10/2016 10:00",394,210,14,17,"teilweise bewölkt",604,"wolbecker"
"8/10/2016 11:00",357,222,16,15,"teilweise bewölkt",579,"wolbecker"
"8/10/2016 12:00",327,343,17,22,"Regen",670,"wolbecker"
"8/10/2016 13:00",270,307,14,13,"Regen",577,"wolbecker"
"8/10/2016 14:00",249,328,15,20,"Regen",577,"wolbecker"
"8/10/2016 15:00",262,332,13,19,"Regen",594,"wolbecker"
"8/10/2016 16:00",268,420,13,7,"Regen",688,"wolbecker"
"8/10/2016 17:00",406,402,14,9,"Regen",808,"wolbecker"
"8/10/2016 18:00",276,411,15,9,"teilweise bewölkt",687,"wolbecker"
"8/10/2016 19:00",249,338,14,4,"teilweise bewölkt",587,"wolbecker"
"8/10/2016 20:00",164,209,12,2,"Klarer Himmel",373,"wolbecker"
"8/10/2016 21:00",137,131,10,2,"Nebel",268,"wolbecker"
"8/10/2016 22:00",101,103,9,4,"Nebel",204,"wolbecker"
"8/10/2016 23:00",75,80,8,2,"Klarer Himmel",155,"wolbecker"
"8/11/2016 0:00",47,41,8,2,"Klarer Himmel",88,"wolbecker"
"8/11/2016 1:00",27,47,7,0,"Nebel",74,"wolbecker"
"8/11/2016 2:00",9,33,7,2,"Nebel",42,"wolbecker"
"8/11/2016 3:00",21,19,6,0,"Nebel",40,"wolbecker"
"8/11/2016 4:00",17,17,6,4,"Nebel",34,"wolbecker"
"8/11/2016 5:00",53,37,6,4,"Nebel",90,"wolbecker"
"8/11/2016 6:00",108,133,7,4,"Nebel",241,"wolbecker"
"8/11/2016 7:00",302,194,9,6,"Klarer Himmel",496,"wolbecker"
"8/11/2016 8:00",413,171,10,11,"Klarer Himmel",584,"wolbecker"
"8/11/2016 9:00",344,126,11,13,"Klarer Himmel",470,"wolbecker"
"8/11/2016 10:00",281,166,13,15,"Regen",447,"wolbecker"
"8/11/2016 11:00",279,186,14,20,"Regen",465,"wolbecker"
"8/11/2016 12:00",259,245,14,19,"wolkig",504,"wolbecker"
"8/11/2016 13:00",245,258,15,19,"Regen",503,"wolbecker"
"8/11/2016 14:00",293,282,14,19,"Regen",575,"wolbecker"
"8/11/2016 15:00",245,350,13,28,"Regen",595,"wolbecker"
"8/11/2016 16:00",263,365,13,22,"Regen",628,"wolbecker"
"8/11/2016 17:00",344,376,13,20,"Regen",720,"wolbecker"
"8/11/2016 18:00",270,368,13,19,"Regen",638,"wolbecker"
"8/11/2016 19:00",198,258,13,17,"Regen",456,"wolbecker"
"8/11/2016 20:00",117,159,13,15,"Regen",276,"wolbecker"
"8/11/2016 21:00",76,98,13,17,"Regen",174,"wolbecker"
"8/11/2016 22:00",78,56,13,15,"Regen",134,"wolbecker"
"8/11/2016 23:00",40,48,14,15,"Regen",88,"wolbecker"
"8/12/2016 0:00",20,33,14,15,"Regen",53,"wolbecker"
"8/12/2016 1:00",27,29,14,15,"Regen",56,"wolbecker"
"8/12/2016 2:00",15,10,14,11,"Regen",25,"wolbecker"
"8/12/2016 3:00",16,7,15,15,"Regen",23,"wolbecker"
"8/12/2016 4:00",21,14,15,13,"Regen",35,"wolbecker"
"8/12/2016 5:00",54,35,16,13,"Regen",89,"wolbecker"
"8/12/2016 6:00",101,107,16,13,"Regen",208,"wolbecker"
"8/12/2016 7:00",249,154,17,13,"Regen",403,"wolbecker"
"8/12/2016 8:00",301,144,17,15,"Regen",445,"wolbecker"
"8/12/2016 9:00",247,113,17,15,"Regen",360,"wolbecker"
"8/12/2016 10:00",219,155,17,15,"Regen",374,"wolbecker"
"8/12/2016 11:00",215,156,18,19,"Regen",371,"wolbecker"
"8/12/2016 12:00",238,222,19,24,"wolkig",460,"wolbecker"
"8/12/2016 13:00",245,275,20,24,"wolkig",520,"wolbecker"
"8/12/2016 14:00",317,314,21,28,"wolkig",631,"wolbecker"
"8/12/2016 15:00",300,316,21,26,"wolkig",616,"wolbecker"
"8/12/2016 16:00",333,363,20,26,"wolkig",696,"wolbecker"
"8/12/2016 17:00",305,361,21,13,"wolkig",666,"wolbecker"
"8/12/2016 18:00",271,310,21,13,"wolkig",581,"wolbecker"
"8/12/2016 19:00",263,316,21,15,"wolkig",579,"wolbecker"
"8/12/2016 20:00",187,186,20,7,"wolkig",373,"wolbecker"
"8/12/2016 21:00",155,152,19,6,"teilweise bewölkt",307,"wolbecker"
"8/12/2016 22:00",107,142,17,7,"teilweise bewölkt",249,"wolbecker"
"8/12/2016 23:00",84,97,17,7,"teilweise bewölkt",181,"wolbecker"
"8/13/2016 0:00",93,77,17,9,"teilweise bewölkt",170,"wolbecker"
"8/13/2016 1:00",64,84,17,11,"wolkig",148,"wolbecker"
"8/13/2016 2:00",46,65,16,11,"teilweise bewölkt",111,"wolbecker"
"8/13/2016 3:00",36,33,16,11,"teilweise bewölkt",69,"wolbecker"
"8/13/2016 4:00",47,19,16,11,"teilweise bewölkt",66,"wolbecker"
"8/13/2016 5:00",34,23,16,11,"Klarer Himmel",57,"wolbecker"
"8/13/2016 6:00",45,34,16,11,"Klarer Himmel",79,"wolbecker"
"8/13/2016 7:00",56,48,16,15,"wolkig",104,"wolbecker"
"8/13/2016 8:00",108,82,17,17,"wolkig",190,"wolbecker"
"8/13/2016 9:00",260,141,17,15,"wolkig",401,"wolbecker"
"8/13/2016 10:00",399,206,18,20,"wolkig",605,"wolbecker"
"8/13/2016 11:00",491,259,18,26,"wolkig",750,"wolbecker"
"8/13/2016 12:00",382,336,19,22,"wolkig",718,"wolbecker"
"8/13/2016 13:00",357,337,20,24,"wolkig",694,"wolbecker"
"8/13/2016 14:00",279,351,21,24,"wolkig",630,"wolbecker"
"8/13/2016 15:00",284,313,20,24,"wolkig",597,"wolbecker"
"8/13/2016 16:00",266,340,22,20,"wolkig",606,"wolbecker"
"8/13/2016 17:00",230,287,21,13,"wolkig",517,"wolbecker"
"8/13/2016 18:00",212,327,21,19,"wolkig",539,"wolbecker"
"8/13/2016 19:00",229,253,20,13,"wolkig",482,"wolbecker"
"8/13/2016 20:00",187,169,20,17,"wolkig",356,"wolbecker"
"8/13/2016 21:00",128,110,19,11,"Regen",238,"wolbecker"
"8/13/2016 22:00",106,104,17,6,"wolkig",210,"wolbecker"
"8/13/2016 23:00",84,103,16,0,"wolkig",187,"wolbecker"
"8/14/2016 0:00",52,118,16,2,"teilweise bewölkt",170,"wolbecker"
"8/14/2016 1:00",71,92,15,0,"wolkig",163,"wolbecker"
"8/14/2016 2:00",60,58,15,0,"Nebel",118,"wolbecker"
"8/14/2016 3:00",53,38,15,2,"Nebel",91,"wolbecker"
"8/14/2016 4:00",36,20,15,4,"Nebel",56,"wolbecker"
"8/14/2016 5:00",37,10,15,2,"Nebel",47,"wolbecker"
"8/14/2016 6:00",23,16,15,4,"Nebel",39,"wolbecker"
"8/14/2016 7:00",17,26,15,0,"Nebel",43,"wolbecker"
"8/14/2016 8:00",35,37,17,4,"wolkig",72,"wolbecker"
"8/14/2016 9:00",109,30,18,4,"wolkig",139,"wolbecker"
"8/14/2016 10:00",128,87,19,7,"wolkig",215,"wolbecker"
"8/14/2016 11:00",183,130,19,9,"teilweise bewölkt",313,"wolbecker"
"8/14/2016 12:00",200,148,20,11,"teilweise bewölkt",348,"wolbecker"
"8/14/2016 13:00",175,156,21,15,"wolkig",331,"wolbecker"
"8/14/2016 14:00",245,195,22,6,"teilweise bewölkt",440,"wolbecker"
"8/14/2016 15:00",252,181,22,11,"teilweise bewölkt",433,"wolbecker"
"8/14/2016 16:00",275,213,22,7,"teilweise bewölkt",488,"wolbecker"
"8/14/2016 17:00",213,196,21,11,"wolkig",409,"wolbecker"
"8/14/2016 18:00",249,229,21,17,"teilweise bewölkt",478,"wolbecker"
"8/14/2016 19:00",210,193,19,11,"teilweise bewölkt",403,"wolbecker"
"8/14/2016 20:00",191,147,17,9,"Klarer Himmel",338,"wolbecker"
"8/14/2016 21:00",123,76,16,7,"Klarer Himmel",199,"wolbecker"
"8/14/2016 22:00",101,62,14,6,"Klarer Himmel",163,"wolbecker"
"8/14/2016 23:00",46,39,13,4,"Klarer Himmel",85,"wolbecker"
"8/15/2016 0:00",32,20,13,0,"Nebel",52,"wolbecker"
"8/15/2016 1:00",17,10,11,2,"teilweise bewölkt",27,"wolbecker"
"8/15/2016 2:00",3,7,12,2,"wolkig",10,"wolbecker"
"8/15/2016 3:00",3,4,13,2,"Klarer Himmel",7,"wolbecker"
"8/15/2016 4:00",6,11,13,4,"Klarer Himmel",17,"wolbecker"
"8/15/2016 5:00",35,32,13,4,"Klarer Himmel",67,"wolbecker"
"8/15/2016 6:00",150,116,13,0,"Klarer Himmel",266,"wolbecker"
"8/15/2016 7:00",360,207,14,2,"Klarer Himmel",567,"wolbecker"
"8/15/2016 8:00",447,228,16,7,"teilweise bewölkt",675,"wolbecker"
"8/15/2016 9:00",389,158,18,9,"teilweise bewölkt",547,"wolbecker"
"8/15/2016 10:00",326,215,18,9,"wolkig",541,"wolbecker"
"8/15/2016 11:00",344,251,19,7,"wolkig",595,"wolbecker"
"8/15/2016 12:00",307,248,20,15,"wolkig",555,"wolbecker"
"8/15/2016 13:00",291,284,19,13,"wolkig",575,"wolbecker"
"8/15/2016 14:00",324,341,20,17,"wolkig",665,"wolbecker"
"8/15/2016 15:00",371,383,20,13,"teilweise bewölkt",754,"wolbecker"
"8/15/2016 16:00",387,523,20,13,"wolkig",910,"wolbecker"
"8/15/2016 17:00",487,554,19,13,"wolkig",1041,"wolbecker"
"8/15/2016 18:00",394,483,20,15,"teilweise bewölkt",877,"wolbecker"
"8/15/2016 19:00",282,432,19,13,"Klarer Himmel",714,"wolbecker"
"8/15/2016 20:00",220,206,16,4,"Klarer Himmel",426,"wolbecker"
"8/15/2016 21:00",144,133,14,2,"Klarer Himmel",277,"wolbecker"
"8/15/2016 22:00",125,113,13,4,"Klarer Himmel",238,"wolbecker"
"8/15/2016 23:00",57,42,12,4,"Klarer Himmel",99,"wolbecker"
"8/16/2016 0:00",39,32,13,4,"Klarer Himmel",71,"wolbecker"
"8/16/2016 1:00",15,15,12,4,"Klarer Himmel",30,"wolbecker"
"8/16/2016 2:00",12,12,11,2,"Klarer Himmel",24,"wolbecker"
"8/16/2016 3:00",10,8,10,2,"Nebel",18,"wolbecker"
"8/16/2016 4:00",5,12,10,0,"Nebel",17,"wolbecker"
"8/16/2016 5:00",38,46,9,0,"Nebel",84,"wolbecker"
"8/16/2016 6:00",167,150,9,4,"Nebel",317,"wolbecker"
"8/16/2016 7:00",372,231,13,6,"Klarer Himmel",603,"wolbecker"
"8/16/2016 8:00",510,251,15,9,"wolkig",761,"wolbecker"
"8/16/2016 9:00",387,156,17,13,"wolkig",543,"wolbecker"
"8/16/2016 10:00",354,223,18,13,"wolkig",577,"wolbecker"
"8/16/2016 11:00",316,233,19,13,"wolkig",549,"wolbecker"
"8/16/2016 12:00",327,313,19,11,"teilweise bewölkt",640,"wolbecker"
"8/16/2016 13:00",353,307,19,11,"teilweise bewölkt",660,"wolbecker"
"8/16/2016 14:00",344,319,21,13,"teilweise bewölkt",663,"wolbecker"
"8/16/2016 15:00",414,437,20,19,"teilweise bewölkt",851,"wolbecker"
"8/16/2016 16:00",415,536,21,15,"teilweise bewölkt",951,"wolbecker"
"8/16/2016 17:00",504,550,21,13,"teilweise bewölkt",1054,"wolbecker"
"8/16/2016 18:00",420,513,20,15,"teilweise bewölkt",933,"wolbecker"
"8/16/2016 19:00",316,443,19,11,"Klarer Himmel",759,"wolbecker"
"8/16/2016 20:00",230,242,16,6,"Klarer Himmel",472,"wolbecker"
"8/16/2016 21:00",173,175,15,6,"Klarer Himmel",348,"wolbecker"
"8/16/2016 22:00",166,108,13,4,"Klarer Himmel",274,"wolbecker"
"8/16/2016 23:00",84,68,13,6,"Klarer Himmel",152,"wolbecker"
"8/17/2016 0:00",43,45,13,2,"Klarer Himmel",88,"wolbecker"
"8/17/2016 1:00",15,11,13,4,"Klarer Himmel",26,"wolbecker"
"8/17/2016 2:00",8,7,14,6,"Klarer Himmel",15,"wolbecker"
"8/17/2016 3:00",6,6,13,4,"Klarer Himmel",12,"wolbecker"
"8/17/2016 4:00",9,12,11,4,"Klarer Himmel",21,"wolbecker"
"8/17/2016 5:00",38,37,9,2,"Nebel",75,"wolbecker"
"8/17/2016 6:00",158,139,8,6,"Nebel",297,"wolbecker"
"8/17/2016 7:00",383,266,12,2,"Nebel",649,"wolbecker"
"8/17/2016 8:00",539,228,15,7,"Klarer Himmel",767,"wolbecker"
"8/17/2016 9:00",457,209,17,7,"Klarer Himmel",666,"wolbecker"
"8/17/2016 10:00",452,210,19,9,"Klarer Himmel",662,"wolbecker"
"8/17/2016 11:00",453,303,20,9,"Klarer Himmel",756,"wolbecker"
"8/17/2016 12:00",422,401,21,11,"Klarer Himmel",823,"wolbecker"
"8/17/2016 13:00",356,426,21,9,"Klarer Himmel",782,"wolbecker"
"8/17/2016 14:00",344,422,22,11,"Klarer Himmel",766,"wolbecker"
"8/17/2016 15:00",382,433,22,9,"Klarer Himmel",815,"wolbecker"
"8/17/2016 16:00",411,558,22,11,"Klarer Himmel",969,"wolbecker"
"8/17/2016 17:00",517,558,22,11,"Klarer Himmel",1075,"wolbecker"
"8/17/2016 18:00",452,534,21,7,"Klarer Himmel",986,"wolbecker"
"8/17/2016 19:00",323,411,20,6,"Klarer Himmel",734,"wolbecker"
"8/17/2016 20:00",250,279,17,6,"Klarer Himmel",529,"wolbecker"
"8/17/2016 21:00",176,165,16,6,"Klarer Himmel",341,"wolbecker"
"8/17/2016 22:00",176,141,14,4,"Klarer Himmel",317,"wolbecker"
"8/17/2016 23:00",100,71,13,6,"Klarer Himmel",171,"wolbecker"
"8/18/2016 0:00",62,47,12,4,"Klarer Himmel",109,"wolbecker"
"8/18/2016 1:00",19,31,10,4,"Nebel",50,"wolbecker"
"8/18/2016 2:00",14,19,10,6,"Nebel",33,"wolbecker"
"8/18/2016 3:00",14,16,10,7,"Nebel",30,"wolbecker"
"8/18/2016 4:00",10,16,9,4,"Klarer Himmel",26,"wolbecker"
"8/18/2016 5:00",51,43,8,2,"Nebel",94,"wolbecker"
"8/18/2016 6:00",139,148,8,2,"Nebel",287,"wolbecker"
"8/18/2016 7:00",367,241,11,6,"Klarer Himmel",608,"wolbecker"
"8/18/2016 8:00",469,227,16,6,"Klarer Himmel",696,"wolbecker"
"8/18/2016 9:00",387,175,19,7,"Klarer Himmel",562,"wolbecker"
"8/18/2016 10:00",340,243,20,11,"Klarer Himmel",583,"wolbecker"
"8/18/2016 11:00",359,223,22,13,"Klarer Himmel",582,"wolbecker"
"8/18/2016 12:00",331,292,22,13,"Klarer Himmel",623,"wolbecker"
"8/18/2016 13:00",321,357,23,9,"Klarer Himmel",678,"wolbecker"
"8/18/2016 14:00",349,353,23,7,"Klarer Himmel",702,"wolbecker"
"8/18/2016 15:00",384,471,24,6,"Klarer Himmel",855,"wolbecker"
"8/18/2016 16:00",477,521,24,7,"Klarer Himmel",998,"wolbecker"
"8/18/2016 17:00",466,568,24,13,"Klarer Himmel",1034,"wolbecker"
"8/18/2016 18:00",468,496,23,11,"Klarer Himmel",964,"wolbecker"
"8/18/2016 19:00",353,384,22,6,"Klarer Himmel",737,"wolbecker"
"8/18/2016 20:00",224,271,18,6,"Klarer Himmel",495,"wolbecker"
"8/18/2016 21:00",162,179,15,2,"Klarer Himmel",341,"wolbecker"
"8/18/2016 22:00",199,142,15,7,"Klarer Himmel",341,"wolbecker"
"8/18/2016 23:00",101,63,15,4,"Klarer Himmel",164,"wolbecker"
"8/19/2016 0:00",60,39,14,4,"Klarer Himmel",99,"wolbecker"
"8/19/2016 1:00",27,24,14,4,"Klarer Himmel",51,"wolbecker"
"8/19/2016 2:00",12,9,12,4,"Klarer Himmel",21,"wolbecker"
"8/19/2016 3:00",4,7,11,2,"Nebel",11,"wolbecker"
"8/19/2016 4:00",7,12,10,0,"Nebel",19,"wolbecker"
"8/19/2016 5:00",30,37,9,0,"Nebel",67,"wolbecker"
"8/19/2016 6:00",147,112,9,0,"Nebel",259,"wolbecker"
"8/19/2016 7:00",334,213,11,2,"Klarer Himmel",547,"wolbecker"
"8/19/2016 8:00",413,221,16,4,"Klarer Himmel",634,"wolbecker"
"8/19/2016 9:00",382,179,19,6,"Klarer Himmel",561,"wolbecker"
"8/19/2016 10:00",334,180,21,4,"Klarer Himmel",514,"wolbecker"
"8/19/2016 11:00",351,263,22,6,"teilweise bewölkt",614,"wolbecker"
"8/19/2016 12:00",357,353,23,6,"teilweise bewölkt",710,"wolbecker"
"8/19/2016 13:00",363,466,25,7,"Klarer Himmel",829,"wolbecker"
"8/19/2016 14:00",416,443,26,6,"Klarer Himmel",859,"wolbecker"
"8/19/2016 15:00",378,428,25,7,"Klarer Himmel",806,"wolbecker"
"8/19/2016 16:00",403,459,26,7,"Klarer Himmel",862,"wolbecker"
"8/19/2016 17:00",441,441,25,6,"Klarer Himmel",882,"wolbecker"
"8/19/2016 18:00",348,397,23,4,"Klarer Himmel",745,"wolbecker"
"8/19/2016 19:00",273,299,22,4,"Klarer Himmel",572,"wolbecker"
"8/19/2016 20:00",196,212,19,2,"Regen",408,"wolbecker"
"8/19/2016 21:00",141,155,18,4,NA,296,"wolbecker"
"8/19/2016 22:00",129,107,18,4,"Klarer Himmel",236,"wolbecker"
"8/19/2016 23:00",88,119,19,6,"Regen",207,"wolbecker"
"8/20/2016 0:00",77,63,19,20,"Regen",140,"wolbecker"
"8/20/2016 1:00",65,69,18,9,"wolkig",134,"wolbecker"
"8/20/2016 2:00",53,37,17,7,"Klarer Himmel",90,"wolbecker"
"8/20/2016 3:00",36,29,17,9,"wolkig",65,"wolbecker"
"8/20/2016 4:00",20,14,17,11,"wolkig",34,"wolbecker"
"8/20/2016 5:00",38,19,17,13,"wolkig",57,"wolbecker"
"8/20/2016 6:00",44,29,17,11,"wolkig",73,"wolbecker"
"8/20/2016 7:00",106,56,17,9,"wolkig",162,"wolbecker"
"8/20/2016 8:00",165,81,18,15,"wolkig",246,"wolbecker"
"8/20/2016 9:00",314,133,18,15,"wolkig",447,"wolbecker"
"8/20/2016 10:00",438,193,20,13,"wolkig",631,"wolbecker"
"8/20/2016 11:00",452,264,20,11,"wolkig",716,"wolbecker"
"8/20/2016 12:00",446,385,20,13,"wolkig",831,"wolbecker"
"8/20/2016 13:00",351,391,22,17,"wolkig",742,"wolbecker"
"8/20/2016 14:00",315,394,21,13,"wolkig",709,"wolbecker"
"8/20/2016 15:00",302,359,22,17,"Regen",661,"wolbecker"
"8/20/2016 16:00",221,346,20,9,"teilweise bewölkt",567,"wolbecker"
"8/20/2016 17:00",268,316,22,11,"teilweise bewölkt",584,"wolbecker"
"8/20/2016 18:00",201,333,22,11,"teilweise bewölkt",534,"wolbecker"
"8/20/2016 19:00",242,262,21,7,"Klarer Himmel",504,"wolbecker"
"8/20/2016 20:00",176,196,18,7,"Klarer Himmel",372,"wolbecker"
"8/20/2016 21:00",145,135,15,4,"Nebel",280,"wolbecker"
"8/20/2016 22:00",128,89,15,7,"Klarer Himmel",217,"wolbecker"
"8/20/2016 23:00",106,104,18,19,"Klarer Himmel",210,"wolbecker"
"8/21/2016 0:00",108,95,17,13,"Klarer Himmel",203,"wolbecker"
"8/21/2016 1:00",89,89,17,9,"Klarer Himmel",178,"wolbecker"
"8/21/2016 2:00",49,57,15,9,"Klarer Himmel",106,"wolbecker"
"8/21/2016 3:00",45,29,15,11,"Klarer Himmel",74,"wolbecker"
"8/21/2016 4:00",38,15,15,13,"Klarer Himmel",53,"wolbecker"
"8/21/2016 5:00",29,12,14,11,"Klarer Himmel",41,"wolbecker"
"8/21/2016 6:00",31,20,15,11,"Klarer Himmel",51,"wolbecker"
"8/21/2016 7:00",27,26,16,17,"wolkig",53,"wolbecker"
"8/21/2016 8:00",35,40,17,19,"wolkig",75,"wolbecker"
"8/21/2016 9:00",60,58,18,22,"wolkig",118,"wolbecker"
"8/21/2016 10:00",106,110,17,20,"wolkig",216,"wolbecker"
"8/21/2016 11:00",89,101,15,28,"Regen",190,"wolbecker"
"8/21/2016 12:00",110,106,17,22,"wolkig",216,"wolbecker"
"8/21/2016 13:00",135,128,17,20,"wolkig",263,"wolbecker"
"8/21/2016 14:00",168,117,19,20,"wolkig",285,"wolbecker"
"8/21/2016 15:00",149,132,18,20,"Regen",281,"wolbecker"
"8/21/2016 16:00",131,126,18,17,"wolkig",257,"wolbecker"
"8/21/2016 17:00",201,144,18,19,"wolkig",345,"wolbecker"
"8/21/2016 18:00",166,171,18,24,"wolkig",337,"wolbecker"
"8/21/2016 19:00",169,138,18,22,"wolkig",307,"wolbecker"
"8/21/2016 20:00",121,93,17,13,"wolkig",214,"wolbecker"
"8/21/2016 21:00",111,63,17,17,"wolkig",174,"wolbecker"
"8/21/2016 22:00",61,49,16,9,"teilweise bewölkt",110,"wolbecker"
"8/21/2016 23:00",36,17,16,11,"teilweise bewölkt",53,"wolbecker"
"8/22/2016 0:00",29,11,16,11,"Klarer Himmel",40,"wolbecker"
"8/22/2016 1:00",11,12,16,11,"Klarer Himmel",23,"wolbecker"
"8/22/2016 2:00",3,2,15,9,"wolkig",5,"wolbecker"
"8/22/2016 3:00",3,1,16,11,"wolkig",4,"wolbecker"
"8/22/2016 4:00",4,8,15,13,"teilweise bewölkt",12,"wolbecker"
"8/22/2016 5:00",44,45,14,11,"wolkig",89,"wolbecker"
"8/22/2016 6:00",144,164,14,9,"Regen",308,"wolbecker"
"8/22/2016 7:00",356,251,15,11,"Regen",607,"wolbecker"
"8/22/2016 8:00",435,217,15,13,"Regen",652,"wolbecker"
"8/22/2016 9:00",358,208,15,13,"wolkig",566,"wolbecker"
"8/22/2016 10:00",256,163,16,15,"Regen",419,"wolbecker"
"8/22/2016 11:00",227,171,16,17,"Regen",398,"wolbecker"
"8/22/2016 12:00",213,194,16,15,"Regen",407,"wolbecker"
"8/22/2016 13:00",221,217,16,13,"Regen",438,"wolbecker"
"8/22/2016 14:00",235,248,17,13,"Regen",483,"wolbecker"
"8/22/2016 15:00",303,312,17,13,"Regen",615,"wolbecker"
"8/22/2016 16:00",312,409,18,15,"Regen",721,"wolbecker"
"8/22/2016 17:00",395,437,18,11,"Regen",832,"wolbecker"
"8/22/2016 18:00",366,395,19,11,"wolkig",761,"wolbecker"
"8/22/2016 19:00",241,324,19,9,"teilweise bewölkt",565,"wolbecker"
"8/22/2016 20:00",153,200,18,9,"Klarer Himmel",353,"wolbecker"
"8/22/2016 21:00",123,117,17,7,"Klarer Himmel",240,"wolbecker"
"8/22/2016 22:00",115,92,17,7,"teilweise bewölkt",207,"wolbecker"
"8/22/2016 23:00",81,52,15,2,"Nebel",133,"wolbecker"
"8/23/2016 0:00",25,44,14,0,"Nebel",69,"wolbecker"
"8/23/2016 1:00",14,22,15,0,"wolkig",36,"wolbecker"
"8/23/2016 2:00",11,4,15,2,"wolkig",15,"wolbecker"
"8/23/2016 3:00",19,7,16,4,"wolkig",26,"wolbecker"
"8/23/2016 4:00",17,10,16,2,"Klarer Himmel",27,"wolbecker"
"8/23/2016 5:00",48,49,15,6,"wolkig",97,"wolbecker"
"8/23/2016 6:00",174,170,15,0,"Nebel",344,"wolbecker"
"8/23/2016 7:00",421,302,16,0,"Nebel",723,"wolbecker"
"8/23/2016 8:00",574,252,18,6,"wolkig",826,"wolbecker"
"8/23/2016 9:00",410,216,19,7,"wolkig",626,"wolbecker"
"8/23/2016 10:00",426,248,21,7,"Klarer Himmel",674,"wolbecker"
"8/23/2016 11:00",399,267,23,7,"Klarer Himmel",666,"wolbecker"
"8/23/2016 12:00",429,364,24,7,"Klarer Himmel",793,"wolbecker"
"8/23/2016 13:00",365,401,25,7,"Klarer Himmel",766,"wolbecker"
"8/23/2016 14:00",427,384,26,7,"wolkig",811,"wolbecker"
"8/23/2016 15:00",398,474,26,2,"teilweise bewölkt",872,"wolbecker"
"8/23/2016 16:00",461,582,26,6,"teilweise bewölkt",1043,"wolbecker"
"8/23/2016 17:00",599,604,27,4,"teilweise bewölkt",1203,"wolbecker"
"8/23/2016 18:00",494,552,26,6,"Klarer Himmel",1046,"wolbecker"
"8/23/2016 19:00",380,429,25,4,"Klarer Himmel",809,"wolbecker"
"8/23/2016 20:00",280,280,22,6,"Klarer Himmel",560,"wolbecker"
"8/23/2016 21:00",181,164,21,6,"Klarer Himmel",345,"wolbecker"
"8/23/2016 22:00",183,126,20,6,"Klarer Himmel",309,"wolbecker"
"8/23/2016 23:00",99,65,20,4,"Klarer Himmel",164,"wolbecker"
"8/24/2016 0:00",37,35,19,4,"Klarer Himmel",72,"wolbecker"
"8/24/2016 1:00",14,11,19,6,"Klarer Himmel",25,"wolbecker"
"8/24/2016 2:00",7,10,18,4,"Klarer Himmel",17,"wolbecker"
"8/24/2016 3:00",8,5,19,6,"Klarer Himmel",13,"wolbecker"
"8/24/2016 4:00",3,14,18,6,"Klarer Himmel",17,"wolbecker"
"8/24/2016 5:00",51,53,17,4,"Klarer Himmel",104,"wolbecker"
"8/24/2016 6:00",191,191,17,4,"Klarer Himmel",382,"wolbecker"
"8/24/2016 7:00",717,367,19,7,"Klarer Himmel",1084,"wolbecker"
"8/24/2016 8:00",653,297,21,7,"Klarer Himmel",950,"wolbecker"
"8/24/2016 9:00",505,204,23,6,"Klarer Himmel",709,"wolbecker"
"8/24/2016 10:00",434,278,25,7,"Klarer Himmel",712,"wolbecker"
"8/24/2016 11:00",411,330,27,7,"Klarer Himmel",741,"wolbecker"
"8/24/2016 12:00",356,395,28,9,"Klarer Himmel",751,"wolbecker"
"8/24/2016 13:00",351,584,29,11,"Klarer Himmel",935,"wolbecker"
"8/24/2016 14:00",330,507,30,13,"Klarer Himmel",837,"wolbecker"
"8/24/2016 15:00",434,505,30,11,"Klarer Himmel",939,"wolbecker"
"8/24/2016 16:00",459,628,31,6,"Klarer Himmel",1087,"wolbecker"
"8/24/2016 17:00",565,577,31,6,"Klarer Himmel",1142,"wolbecker"
"8/24/2016 18:00",477,521,30,4,"Klarer Himmel",998,"wolbecker"
"8/24/2016 19:00",421,424,28,6,"Klarer Himmel",845,"wolbecker"
"8/24/2016 20:00",327,314,25,6,"Klarer Himmel",641,"wolbecker"
"8/24/2016 21:00",243,193,24,6,"Klarer Himmel",436,"wolbecker"
"8/24/2016 22:00",192,147,25,7,"Klarer Himmel",339,"wolbecker"
"8/24/2016 23:00",145,102,23,6,"Klarer Himmel",247,"wolbecker"
"8/25/2016 0:00",76,20,21,4,"Klarer Himmel",96,"wolbecker"
"8/25/2016 1:00",30,41,21,6,"Klarer Himmel",71,"wolbecker"
"8/25/2016 2:00",21,19,21,9,"Klarer Himmel",40,"wolbecker"
"8/25/2016 3:00",16,12,21,7,"Klarer Himmel",28,"wolbecker"
"8/25/2016 4:00",11,12,19,4,"Klarer Himmel",23,"wolbecker"
"8/25/2016 5:00",44,44,20,9,"Klarer Himmel",88,"wolbecker"
"8/25/2016 6:00",162,185,19,9,"Klarer Himmel",347,"wolbecker"
"8/25/2016 7:00",725,348,20,9,"Klarer Himmel",1073,"wolbecker"
"8/25/2016 8:00",573,286,22,6,"Klarer Himmel",859,"wolbecker"
"8/25/2016 9:00",452,240,24,7,"Klarer Himmel",692,"wolbecker"
"8/25/2016 10:00",365,227,27,11,"Klarer Himmel",592,"wolbecker"
"8/25/2016 11:00",343,231,28,15,"Klarer Himmel",574,"wolbecker"
"8/25/2016 12:00",348,383,29,15,"Klarer Himmel",731,"wolbecker"
"8/25/2016 13:00",354,474,30,9,"Klarer Himmel",828,"wolbecker"
"8/25/2016 14:00",380,433,31,11,"Klarer Himmel",813,"wolbecker"
"8/25/2016 15:00",371,514,31,15,"Klarer Himmel",885,"wolbecker"
"8/25/2016 16:00",486,614,32,11,"Klarer Himmel",1100,"wolbecker"
"8/25/2016 17:00",554,596,32,6,"Klarer Himmel",1150,"wolbecker"
"8/25/2016 18:00",478,539,32,4,"Klarer Himmel",1017,"wolbecker"
"8/25/2016 19:00",456,418,29,4,"Klarer Himmel",874,"wolbecker"
"8/25/2016 20:00",342,286,24,0,"Klarer Himmel",628,"wolbecker"
"8/25/2016 21:00",232,224,21,4,"Klarer Himmel",456,"wolbecker"
"8/25/2016 22:00",207,185,20,2,"Klarer Himmel",392,"wolbecker"
"8/25/2016 23:00",142,80,21,6,"Klarer Himmel",222,"wolbecker"
"8/26/2016 0:00",52,46,19,2,"Klarer Himmel",98,"wolbecker"
"8/26/2016 1:00",37,26,18,2,"Klarer Himmel",63,"wolbecker"
"8/26/2016 2:00",15,16,20,6,"Klarer Himmel",31,"wolbecker"
"8/26/2016 3:00",7,4,20,6,"Klarer Himmel",11,"wolbecker"
"8/26/2016 4:00",7,10,19,6,"Klarer Himmel",17,"wolbecker"
"8/26/2016 5:00",49,43,18,4,"Klarer Himmel",92,"wolbecker"
"8/26/2016 6:00",157,157,18,2,"Klarer Himmel",314,"wolbecker"
"8/26/2016 7:00",702,320,20,6,"Klarer Himmel",1022,"wolbecker"
"8/26/2016 8:00",490,259,22,9,"Klarer Himmel",749,"wolbecker"
"8/26/2016 9:00",423,257,25,7,"Klarer Himmel",680,"wolbecker"
"8/26/2016 10:00",356,239,26,7,"Klarer Himmel",595,"wolbecker"
"8/26/2016 11:00",361,316,28,7,"Klarer Himmel",677,"wolbecker"
"8/26/2016 12:00",332,450,30,11,"Klarer Himmel",782,"wolbecker"
"8/26/2016 13:00",390,562,30,7,"Klarer Himmel",952,"wolbecker"
"8/26/2016 14:00",436,532,30,15,"Klarer Himmel",968,"wolbecker"
"8/26/2016 15:00",424,494,31,9,"Klarer Himmel",918,"wolbecker"
"8/26/2016 16:00",384,507,31,9,"Klarer Himmel",891,"wolbecker"
"8/26/2016 17:00",422,454,30,15,"Klarer Himmel",876,"wolbecker"
"8/26/2016 18:00",380,432,29,11,"Klarer Himmel",812,"wolbecker"
"8/26/2016 19:00",378,362,27,13,"Klarer Himmel",740,"wolbecker"
"8/26/2016 20:00",253,250,25,15,"Klarer Himmel",503,"wolbecker"
"8/26/2016 21:00",216,213,24,17,"Klarer Himmel",429,"wolbecker"
"8/26/2016 22:00",175,143,22,13,"Klarer Himmel",318,"wolbecker"
"8/26/2016 23:00",161,122,21,13,"Klarer Himmel",283,"wolbecker"
"8/27/2016 0:00",130,93,20,9,"wolkig",223,"wolbecker"
"8/27/2016 1:00",100,64,20,9,"Klarer Himmel",164,"wolbecker"
"8/27/2016 2:00",69,37,19,9,"wolkig",106,"wolbecker"
"8/27/2016 3:00",45,36,19,9,"wolkig",81,"wolbecker"
"8/27/2016 4:00",46,15,18,11,"teilweise bewölkt",61,"wolbecker"
"8/27/2016 5:00",34,20,17,7,"wolkig",54,"wolbecker"
"8/27/2016 6:00",38,36,17,9,"teilweise bewölkt",74,"wolbecker"
"8/27/2016 7:00",107,67,18,6,"Klarer Himmel",174,"wolbecker"
"8/27/2016 8:00",158,119,19,15,"Klarer Himmel",277,"wolbecker"
"8/27/2016 9:00",365,184,21,11,"Klarer Himmel",549,"wolbecker"
"8/27/2016 10:00",458,268,22,13,"Klarer Himmel",726,"wolbecker"
"8/27/2016 11:00",461,303,24,13,"Klarer Himmel",764,"wolbecker"
"8/27/2016 12:00",413,436,25,15,"Klarer Himmel",849,"wolbecker"
"8/27/2016 13:00",365,428,26,11,"Klarer Himmel",793,"wolbecker"
"8/27/2016 14:00",329,431,27,11,"Klarer Himmel",760,"wolbecker"
"8/27/2016 15:00",305,388,28,11,"Klarer Himmel",693,"wolbecker"
"8/27/2016 16:00",280,329,28,19,"teilweise bewölkt",609,"wolbecker"
"8/27/2016 17:00",299,324,29,9,"teilweise bewölkt",623,"wolbecker"
"8/27/2016 18:00",369,309,28,7,"wolkig",678,"wolbecker"
"8/27/2016 19:00",338,274,27,6,"wolkig",612,"wolbecker"
"8/27/2016 20:00",268,211,25,7,"Klarer Himmel",479,"wolbecker"
"8/27/2016 21:00",179,179,25,6,"wolkig",358,"wolbecker"
"8/27/2016 22:00",180,195,23,7,"wolkig",375,"wolbecker"
"8/27/2016 23:00",68,111,23,13,"teilweise bewölkt",179,"wolbecker"
"8/28/2016 0:00",83,143,24,7,"teilweise bewölkt",226,"wolbecker"
"8/28/2016 1:00",72,108,24,13,"wolkig",180,"wolbecker"
"8/28/2016 2:00",63,43,21,4,"teilweise bewölkt",106,"wolbecker"
"8/28/2016 3:00",70,34,21,6,"wolkig",104,"wolbecker"
"8/28/2016 4:00",43,19,21,6,"Klarer Himmel",62,"wolbecker"
"8/28/2016 5:00",35,5,20,7,"Klarer Himmel",40,"wolbecker"
"8/28/2016 6:00",22,27,20,4,"Klarer Himmel",49,"wolbecker"
"8/28/2016 7:00",26,41,21,9,"Klarer Himmel",67,"wolbecker"
"8/28/2016 8:00",45,39,23,9,"Klarer Himmel",84,"wolbecker"
"8/28/2016 9:00",126,74,25,11,"teilweise bewölkt",200,"wolbecker"
"8/28/2016 10:00",172,109,27,13,"wolkig",281,"wolbecker"
"8/28/2016 11:00",184,146,29,13,"wolkig",330,"wolbecker"
"8/28/2016 12:00",204,179,31,20,"teilweise bewölkt",383,"wolbecker"
"8/28/2016 13:00",185,222,32,22,"teilweise bewölkt",407,"wolbecker"
"8/28/2016 14:00",239,269,30,30,"teilweise bewölkt",508,"wolbecker"
"8/28/2016 15:00",233,221,27,32,"Regen",454,"wolbecker"
"8/28/2016 16:00",214,194,26,32,"teilweise bewölkt",408,"wolbecker"
"8/28/2016 17:00",259,218,25,33,"teilweise bewölkt",477,"wolbecker"
"8/28/2016 18:00",318,208,23,30,"teilweise bewölkt",526,"wolbecker"
"8/28/2016 19:00",215,172,22,26,"teilweise bewölkt",387,"wolbecker"
"8/28/2016 20:00",183,150,21,9,"Klarer Himmel",333,"wolbecker"
"8/28/2016 21:00",136,111,19,11,"Klarer Himmel",247,"wolbecker"
"8/28/2016 22:00",126,60,19,13,"teilweise bewölkt",186,"wolbecker"
"8/28/2016 23:00",54,39,18,6,"Klarer Himmel",93,"wolbecker"
"8/29/2016 0:00",26,20,17,9,"teilweise bewölkt",46,"wolbecker"
"8/29/2016 1:00",12,16,18,7,"Klarer Himmel",28,"wolbecker"
"8/29/2016 2:00",7,5,17,13,"Klarer Himmel",12,"wolbecker"
"8/29/2016 3:00",3,4,17,17,"teilweise bewölkt",7,"wolbecker"
"8/29/2016 4:00",3,6,17,15,"wolkig",9,"wolbecker"
"8/29/2016 5:00",45,40,17,13,"wolkig",85,"wolbecker"
"8/29/2016 6:00",140,167,17,19,"Regen",307,"wolbecker"
"8/29/2016 7:00",574,288,17,17,"wolkig",862,"wolbecker"
"8/29/2016 8:00",462,227,17,17,"wolkig",689,"wolbecker"
"8/29/2016 9:00",354,188,19,17,"wolkig",542,"wolbecker"
"8/29/2016 10:00",300,170,18,13,"wolkig",470,"wolbecker"
"8/29/2016 11:00",306,246,20,13,"wolkig",552,"wolbecker"
"8/29/2016 12:00",274,280,20,13,"wolkig",554,"wolbecker"
"8/29/2016 13:00",392,333,21,17,"wolkig",725,"wolbecker"
"8/29/2016 14:00",343,361,21,22,"wolkig",704,"wolbecker"
"8/29/2016 15:00",412,358,21,15,"wolkig",770,"wolbecker"
"8/29/2016 16:00",419,507,20,15,"wolkig",926,"wolbecker"
"8/29/2016 17:00",482,567,21,15,"teilweise bewölkt",1049,"wolbecker"
"8/29/2016 18:00",408,500,20,11,"teilweise bewölkt",908,"wolbecker"
"8/29/2016 19:00",287,379,19,15,"wolkig",666,"wolbecker"
"8/29/2016 20:00",212,216,17,9,"teilweise bewölkt",428,"wolbecker"
"8/29/2016 21:00",137,160,16,11,"Klarer Himmel",297,"wolbecker"
"8/29/2016 22:00",99,116,14,4,"Klarer Himmel",215,"wolbecker"
"8/29/2016 23:00",59,42,12,0,"Klarer Himmel",101,"wolbecker"
"8/30/2016 0:00",28,21,11,2,"Klarer Himmel",49,"wolbecker"
"8/30/2016 1:00",18,12,11,0,"Nebel",30,"wolbecker"
"8/30/2016 2:00",4,5,10,0,"Nebel",9,"wolbecker"
"8/30/2016 3:00",6,7,9,0,"Nebel",13,"wolbecker"
"8/30/2016 4:00",4,9,9,0,"Nebel",13,"wolbecker"
"8/30/2016 5:00",42,42,8,2,"Nebel",84,"wolbecker"
"8/30/2016 6:00",170,172,9,0,"Nebel",342,"wolbecker"
"8/30/2016 7:00",694,368,10,2,"Nebel",1062,"wolbecker"
"8/30/2016 8:00",600,301,14,0,"Klarer Himmel",901,"wolbecker"
"8/30/2016 9:00",423,218,17,0,"Klarer Himmel",641,"wolbecker"
"8/30/2016 10:00",355,221,18,2,"teilweise bewölkt",576,"wolbecker"
"8/30/2016 11:00",336,245,19,4,"teilweise bewölkt",581,"wolbecker"
"8/30/2016 12:00",400,374,20,6,"teilweise bewölkt",774,"wolbecker"
"8/30/2016 13:00",378,431,21,9,"teilweise bewölkt",809,"wolbecker"
"8/30/2016 14:00",422,410,22,7,"Klarer Himmel",832,"wolbecker"
"8/30/2016 15:00",447,481,22,7,"Klarer Himmel",928,"wolbecker"
"8/30/2016 16:00",500,579,23,4,"Klarer Himmel",1079,"wolbecker"
"8/30/2016 17:00",574,646,22,6,"Klarer Himmel",1220,"wolbecker"
"8/30/2016 18:00",470,591,22,4,"Klarer Himmel",1061,"wolbecker"
"8/30/2016 19:00",320,432,20,4,"Klarer Himmel",752,"wolbecker"
"8/30/2016 20:00",254,292,17,2,"Klarer Himmel",546,"wolbecker"
"8/30/2016 21:00",186,188,14,4,"Klarer Himmel",374,"wolbecker"
"8/30/2016 22:00",163,132,13,2,"Klarer Himmel",295,"wolbecker"
"8/30/2016 23:00",66,63,12,0,"Klarer Himmel",129,"wolbecker"
"8/31/2016 0:00",51,30,12,0,"Klarer Himmel",81,"wolbecker"
"8/31/2016 1:00",12,12,11,0,"Klarer Himmel",24,"wolbecker"
"8/31/2016 2:00",8,4,11,2,"Klarer Himmel",12,"wolbecker"
"8/31/2016 3:00",3,1,10,2,"Klarer Himmel",4,"wolbecker"
"8/31/2016 4:00",1,9,12,6,"Klarer Himmel",10,"wolbecker"
"8/31/2016 5:00",40,55,11,2,"Klarer Himmel",95,"wolbecker"
"8/31/2016 6:00",175,170,11,2,"Klarer Himmel",345,"wolbecker"
"8/31/2016 7:00",710,396,13,4,"Klarer Himmel",1106,"wolbecker"
"8/31/2016 8:00",645,295,16,4,"Klarer Himmel",940,"wolbecker"
"8/31/2016 9:00",470,239,18,7,"Klarer Himmel",709,"wolbecker"
"8/31/2016 10:00",406,258,20,9,"Klarer Himmel",664,"wolbecker"
"8/31/2016 11:00",372,308,22,4,"Klarer Himmel",680,"wolbecker"
"8/31/2016 12:00",415,419,24,4,"Klarer Himmel",834,"wolbecker"
"8/31/2016 13:00",423,513,25,9,"Klarer Himmel",936,"wolbecker"
"8/31/2016 14:00",404,496,26,11,"Klarer Himmel",900,"wolbecker"
"8/31/2016 15:00",449,523,26,13,"Klarer Himmel",972,"wolbecker"
"8/31/2016 16:00",450,589,26,13,"Klarer Himmel",1039,"wolbecker"
"8/31/2016 17:00",563,645,26,19,"Klarer Himmel",1208,"wolbecker"
"8/31/2016 18:00",487,562,25,13,"Klarer Himmel",1049,"wolbecker"
"8/31/2016 19:00",405,429,23,6,"Klarer Himmel",834,"wolbecker"
"8/31/2016 20:00",270,280,18,0,"Klarer Himmel",550,"wolbecker"
"8/31/2016 21:00",202,223,18,7,"Klarer Himmel",425,"wolbecker"
"8/31/2016 22:00",187,138,16,2,"Klarer Himmel",325,"wolbecker"
"8/31/2016 23:00",81,69,15,0,"Klarer Himmel",150,"wolbecker"
"9/1/2016 0:00",62,55,14,2,"Klarer Himmel",117,"wolbecker"
"9/1/2016 1:00",24,34,13,0,"Klarer Himmel",58,"wolbecker"
"9/1/2016 2:00",17,16,13,2,NA,33,"wolbecker"
"9/1/2016 3:00",6,13,12,2,"Nebel",19,"wolbecker"
"9/1/2016 4:00",10,12,12,2,"Nebel",22,"wolbecker"
"9/1/2016 5:00",50,48,12,0,"Nebel",98,"wolbecker"
"9/1/2016 6:00",168,181,12,2,"Nebel",349,"wolbecker"
"9/1/2016 7:00",703,347,13,0,"Nebel",1050,"wolbecker"
"9/1/2016 8:00",595,299,16,0,NA,894,"wolbecker"
"9/1/2016 9:00",422,234,18,6,NA,656,"wolbecker"
"9/1/2016 10:00",377,187,20,6,"Klarer Himmel",564,"wolbecker"
"9/1/2016 11:00",372,269,23,13,"teilweise bewölkt",641,"wolbecker"
"9/1/2016 12:00",356,366,23,15,"teilweise bewölkt",722,"wolbecker"
"9/1/2016 13:00",405,465,24,17,"teilweise bewölkt",870,"wolbecker"
"9/1/2016 14:00",408,453,24,19,"wolkig",861,"wolbecker"
"9/1/2016 15:00",423,530,19,26,"Regen",953,"wolbecker"
"9/1/2016 16:00",481,543,19,6,"wolkig",1024,"wolbecker"
"9/1/2016 17:00",521,574,20,7,"wolkig",1095,"wolbecker"
"9/1/2016 18:00",482,545,21,9,"wolkig",1027,"wolbecker"
"9/1/2016 19:00",376,455,19,2,"wolkig",831,"wolbecker"
"9/1/2016 20:00",232,294,16,0,"Nebel",526,"wolbecker"
"9/1/2016 21:00",164,197,16,0,"wolkig",361,"wolbecker"
"9/1/2016 22:00",141,170,15,0,"Nebel",311,"wolbecker"
"9/1/2016 23:00",114,76,13,4,"Nebel",190,"wolbecker"
"9/2/2016 0:00",39,40,13,0,"Nebel",79,"wolbecker"
"9/2/2016 1:00",10,14,12,0,"Nebel",24,"wolbecker"
"9/2/2016 2:00",5,9,11,0,"Nebel",14,"wolbecker"
"9/2/2016 3:00",4,6,11,0,"Nebel",10,"wolbecker"
"9/2/2016 4:00",7,7,11,0,"Nebel",14,"wolbecker"
"9/2/2016 5:00",28,39,10,0,"Nebel",67,"wolbecker"
"9/2/2016 6:00",157,165,11,0,"Nebel",322,"wolbecker"
"9/2/2016 7:00",680,314,11,2,"Nebel",994,"wolbecker"
"9/2/2016 8:00",532,288,13,6,"Nebel",820,"wolbecker"
"9/2/2016 9:00",383,210,15,4,"wolkig",593,"wolbecker"
"9/2/2016 10:00",331,199,18,7,"wolkig",530,"wolbecker"
"9/2/2016 11:00",378,337,21,17,"wolkig",715,"wolbecker"
"9/2/2016 12:00",432,372,23,17,"wolkig",804,"wolbecker"
"9/2/2016 13:00",445,499,24,15,"wolkig",944,"wolbecker"
"9/2/2016 14:00",457,484,24,17,"Klarer Himmel",941,"wolbecker"
"9/2/2016 15:00",434,488,25,19,"Klarer Himmel",922,"wolbecker"
"9/2/2016 16:00",458,484,25,19,"Klarer Himmel",942,"wolbecker"
"9/2/2016 17:00",483,519,24,19,"wolkig",1002,"wolbecker"
"9/2/2016 18:00",388,413,22,17,"Klarer Himmel",801,"wolbecker"
"9/2/2016 19:00",353,361,21,11,"Klarer Himmel",714,"wolbecker"
"9/2/2016 20:00",249,284,18,6,"Klarer Himmel",533,"wolbecker"
"9/2/2016 21:00",188,172,18,6,"Klarer Himmel",360,"wolbecker"
"9/2/2016 22:00",150,175,18,6,"Klarer Himmel",325,"wolbecker"
"9/2/2016 23:00",125,145,18,6,"Klarer Himmel",270,"wolbecker"
"9/3/2016 0:00",85,158,18,4,"Klarer Himmel",243,"wolbecker"
"9/3/2016 1:00",53,105,17,11,"wolkig",158,"wolbecker"
"9/3/2016 2:00",55,55,17,7,"wolkig",110,"wolbecker"
"9/3/2016 3:00",40,37,16,7,"wolkig",77,"wolbecker"
"9/3/2016 4:00",37,24,16,11,"wolkig",61,"wolbecker"
"9/3/2016 5:00",39,16,16,7,"Klarer Himmel",55,"wolbecker"
"9/3/2016 6:00",42,30,15,9,"teilweise bewölkt",72,"wolbecker"
"9/3/2016 7:00",91,49,16,7,"wolkig",140,"wolbecker"
"9/3/2016 8:00",144,103,17,11,"wolkig",247,"wolbecker"
"9/3/2016 9:00",320,130,18,11,"wolkig",450,"wolbecker"
"9/3/2016 10:00",424,218,18,19,"wolkig",642,"wolbecker"
"9/3/2016 11:00",455,261,18,13,"wolkig",716,"wolbecker"
"9/3/2016 12:00",410,350,20,17,"wolkig",760,"wolbecker"
"9/3/2016 13:00",396,392,20,11,"wolkig",788,"wolbecker"
"9/3/2016 14:00",387,402,21,20,"wolkig",789,"wolbecker"
"9/3/2016 15:00",373,374,22,17,"wolkig",747,"wolbecker"
"9/3/2016 16:00",310,369,22,15,"wolkig",679,"wolbecker"
"9/3/2016 17:00",334,377,22,13,"wolkig",711,"wolbecker"
"9/3/2016 18:00",337,390,22,6,"wolkig",727,"wolbecker"
"9/3/2016 19:00",404,327,19,0,"wolkig",731,"wolbecker"
"9/3/2016 20:00",297,266,17,0,"wolkig",563,"wolbecker"
"9/3/2016 21:00",203,231,16,6,"Klarer Himmel",434,"wolbecker"
"9/3/2016 22:00",157,259,17,7,"Klarer Himmel",416,"wolbecker"
"9/3/2016 23:00",129,251,18,9,"Klarer Himmel",380,"wolbecker"
"9/4/2016 0:00",106,187,18,9,"Klarer Himmel",293,"wolbecker"
"9/4/2016 1:00",112,134,18,13,"Klarer Himmel",246,"wolbecker"
"9/4/2016 2:00",76,84,19,11,"wolkig",160,"wolbecker"
"9/4/2016 3:00",65,39,19,11,"wolkig",104,"wolbecker"
"9/4/2016 4:00",39,32,18,7,"Regen",71,"wolbecker"
"9/4/2016 5:00",62,8,17,15,"Regen",70,"wolbecker"
"9/4/2016 6:00",28,18,17,15,"Klarer Himmel",46,"wolbecker"
"9/4/2016 7:00",20,28,17,13,"wolkig",48,"wolbecker"
"9/4/2016 8:00",32,47,18,19,"wolkig",79,"wolbecker"
"9/4/2016 9:00",60,57,18,15,"wolkig",117,"wolbecker"
"9/4/2016 10:00",108,104,19,15,"wolkig",212,"wolbecker"
"9/4/2016 11:00",129,81,19,20,"Regen",210,"wolbecker"
"9/4/2016 12:00",103,100,19,20,"wolkig",203,"wolbecker"
"9/4/2016 13:00",137,129,21,26,"teilweise bewölkt",266,"wolbecker"
"9/4/2016 14:00",158,146,22,26,"teilweise bewölkt",304,"wolbecker"
"9/4/2016 15:00",207,126,22,33,"teilweise bewölkt",333,"wolbecker"
"9/4/2016 16:00",204,173,20,24,"wolkig",377,"wolbecker"
"9/4/2016 17:00",198,224,19,32,"wolkig",422,"wolbecker"
"9/4/2016 18:00",151,178,19,32,"wolkig",329,"wolbecker"
"9/4/2016 19:00",214,146,18,22,"wolkig",360,"wolbecker"
"9/4/2016 20:00",136,110,17,20,"wolkig",246,"wolbecker"
"9/4/2016 21:00",83,64,16,20,"Regen",147,"wolbecker"
"9/4/2016 22:00",62,47,16,20,"teilweise bewölkt",109,"wolbecker"
"9/4/2016 23:00",46,35,17,17,"wolkig",81,"wolbecker"
"9/5/2016 0:00",21,13,16,15,"wolkig",34,"wolbecker"
"9/5/2016 1:00",12,5,16,22,"wolkig",17,"wolbecker"
"9/5/2016 2:00",2,3,16,24,"wolkig",5,"wolbecker"
"9/5/2016 3:00",0,0,16,24,"Regen",0,"wolbecker"
"9/5/2016 4:00",7,6,15,20,"wolkig",13,"wolbecker"
"9/5/2016 5:00",36,37,15,20,"Regen",73,"wolbecker"
"9/5/2016 6:00",144,171,15,19,"Regen",315,"wolbecker"
"9/5/2016 7:00",599,328,15,13,"wolkig",927,"wolbecker"
"9/5/2016 8:00",560,255,16,17,"teilweise bewölkt",815,"wolbecker"
"9/5/2016 9:00",380,201,17,13,"wolkig",581,"wolbecker"
"9/5/2016 10:00",313,175,18,19,"wolkig",488,"wolbecker"
"9/5/2016 11:00",312,227,19,15,"wolkig",539,"wolbecker"
"9/5/2016 12:00",298,306,20,11,"wolkig",604,"wolbecker"
"9/5/2016 13:00",347,370,22,9,"wolkig",717,"wolbecker"
"9/5/2016 14:00",394,339,22,13,"wolkig",733,"wolbecker"
"9/5/2016 15:00",407,452,22,11,"wolkig",859,"wolbecker"
"9/5/2016 16:00",435,508,22,11,"teilweise bewölkt",943,"wolbecker"
"9/5/2016 17:00",491,639,22,11,"teilweise bewölkt",1130,"wolbecker"
"9/5/2016 18:00",440,526,21,9,"teilweise bewölkt",966,"wolbecker"
"9/5/2016 19:00",350,407,19,6,"teilweise bewölkt",757,"wolbecker"
"9/5/2016 20:00",181,209,17,0,"wolkig",390,"wolbecker"
"9/5/2016 21:00",148,179,15,0,"teilweise bewölkt",327,"wolbecker"
"9/5/2016 22:00",148,118,15,0,"Klarer Himmel",266,"wolbecker"
"9/5/2016 23:00",47,48,13,2,"Nebel",95,"wolbecker"
"9/6/2016 0:00",22,33,13,0,"Nebel",55,"wolbecker"
"9/6/2016 1:00",21,18,12,0,"Nebel",39,"wolbecker"
"9/6/2016 2:00",3,11,12,0,"Nebel",14,"wolbecker"
"9/6/2016 3:00",6,3,11,0,"Nebel",9,"wolbecker"
"9/6/2016 4:00",7,7,12,2,"Nebel",14,"wolbecker"
"9/6/2016 5:00",39,54,11,0,"Nebel",93,"wolbecker"
"9/6/2016 6:00",178,197,11,0,"Nebel",375,"wolbecker"
"9/6/2016 7:00",689,354,13,2,"Nebel",1043,"wolbecker"
"9/6/2016 8:00",601,287,15,2,"teilweise bewölkt",888,"wolbecker"
"9/6/2016 9:00",425,169,17,7,"teilweise bewölkt",594,"wolbecker"
"9/6/2016 10:00",345,219,20,6,"Klarer Himmel",564,"wolbecker"
"9/6/2016 11:00",307,250,22,9,"teilweise bewölkt",557,"wolbecker"
"9/6/2016 12:00",368,333,23,11,"teilweise bewölkt",701,"wolbecker"
"9/6/2016 13:00",394,418,23,7,"teilweise bewölkt",812,"wolbecker"
"9/6/2016 14:00",388,460,24,9,"teilweise bewölkt",848,"wolbecker"
"9/6/2016 15:00",452,473,24,7,"teilweise bewölkt",925,"wolbecker"
"9/6/2016 16:00",493,560,25,6,"teilweise bewölkt",1053,"wolbecker"
"9/6/2016 17:00",588,644,25,7,"Klarer Himmel",1232,"wolbecker"
"9/6/2016 18:00",529,582,24,2,"Klarer Himmel",1111,"wolbecker"
"9/6/2016 19:00",377,432,19,4,"Klarer Himmel",809,"wolbecker"
"9/6/2016 20:00",259,254,18,0,"Klarer Himmel",513,"wolbecker"
"9/6/2016 21:00",192,196,16,2,"Klarer Himmel",388,"wolbecker"
"9/6/2016 22:00",157,132,15,2,"Klarer Himmel",289,"wolbecker"
"9/6/2016 23:00",74,71,14,0,"Klarer Himmel",145,"wolbecker"
"9/7/2016 0:00",44,35,13,0,"Klarer Himmel",79,"wolbecker"
"9/7/2016 1:00",19,17,13,4,"Klarer Himmel",36,"wolbecker"
"9/7/2016 2:00",12,7,15,4,"Klarer Himmel",19,"wolbecker"
"9/7/2016 3:00",2,6,15,6,"Klarer Himmel",8,"wolbecker"
"9/7/2016 4:00",4,11,14,4,"Klarer Himmel",15,"wolbecker"
"9/7/2016 5:00",41,45,13,6,"Klarer Himmel",86,"wolbecker"
"9/7/2016 6:00",179,194,13,2,"Klarer Himmel",373,"wolbecker"
"9/7/2016 7:00",724,397,14,4,"Klarer Himmel",1121,"wolbecker"
"9/7/2016 8:00",629,311,16,6,"Klarer Himmel",940,"wolbecker"
"9/7/2016 9:00",501,251,18,7,"Klarer Himmel",752,"wolbecker"
"9/7/2016 10:00",421,270,20,7,"Klarer Himmel",691,"wolbecker"
"9/7/2016 11:00",387,298,23,4,"Klarer Himmel",685,"wolbecker"
"9/7/2016 12:00",390,426,25,4,"Klarer Himmel",816,"wolbecker"
"9/7/2016 13:00",396,463,25,7,"Klarer Himmel",859,"wolbecker"
"9/7/2016 14:00",350,484,26,7,"Klarer Himmel",834,"wolbecker"
"9/7/2016 15:00",402,509,26,9,"Klarer Himmel",911,"wolbecker"
"9/7/2016 16:00",460,612,27,6,"Klarer Himmel",1072,"wolbecker"
"9/7/2016 17:00",641,574,26,7,"Klarer Himmel",1215,"wolbecker"
"9/7/2016 18:00",500,550,25,7,"Klarer Himmel",1050,"wolbecker"
"9/7/2016 19:00",428,410,23,4,"Klarer Himmel",838,"wolbecker"
"9/7/2016 20:00",270,340,19,6,"Klarer Himmel",610,"wolbecker"
"9/7/2016 21:00",222,245,18,6,"Klarer Himmel",467,"wolbecker"
"9/7/2016 22:00",167,147,16,6,"Klarer Himmel",314,"wolbecker"
"9/7/2016 23:00",90,91,18,4,"Klarer Himmel",181,"wolbecker"
"9/8/2016 0:00",44,43,16,4,"Klarer Himmel",87,"wolbecker"
"9/8/2016 1:00",19,28,14,0,"Klarer Himmel",47,"wolbecker"
"9/8/2016 2:00",15,14,14,4,"Klarer Himmel",29,"wolbecker"
"9/8/2016 3:00",10,11,16,6,"Klarer Himmel",21,"wolbecker"
"9/8/2016 4:00",12,17,16,4,"Klarer Himmel",29,"wolbecker"
"9/8/2016 5:00",43,49,14,2,"Klarer Himmel",92,"wolbecker"
"9/8/2016 6:00",167,201,13,2,"Nebel",368,"wolbecker"
"9/8/2016 7:00",693,398,16,6,"Klarer Himmel",1091,"wolbecker"
"9/8/2016 8:00",598,282,18,6,"Klarer Himmel",880,"wolbecker"
"9/8/2016 9:00",431,234,21,9,"Klarer Himmel",665,"wolbecker"
"9/8/2016 10:00",380,216,23,11,"Klarer Himmel",596,"wolbecker"
"9/8/2016 11:00",306,313,25,15,"Klarer Himmel",619,"wolbecker"
"9/8/2016 12:00",383,368,27,13,"Klarer Himmel",751,"wolbecker"
"9/8/2016 13:00",366,449,27,13,"Klarer Himmel",815,"wolbecker"
"9/8/2016 14:00",406,475,28,20,"Klarer Himmel",881,"wolbecker"
"9/8/2016 15:00",408,565,28,22,"Klarer Himmel",973,"wolbecker"
"9/8/2016 16:00",526,604,28,17,"Klarer Himmel",1130,"wolbecker"
"9/8/2016 17:00",551,570,27,22,"Klarer Himmel",1121,"wolbecker"
"9/8/2016 18:00",598,539,26,11,"Klarer Himmel",1137,"wolbecker"
"9/8/2016 19:00",400,461,22,4,"Klarer Himmel",861,"wolbecker"
"9/8/2016 20:00",257,316,20,0,"Klarer Himmel",573,"wolbecker"
"9/8/2016 21:00",198,202,19,0,"Klarer Himmel",400,"wolbecker"
"9/8/2016 22:00",202,148,17,0,"Klarer Himmel",350,"wolbecker"
"9/8/2016 23:00",128,60,19,9,"Klarer Himmel",188,"wolbecker"
"9/9/2016 0:00",62,45,19,9,"Klarer Himmel",107,"wolbecker"
"9/9/2016 1:00",20,21,18,9,"teilweise bewölkt",41,"wolbecker"
"9/9/2016 2:00",8,14,18,11,"wolkig",22,"wolbecker"
"9/9/2016 3:00",5,7,18,11,"wolkig",12,"wolbecker"
"9/9/2016 4:00",5,11,16,7,"wolkig",16,"wolbecker"
"9/9/2016 5:00",36,45,17,7,"teilweise bewölkt",81,"wolbecker"
"9/9/2016 6:00",154,163,15,6,"Nebel",317,"wolbecker"
"9/9/2016 7:00",653,345,16,9,"wolkig",998,"wolbecker"
"9/9/2016 8:00",503,265,16,9,"wolkig",768,"wolbecker"
"9/9/2016 9:00",382,179,16,7,"wolkig",561,"wolbecker"
"9/9/2016 10:00",363,194,18,7,"wolkig",557,"wolbecker"
"9/9/2016 11:00",326,265,18,7,"wolkig",591,"wolbecker"
"9/9/2016 12:00",362,349,20,9,"teilweise bewölkt",711,"wolbecker"
"9/9/2016 13:00",448,580,21,7,"teilweise bewölkt",1028,"wolbecker"
"9/9/2016 14:00",524,493,23,9,"teilweise bewölkt",1017,"wolbecker"
"9/9/2016 15:00",421,507,23,7,"teilweise bewölkt",928,"wolbecker"
"9/9/2016 16:00",440,496,24,6,"teilweise bewölkt",936,"wolbecker"
"9/9/2016 17:00",491,499,23,4,"teilweise bewölkt",990,"wolbecker"
"9/9/2016 18:00",398,461,23,6,"Klarer Himmel",859,"wolbecker"
"9/9/2016 19:00",359,389,19,4,"Klarer Himmel",748,"wolbecker"
"9/9/2016 20:00",227,297,16,0,"Nebel",524,"wolbecker"
"9/9/2016 21:00",164,213,15,0,"Nebel",377,"wolbecker"
"9/9/2016 22:00",162,198,14,0,"Nebel",360,"wolbecker"
"9/9/2016 23:00",168,136,13,0,"Nebel",304,"wolbecker"
"9/10/2016 0:00",130,97,12,0,"Nebel",227,"wolbecker"
"9/10/2016 1:00",122,64,12,0,"Nebel",186,"wolbecker"
"9/10/2016 2:00",71,54,11,0,"Nebel",125,"wolbecker"
"9/10/2016 3:00",55,35,10,0,"Nebel",90,"wolbecker"
"9/10/2016 4:00",26,19,10,0,"Nebel",45,"wolbecker"
"9/10/2016 5:00",49,28,10,0,"Nebel",77,"wolbecker"
"9/10/2016 6:00",39,24,10,0,"Nebel",63,"wolbecker"
"9/10/2016 7:00",95,72,11,0,"Nebel",167,"wolbecker"
"9/10/2016 8:00",163,102,15,0,"Klarer Himmel",265,"wolbecker"
"9/10/2016 9:00",367,158,18,4,"Klarer Himmel",525,"wolbecker"
"9/10/2016 10:00",488,219,21,2,"Klarer Himmel",707,"wolbecker"
"9/10/2016 11:00",527,341,23,4,"Klarer Himmel",868,"wolbecker"
"9/10/2016 12:00",509,403,24,6,"Klarer Himmel",912,"wolbecker"
"9/10/2016 13:00",458,508,26,7,"Klarer Himmel",966,"wolbecker"
"9/10/2016 14:00",391,466,26,9,"Klarer Himmel",857,"wolbecker"
"9/10/2016 15:00",332,405,27,11,"Klarer Himmel",737,"wolbecker"
"9/10/2016 16:00",318,419,26,11,"Klarer Himmel",737,"wolbecker"
"9/10/2016 17:00",317,347,27,11,"Klarer Himmel",664,"wolbecker"
"9/10/2016 18:00",325,372,26,7,"Klarer Himmel",697,"wolbecker"
"9/10/2016 19:00",299,281,23,6,"Klarer Himmel",580,"wolbecker"
"9/10/2016 20:00",219,251,20,4,"Klarer Himmel",470,"wolbecker"
"9/10/2016 21:00",176,175,18,4,"Klarer Himmel",351,"wolbecker"
"9/10/2016 22:00",154,199,17,0,"Klarer Himmel",353,"wolbecker"
"9/10/2016 23:00",116,126,16,0,"Klarer Himmel",242,"wolbecker"
"9/11/2016 0:00",119,110,15,0,"Klarer Himmel",229,"wolbecker"
"9/11/2016 1:00",88,83,15,0,"Klarer Himmel",171,"wolbecker"
"9/11/2016 2:00",57,63,14,0,"Klarer Himmel",120,"wolbecker"
"9/11/2016 3:00",52,42,13,0,"Nebel",94,"wolbecker"
"9/11/2016 4:00",46,22,13,0,"Nebel",68,"wolbecker"
"9/11/2016 5:00",40,19,12,0,"Nebel",59,"wolbecker"
"9/11/2016 6:00",35,14,13,2,"Nebel",49,"wolbecker"
"9/11/2016 7:00",46,35,13,0,"Nebel",81,"wolbecker"
"9/11/2016 8:00",220,65,15,0,"Klarer Himmel",285,"wolbecker"
"9/11/2016 9:00",167,79,18,4,"Klarer Himmel",246,"wolbecker"
"9/11/2016 10:00",230,139,21,0,"Klarer Himmel",369,"wolbecker"
"9/11/2016 11:00",247,178,22,6,"Klarer Himmel",425,"wolbecker"
"9/11/2016 12:00",324,215,23,6,"Klarer Himmel",539,"wolbecker"
"9/11/2016 13:00",279,339,24,6,"wolkig",618,"wolbecker"
"9/11/2016 14:00",274,449,24,6,"wolkig",723,"wolbecker"
"9/11/2016 15:00",243,321,24,6,"wolkig",564,"wolbecker"
"9/11/2016 16:00",283,268,25,6,"wolkig",551,"wolbecker"
"9/11/2016 17:00",273,280,25,6,"wolkig",553,"wolbecker"
"9/11/2016 18:00",289,224,24,4,"wolkig",513,"wolbecker"
"9/11/2016 19:00",257,195,21,0,"Klarer Himmel",452,"wolbecker"
"9/11/2016 20:00",173,135,18,4,"Klarer Himmel",308,"wolbecker"
"9/11/2016 21:00",136,98,17,4,"Klarer Himmel",234,"wolbecker"
"9/11/2016 22:00",105,108,17,4,"Klarer Himmel",213,"wolbecker"
"9/11/2016 23:00",48,39,16,2,"Klarer Himmel",87,"wolbecker"
"9/12/2016 0:00",25,14,16,0,"Klarer Himmel",39,"wolbecker"
"9/12/2016 1:00",13,8,15,0,"Nebel",21,"wolbecker"
"9/12/2016 2:00",6,1,14,0,"Nebel",7,"wolbecker"
"9/12/2016 3:00",1,3,14,4,"Nebel",4,"wolbecker"
"9/12/2016 4:00",7,13,14,2,"Klarer Himmel",20,"wolbecker"
"9/12/2016 5:00",37,49,13,0,"Klarer Himmel",86,"wolbecker"
"9/12/2016 6:00",163,188,13,2,"Nebel",351,"wolbecker"
"9/12/2016 7:00",699,369,13,2,"Klarer Himmel",1068,"wolbecker"
"9/12/2016 8:00",583,289,18,0,"Klarer Himmel",872,"wolbecker"
"9/12/2016 9:00",462,219,21,7,"Klarer Himmel",681,"wolbecker"
"9/12/2016 10:00",346,220,23,6,"teilweise bewölkt",566,"wolbecker"
"9/12/2016 11:00",341,237,25,4,"Klarer Himmel",578,"wolbecker"
"9/12/2016 12:00",336,348,28,4,"Klarer Himmel",684,"wolbecker"
"9/12/2016 13:00",412,433,29,4,"Klarer Himmel",845,"wolbecker"
"9/12/2016 14:00",400,439,30,7,"Klarer Himmel",839,"wolbecker"
"9/12/2016 15:00",379,553,30,6,"Klarer Himmel",932,"wolbecker"
"9/12/2016 16:00",486,601,30,4,"Klarer Himmel",1087,"wolbecker"
"9/12/2016 17:00",527,606,31,2,"Klarer Himmel",1133,"wolbecker"
"9/12/2016 18:00",524,533,28,6,"Klarer Himmel",1057,"wolbecker"
"9/12/2016 19:00",391,418,25,0,"Klarer Himmel",809,"wolbecker"
"9/12/2016 20:00",246,253,22,0,"Klarer Himmel",499,"wolbecker"
"9/12/2016 21:00",204,157,20,0,"Klarer Himmel",361,"wolbecker"
"9/12/2016 22:00",134,97,19,0,"Klarer Himmel",231,"wolbecker"
"9/12/2016 23:00",89,57,18,0,"Klarer Himmel",146,"wolbecker"
"9/13/2016 0:00",23,32,17,0,"Klarer Himmel",55,"wolbecker"
"9/13/2016 1:00",24,20,17,0,"Klarer Himmel",44,"wolbecker"
"9/13/2016 2:00",11,10,17,0,"Klarer Himmel",21,"wolbecker"
"9/13/2016 3:00",2,4,19,4,"Nebel",6,"wolbecker"
"9/13/2016 4:00",4,12,18,0,"Klarer Himmel",16,"wolbecker"
"9/13/2016 5:00",41,42,16,0,"Klarer Himmel",83,"wolbecker"
"9/13/2016 6:00",186,209,18,2,"Klarer Himmel",395,"wolbecker"
"9/13/2016 7:00",713,383,19,2,"Klarer Himmel",1096,"wolbecker"
"9/13/2016 8:00",605,309,22,2,"Klarer Himmel",914,"wolbecker"
"9/13/2016 9:00",446,205,23,7,"Klarer Himmel",651,"wolbecker"
"9/13/2016 10:00",351,200,25,9,"Klarer Himmel",551,"wolbecker"
"9/13/2016 11:00",332,295,28,7,"Klarer Himmel",627,"wolbecker"
"9/13/2016 12:00",345,432,30,7,"Klarer Himmel",777,"wolbecker"
"9/13/2016 13:00",349,425,31,9,"Klarer Himmel",774,"wolbecker"
"9/13/2016 14:00",371,463,32,9,"Klarer Himmel",834,"wolbecker"
"9/13/2016 15:00",384,535,33,9,"Klarer Himmel",919,"wolbecker"
"9/13/2016 16:00",479,579,33,11,"Klarer Himmel",1058,"wolbecker"
"9/13/2016 17:00",611,608,32,6,"Klarer Himmel",1219,"wolbecker"
"9/13/2016 18:00",529,546,31,6,"Klarer Himmel",1075,"wolbecker"
"9/13/2016 19:00",479,433,26,4,"Klarer Himmel",912,"wolbecker"
"9/13/2016 20:00",286,268,24,6,"Klarer Himmel",554,"wolbecker"
"9/13/2016 21:00",220,207,24,6,"Klarer Himmel",427,"wolbecker"
"9/13/2016 22:00",184,138,24,7,"Klarer Himmel",322,"wolbecker"
"9/13/2016 23:00",82,84,21,2,"Klarer Himmel",166,"wolbecker"
"9/14/2016 0:00",48,36,19,6,"Klarer Himmel",84,"wolbecker"
"9/14/2016 1:00",18,20,22,6,"Klarer Himmel",38,"wolbecker"
"9/14/2016 2:00",7,9,22,4,"Klarer Himmel",16,"wolbecker"
"9/14/2016 3:00",5,5,22,6,"Klarer Himmel",10,"wolbecker"
"9/14/2016 4:00",5,8,22,6,"Klarer Himmel",13,"wolbecker"
"9/14/2016 5:00",28,49,21,6,"Klarer Himmel",77,"wolbecker"
"9/14/2016 6:00",171,206,19,6,"Klarer Himmel",377,"wolbecker"
"9/14/2016 7:00",733,406,20,6,"Klarer Himmel",1139,"wolbecker"
"9/14/2016 8:00",614,304,21,4,"Klarer Himmel",918,"wolbecker"
"9/14/2016 9:00",494,230,23,4,"Klarer Himmel",724,"wolbecker"
"9/14/2016 10:00",417,249,26,9,"Klarer Himmel",666,"wolbecker"
"9/14/2016 11:00",391,341,29,9,"Klarer Himmel",732,"wolbecker"
"9/14/2016 12:00",353,464,30,9,"Klarer Himmel",817,"wolbecker"
"9/14/2016 13:00",391,517,31,9,"Klarer Himmel",908,"wolbecker"
"9/14/2016 14:00",370,455,31,6,"Klarer Himmel",825,"wolbecker"
"9/14/2016 15:00",369,534,32,9,"Klarer Himmel",903,"wolbecker"
"9/14/2016 16:00",485,600,32,4,"Klarer Himmel",1085,"wolbecker"
"9/14/2016 17:00",607,539,31,6,"Klarer Himmel",1146,"wolbecker"
"9/14/2016 18:00",585,523,29,4,"Klarer Himmel",1108,"wolbecker"
"9/14/2016 19:00",453,440,27,6,"Klarer Himmel",893,"wolbecker"
"9/14/2016 20:00",317,303,22,6,"Klarer Himmel",620,"wolbecker"
"9/14/2016 21:00",199,196,23,7,"Klarer Himmel",395,"wolbecker"
"9/14/2016 22:00",218,183,24,7,"Klarer Himmel",401,"wolbecker"
"9/14/2016 23:00",121,84,23,6,"Klarer Himmel",205,"wolbecker"
"9/15/2016 0:00",46,56,23,9,"Klarer Himmel",102,"wolbecker"
"9/15/2016 1:00",46,44,22,7,"Klarer Himmel",90,"wolbecker"
"9/15/2016 2:00",12,24,21,9,"Klarer Himmel",36,"wolbecker"
"9/15/2016 3:00",12,10,21,7,"Klarer Himmel",22,"wolbecker"
"9/15/2016 4:00",14,18,19,7,"Klarer Himmel",32,"wolbecker"
"9/15/2016 5:00",36,49,17,6,"Klarer Himmel",85,"wolbecker"
"9/15/2016 6:00",164,216,17,7,"Klarer Himmel",380,"wolbecker"
"9/15/2016 7:00",755,364,18,4,"Klarer Himmel",1119,"wolbecker"
"9/15/2016 8:00",581,276,20,6,"Klarer Himmel",857,"wolbecker"
"9/15/2016 9:00",465,241,22,9,"Klarer Himmel",706,"wolbecker"
"9/15/2016 10:00",326,214,24,11,"Klarer Himmel",540,"wolbecker"
"9/15/2016 11:00",337,306,25,11,"Klarer Himmel",643,"wolbecker"
"9/15/2016 12:00",320,390,27,11,"Klarer Himmel",710,"wolbecker"
"9/15/2016 13:00",422,446,29,13,"Klarer Himmel",868,"wolbecker"
"9/15/2016 14:00",401,446,29,13,"Klarer Himmel",847,"wolbecker"
"9/15/2016 15:00",417,564,29,17,"Klarer Himmel",981,"wolbecker"
"9/15/2016 16:00",519,643,29,13,"Klarer Himmel",1162,"wolbecker"
"9/15/2016 17:00",564,644,28,15,"Klarer Himmel",1208,"wolbecker"
"9/15/2016 18:00",534,518,26,9,"Klarer Himmel",1052,"wolbecker"
"9/15/2016 19:00",478,437,24,7,"Klarer Himmel",915,"wolbecker"
"9/15/2016 20:00",296,249,23,7,"Klarer Himmel",545,"wolbecker"
"9/15/2016 21:00",221,183,24,11,"Klarer Himmel",404,"wolbecker"
"9/15/2016 22:00",172,169,23,7,"Klarer Himmel",341,"wolbecker"
"9/15/2016 23:00",87,86,21,11,"Klarer Himmel",173,"wolbecker"
"9/16/2016 0:00",58,29,22,13,"Klarer Himmel",87,"wolbecker"
"9/16/2016 1:00",22,23,20,15,"Klarer Himmel",45,"wolbecker"
"9/16/2016 2:00",9,11,20,11,"Klarer Himmel",20,"wolbecker"
"9/16/2016 3:00",11,7,19,15,"Regen",18,"wolbecker"
"9/16/2016 4:00",6,11,18,19,"Regen",17,"wolbecker"
"9/16/2016 5:00",28,36,16,13,"Regen",64,"wolbecker"
"9/16/2016 6:00",135,151,16,7,"wolkig",286,"wolbecker"
"9/16/2016 7:00",598,311,15,6,"wolkig",909,"wolbecker"
"9/16/2016 8:00",472,240,16,6,NA,712,"wolbecker"
"9/16/2016 9:00",379,182,18,9,"wolkig",561,"wolbecker"
"9/16/2016 10:00",323,207,18,11,"wolkig",530,"wolbecker"
"9/16/2016 11:00",336,301,19,15,"wolkig",637,"wolbecker"
"9/16/2016 12:00",332,370,20,17,"teilweise bewölkt",702,"wolbecker"
"9/16/2016 13:00",376,460,21,15,"wolkig",836,"wolbecker"
"9/16/2016 14:00",404,497,22,17,"wolkig",901,"wolbecker"
"9/16/2016 15:00",390,443,22,17,"wolkig",833,"wolbecker"
"9/16/2016 16:00",414,484,21,13,"wolkig",898,"wolbecker"
"9/16/2016 17:00",393,501,21,7,"wolkig",894,"wolbecker"
"9/16/2016 18:00",340,445,20,7,"wolkig",785,"wolbecker"
"9/16/2016 19:00",340,403,19,6,"wolkig",743,"wolbecker"
"9/16/2016 20:00",203,236,17,6,"Klarer Himmel",439,"wolbecker"
"9/16/2016 21:00",145,163,17,4,"Klarer Himmel",308,"wolbecker"
"9/16/2016 22:00",133,157,16,2,"Klarer Himmel",290,"wolbecker"
"9/16/2016 23:00",107,130,16,2,"Klarer Himmel",237,"wolbecker"
"9/17/2016 0:00",115,80,16,0,"Klarer Himmel",195,"wolbecker"
"9/17/2016 1:00",77,102,15,4,"Klarer Himmel",179,"wolbecker"
"9/17/2016 2:00",49,60,15,0,"Klarer Himmel",109,"wolbecker"
"9/17/2016 3:00",57,42,15,0,"Klarer Himmel",99,"wolbecker"
"9/17/2016 4:00",40,27,14,0,"Klarer Himmel",67,"wolbecker"
"9/17/2016 5:00",50,27,14,0,"Klarer Himmel",77,"wolbecker"
"9/17/2016 6:00",46,29,14,0,"Klarer Himmel",75,"wolbecker"
"9/17/2016 7:00",121,58,14,0,"Nebel",179,"wolbecker"
"9/17/2016 8:00",170,91,15,0,"wolkig",261,"wolbecker"
"9/17/2016 9:00",341,172,17,2,"Klarer Himmel",513,"wolbecker"
"9/17/2016 10:00",505,190,18,7,"Klarer Himmel",695,"wolbecker"
"9/17/2016 11:00",475,325,18,7,"Regen",800,"wolbecker"
"9/17/2016 12:00",384,359,18,11,"Regen",743,"wolbecker"
"9/17/2016 13:00",334,423,19,11,"Regen",757,"wolbecker"
"9/17/2016 14:00",281,434,19,9,"Regen",715,"wolbecker"
"9/17/2016 15:00",252,388,19,9,"Regen",640,"wolbecker"
"9/17/2016 16:00",234,365,19,11,"wolkig",599,"wolbecker"
"9/17/2016 17:00",249,294,19,7,"wolkig",543,"wolbecker"
"9/17/2016 18:00",231,291,19,6,"wolkig",522,"wolbecker"
"9/17/2016 19:00",234,282,19,2,"wolkig",516,"wolbecker"
"9/17/2016 20:00",147,182,18,7,"Klarer Himmel",329,"wolbecker"
"9/17/2016 21:00",133,116,18,9,"wolkig",249,"wolbecker"
"9/17/2016 22:00",115,82,18,13,"Klarer Himmel",197,"wolbecker"
"9/17/2016 23:00",93,99,17,7,"Klarer Himmel",192,"wolbecker"
"9/18/2016 0:00",88,73,17,15,"Klarer Himmel",161,"wolbecker"
"9/18/2016 1:00",76,107,16,11,"wolkig",183,"wolbecker"
"9/18/2016 2:00",61,62,16,19,"wolkig",123,"wolbecker"
"9/18/2016 3:00",67,38,16,17,"wolkig",105,"wolbecker"
"9/18/2016 4:00",53,29,16,17,"wolkig",82,"wolbecker"
"9/18/2016 5:00",26,12,16,15,"wolkig",38,"wolbecker"
"9/18/2016 6:00",33,16,15,11,"wolkig",49,"wolbecker"
"9/18/2016 7:00",30,27,15,11,"wolkig",57,"wolbecker"
"9/18/2016 8:00",39,35,14,17,"wolkig",74,"wolbecker"
"9/18/2016 9:00",111,57,15,17,NA,168,"wolbecker"
"9/18/2016 10:00",166,102,16,15,"wolkig",268,"wolbecker"
"9/18/2016 11:00",175,119,17,17,"teilweise bewölkt",294,"wolbecker"
"9/18/2016 12:00",159,179,19,9,"teilweise bewölkt",338,"wolbecker"
"9/18/2016 13:00",205,173,19,13,"teilweise bewölkt",378,"wolbecker"
"9/18/2016 14:00",206,198,19,13,"teilweise bewölkt",404,"wolbecker"
"9/18/2016 15:00",254,236,19,19,"teilweise bewölkt",490,"wolbecker"
"9/18/2016 16:00",250,222,20,15,"Klarer Himmel",472,"wolbecker"
"9/18/2016 17:00",281,269,19,11,"Klarer Himmel",550,"wolbecker"
"9/18/2016 18:00",237,208,18,11,"Klarer Himmel",445,"wolbecker"
"9/18/2016 19:00",206,154,18,13,"Klarer Himmel",360,"wolbecker"
"9/18/2016 20:00",169,101,17,11,"Klarer Himmel",270,"wolbecker"
"9/18/2016 21:00",88,76,17,13,"Klarer Himmel",164,"wolbecker"
"9/18/2016 22:00",79,61,16,11,"Klarer Himmel",140,"wolbecker"
"9/18/2016 23:00",50,37,16,11,"Klarer Himmel",87,"wolbecker"
"9/19/2016 0:00",32,25,15,11,"Klarer Himmel",57,"wolbecker"
"9/19/2016 1:00",10,13,15,9,"Klarer Himmel",23,"wolbecker"
"9/19/2016 2:00",4,1,15,9,"Klarer Himmel",5,"wolbecker"
"9/19/2016 3:00",1,1,15,9,"Klarer Himmel",2,"wolbecker"
"9/19/2016 4:00",8,12,14,9,"Klarer Himmel",20,"wolbecker"
"9/19/2016 5:00",32,45,14,11,"Klarer Himmel",77,"wolbecker"
"9/19/2016 6:00",141,188,14,15,"Klarer Himmel",329,"wolbecker"
"9/19/2016 7:00",700,344,12,13,"Klarer Himmel",1044,"wolbecker"
"9/19/2016 8:00",565,281,14,11,"Klarer Himmel",846,"wolbecker"
"9/19/2016 9:00",452,218,15,19,"Klarer Himmel",670,"wolbecker"
"9/19/2016 10:00",327,226,16,17,"Klarer Himmel",553,"wolbecker"
"9/19/2016 11:00",340,271,16,15,"teilweise bewölkt",611,"wolbecker"
"9/19/2016 12:00",324,342,17,9,"teilweise bewölkt",666,"wolbecker"
"9/19/2016 13:00",369,411,17,6,"teilweise bewölkt",780,"wolbecker"
"9/19/2016 14:00",414,368,18,9,"teilweise bewölkt",782,"wolbecker"
"9/19/2016 15:00",383,448,18,6,"wolkig",831,"wolbecker"
"9/19/2016 16:00",441,533,18,4,"wolkig",974,"wolbecker"
"9/19/2016 17:00",534,584,17,2,"wolkig",1118,"wolbecker"
"9/19/2016 18:00",395,545,17,9,"teilweise bewölkt",940,"wolbecker"
"9/19/2016 19:00",365,421,16,4,"teilweise bewölkt",786,"wolbecker"
"9/19/2016 20:00",201,234,15,0,"teilweise bewölkt",435,"wolbecker"
"9/19/2016 21:00",158,162,14,0,"Klarer Himmel",320,"wolbecker"
"9/19/2016 22:00",122,95,14,0,"Klarer Himmel",217,"wolbecker"
"9/19/2016 23:00",66,47,14,0,"Klarer Himmel",113,"wolbecker"
"9/20/2016 0:00",30,38,14,4,"Klarer Himmel",68,"wolbecker"
"9/20/2016 1:00",11,24,14,0,"Klarer Himmel",35,"wolbecker"
"9/20/2016 2:00",9,13,13,0,"Klarer Himmel",22,"wolbecker"
"9/20/2016 3:00",2,4,13,0,"Klarer Himmel",6,"wolbecker"
"9/20/2016 4:00",6,10,13,0,"Klarer Himmel",16,"wolbecker"
"9/20/2016 5:00",31,59,13,0,"wolkig",90,"wolbecker"
"9/20/2016 6:00",160,212,13,0,"Klarer Himmel",372,"wolbecker"
"9/20/2016 7:00",700,345,13,0,"Klarer Himmel",1045,"wolbecker"
"9/20/2016 8:00",616,306,14,0,"Klarer Himmel",922,"wolbecker"
"9/20/2016 9:00",446,194,14,4,"Klarer Himmel",640,"wolbecker"
"9/20/2016 10:00",314,175,15,4,"Klarer Himmel",489,"wolbecker"
"9/20/2016 11:00",339,246,16,6,"Klarer Himmel",585,"wolbecker"
"9/20/2016 12:00",343,356,17,7,"wolkig",699,"wolbecker"
"9/20/2016 13:00",378,398,18,9,"wolkig",776,"wolbecker"
"9/20/2016 14:00",377,415,18,9,"wolkig",792,"wolbecker"
"9/20/2016 15:00",434,460,18,6,"wolkig",894,"wolbecker"
"9/20/2016 16:00",484,532,19,0,"wolkig",1016,"wolbecker"
"9/20/2016 17:00",543,615,18,2,"wolkig",1158,"wolbecker"
"9/20/2016 18:00",451,565,17,0,"Klarer Himmel",1016,"wolbecker"
"9/20/2016 19:00",366,435,16,0,"Klarer Himmel",801,"wolbecker"
"9/20/2016 20:00",205,217,16,4,"Klarer Himmel",422,"wolbecker"
"9/20/2016 21:00",183,165,15,6,"Klarer Himmel",348,"wolbecker"
"9/20/2016 22:00",167,141,14,4,"Klarer Himmel",308,"wolbecker"
"9/20/2016 23:00",63,67,13,4,"Klarer Himmel",130,"wolbecker"
"9/21/2016 0:00",26,38,11,2,"Klarer Himmel",64,"wolbecker"
"9/21/2016 1:00",13,21,9,0,"Klarer Himmel",34,"wolbecker"
"9/21/2016 2:00",8,15,8,0,"Klarer Himmel",23,"wolbecker"
"9/21/2016 3:00",3,4,7,0,"Klarer Himmel",7,"wolbecker"
"9/21/2016 4:00",7,10,7,0,"Nebel",17,"wolbecker"
"9/21/2016 5:00",32,45,6,0,"Nebel",77,"wolbecker"
"9/21/2016 6:00",162,207,6,0,"Nebel",369,"wolbecker"
"9/21/2016 7:00",689,369,6,0,"Nebel",1058,"wolbecker"
"9/21/2016 8:00",650,323,10,0,"Klarer Himmel",973,"wolbecker"
"9/21/2016 9:00",464,208,14,2,"Klarer Himmel",672,"wolbecker"
"9/21/2016 10:00",410,227,17,4,"wolkig",637,"wolbecker"
"9/21/2016 11:00",394,302,18,7,"wolkig",696,"wolbecker"
"9/21/2016 12:00",412,426,19,9,"Klarer Himmel",838,"wolbecker"
"9/21/2016 13:00",398,439,19,7,"Klarer Himmel",837,"wolbecker"
"9/21/2016 14:00",393,420,20,7,"Klarer Himmel",813,"wolbecker"
"9/21/2016 15:00",456,480,21,7,"Klarer Himmel",936,"wolbecker"
"9/21/2016 16:00",436,579,20,6,"Klarer Himmel",1015,"wolbecker"
"9/21/2016 17:00",531,584,20,6,"Klarer Himmel",1115,"wolbecker"
"9/21/2016 18:00",421,539,18,4,"Klarer Himmel",960,"wolbecker"
"9/21/2016 19:00",357,446,15,6,"Klarer Himmel",803,"wolbecker"
"9/21/2016 20:00",243,235,12,0,"Klarer Himmel",478,"wolbecker"
"9/21/2016 21:00",187,157,11,4,"Klarer Himmel",344,"wolbecker"
"9/21/2016 22:00",161,141,10,0,"Klarer Himmel",302,"wolbecker"
"9/21/2016 23:00",73,91,10,4,"Klarer Himmel",164,"wolbecker"
"9/22/2016 0:00",43,61,8,0,"Klarer Himmel",104,"wolbecker"
"9/22/2016 1:00",25,30,8,0,"Klarer Himmel",55,"wolbecker"
"9/22/2016 2:00",24,14,8,0,"Klarer Himmel",38,"wolbecker"
"9/22/2016 3:00",16,15,8,4,"Klarer Himmel",31,"wolbecker"
"9/22/2016 4:00",13,12,8,2,"Klarer Himmel",25,"wolbecker"
"9/22/2016 5:00",35,61,7,2,NA,96,"wolbecker"
"9/22/2016 6:00",152,195,7,4,"Nebel",347,"wolbecker"
"9/22/2016 7:00",676,344,8,2,"Nebel",1020,"wolbecker"
"9/22/2016 8:00",564,280,9,2,"Klarer Himmel",844,"wolbecker"
"9/22/2016 9:00",479,207,13,6,"Klarer Himmel",686,"wolbecker"
"9/22/2016 10:00",334,216,16,7,"Klarer Himmel",550,"wolbecker"
"9/22/2016 11:00",358,248,18,9,"Klarer Himmel",606,"wolbecker"
"9/22/2016 12:00",322,366,20,13,"Klarer Himmel",688,"wolbecker"
"9/22/2016 13:00",378,417,20,9,"Klarer Himmel",795,"wolbecker"
"9/22/2016 14:00",405,448,21,11,"Klarer Himmel",853,"wolbecker"
"9/22/2016 15:00",466,512,22,9,"Klarer Himmel",978,"wolbecker"
"9/22/2016 16:00",495,586,21,9,"Klarer Himmel",1081,"wolbecker"
"9/22/2016 17:00",544,622,20,9,"Klarer Himmel",1166,"wolbecker"
"9/22/2016 18:00",465,550,17,2,"Klarer Himmel",1015,"wolbecker"
"9/22/2016 19:00",372,371,16,0,"Klarer Himmel",743,"wolbecker"
"9/22/2016 20:00",185,256,13,0,"Klarer Himmel",441,"wolbecker"
"9/22/2016 21:00",160,146,13,0,"Klarer Himmel",306,"wolbecker"
"9/22/2016 22:00",121,142,12,0,"Klarer Himmel",263,"wolbecker"
"9/22/2016 23:00",91,74,12,0,"Klarer Himmel",165,"wolbecker"
"9/23/2016 0:00",40,32,11,0,"Klarer Himmel",72,"wolbecker"
"9/23/2016 1:00",19,29,10,0,NA,48,"wolbecker"
"9/23/2016 2:00",6,13,9,0,"Nebel",19,"wolbecker"
"9/23/2016 3:00",2,8,9,0,"Nebel",10,"wolbecker"
"9/23/2016 4:00",9,11,9,0,"Nebel",20,"wolbecker"
"9/23/2016 5:00",34,51,10,2,"Nebel",85,"wolbecker"
"9/23/2016 6:00",140,174,9,2,"Nebel",314,"wolbecker"
"9/23/2016 7:00",588,366,9,0,"Nebel",954,"wolbecker"
"9/23/2016 8:00",544,250,11,6,"Klarer Himmel",794,"wolbecker"
"9/23/2016 9:00",346,181,14,6,"Klarer Himmel",527,"wolbecker"
"9/23/2016 10:00",331,206,15,4,"Regen",537,"wolbecker"
"9/23/2016 11:00",357,287,16,2,"wolkig",644,"wolbecker"
"9/23/2016 12:00",353,354,19,11,"teilweise bewölkt",707,"wolbecker"
"9/23/2016 13:00",399,489,21,13,"teilweise bewölkt",888,"wolbecker"
"9/23/2016 14:00",462,465,21,17,"teilweise bewölkt",927,"wolbecker"
"9/23/2016 15:00",423,526,20,15,"teilweise bewölkt",949,"wolbecker"
"9/23/2016 16:00",396,476,21,13,"teilweise bewölkt",872,"wolbecker"
"9/23/2016 17:00",406,482,21,19,"teilweise bewölkt",888,"wolbecker"
"9/23/2016 18:00",371,468,19,17,"teilweise bewölkt",839,"wolbecker"
"9/23/2016 19:00",276,410,16,6,"Klarer Himmel",686,"wolbecker"
"9/23/2016 20:00",184,277,13,2,"Klarer Himmel",461,"wolbecker"
"9/23/2016 21:00",171,163,11,0,"Klarer Himmel",334,"wolbecker"
"9/23/2016 22:00",183,134,10,0,"Klarer Himmel",317,"wolbecker"
"9/23/2016 23:00",152,117,9,0,"Nebel",269,"wolbecker"
"9/24/2016 0:00",151,103,8,0,"Nebel",254,"wolbecker"
"9/24/2016 1:00",148,72,7,0,"Nebel",220,"wolbecker"
"9/24/2016 2:00",83,48,7,0,"Nebel",131,"wolbecker"
"9/24/2016 3:00",49,44,7,0,"Nebel",93,"wolbecker"
"9/24/2016 4:00",29,19,7,4,"Nebel",48,"wolbecker"
"9/24/2016 5:00",47,25,7,2,"Nebel",72,"wolbecker"
"9/24/2016 6:00",35,26,8,6,"Nebel",61,"wolbecker"
"9/24/2016 7:00",80,65,9,4,"Klarer Himmel",145,"wolbecker"
"9/24/2016 8:00",146,90,10,6,"teilweise bewölkt",236,"wolbecker"
"9/24/2016 9:00",292,168,12,6,"teilweise bewölkt",460,"wolbecker"
"9/24/2016 10:00",446,194,15,9,"Klarer Himmel",640,"wolbecker"
"9/24/2016 11:00",506,261,18,11,"Klarer Himmel",767,"wolbecker"
"9/24/2016 12:00",484,353,21,11,NA,837,"wolbecker"
"9/24/2016 13:00",426,415,23,15,"Klarer Himmel",841,"wolbecker"
"9/24/2016 14:00",373,475,23,15,"Klarer Himmel",848,"wolbecker"
"9/24/2016 15:00",362,422,24,9,"Klarer Himmel",784,"wolbecker"
"9/24/2016 16:00",292,399,23,9,"Klarer Himmel",691,"wolbecker"
"9/24/2016 17:00",256,392,23,7,"Klarer Himmel",648,"wolbecker"
"9/24/2016 18:00",258,401,19,4,"Klarer Himmel",659,"wolbecker"
"9/24/2016 19:00",239,339,15,2,"Klarer Himmel",578,"wolbecker"
"9/24/2016 20:00",208,259,13,0,"Klarer Himmel",467,"wolbecker"
"9/24/2016 21:00",140,163,13,4,"Klarer Himmel",303,"wolbecker"
"9/24/2016 22:00",158,100,15,7,"Klarer Himmel",258,"wolbecker"
"9/24/2016 23:00",183,102,14,6,"Klarer Himmel",285,"wolbecker"
"9/25/2016 0:00",182,119,12,6,"Klarer Himmel",301,"wolbecker"
"9/25/2016 1:00",125,83,12,4,"Klarer Himmel",208,"wolbecker"
"9/25/2016 2:00",90,58,12,4,"Klarer Himmel",148,"wolbecker"
"9/25/2016 3:00",73,52,12,6,"Klarer Himmel",125,"wolbecker"
"9/25/2016 4:00",52,21,11,7,"Klarer Himmel",73,"wolbecker"
"9/25/2016 5:00",54,18,11,7,"Klarer Himmel",72,"wolbecker"
"9/25/2016 6:00",35,18,10,4,"Klarer Himmel",53,"wolbecker"
"9/25/2016 7:00",23,32,10,7,"Klarer Himmel",55,"wolbecker"
"9/25/2016 8:00",34,54,12,7,"Klarer Himmel",88,"wolbecker"
"9/25/2016 9:00",130,82,15,13,"Klarer Himmel",212,"wolbecker"
"9/25/2016 10:00",183,133,18,15,"Klarer Himmel",316,"wolbecker"
"9/25/2016 11:00",221,148,22,11,"Klarer Himmel",369,"wolbecker"
"9/25/2016 12:00",195,202,23,13,"Klarer Himmel",397,"wolbecker"
"9/25/2016 13:00",278,253,25,17,"Klarer Himmel",531,"wolbecker"
"9/25/2016 14:00",287,280,26,11,"Klarer Himmel",567,"wolbecker"
"9/25/2016 15:00",311,285,27,13,"Klarer Himmel",596,"wolbecker"
"9/25/2016 16:00",270,257,27,20,"Klarer Himmel",527,"wolbecker"
"9/25/2016 17:00",290,279,26,13,"Klarer Himmel",569,"wolbecker"
"9/25/2016 18:00",290,244,22,6,"Klarer Himmel",534,"wolbecker"
"9/25/2016 19:00",270,204,18,0,"Klarer Himmel",474,"wolbecker"
"9/25/2016 20:00",173,139,21,24,"Klarer Himmel",312,"wolbecker"
"9/25/2016 21:00",118,70,18,20,"Klarer Himmel",188,"wolbecker"
"9/25/2016 22:00",95,61,17,11,"Klarer Himmel",156,"wolbecker"
"9/25/2016 23:00",36,29,17,9,"Klarer Himmel",65,"wolbecker"
"9/26/2016 0:00",30,20,16,11,"Klarer Himmel",50,"wolbecker"
"9/26/2016 1:00",6,6,15,7,"Klarer Himmel",12,"wolbecker"
"9/26/2016 2:00",6,5,14,6,"wolkig",11,"wolbecker"
"9/26/2016 3:00",0,4,14,4,"wolkig",4,"wolbecker"
"9/26/2016 4:00",6,8,14,4,"wolkig",14,"wolbecker"
"9/26/2016 5:00",38,41,14,6,"Klarer Himmel",79,"wolbecker"
"9/26/2016 6:00",165,186,13,6,"Klarer Himmel",351,"wolbecker"
"9/26/2016 7:00",684,347,12,4,"Nebel",1031,"wolbecker"
"9/26/2016 8:00",564,300,13,0,"Klarer Himmel",864,"wolbecker"
"9/26/2016 9:00",427,221,14,6,"Klarer Himmel",648,"wolbecker"
"9/26/2016 10:00",364,210,17,4,"Klarer Himmel",574,"wolbecker"
"9/26/2016 11:00",344,271,19,7,"Klarer Himmel",615,"wolbecker"
"9/26/2016 12:00",362,318,20,2,NA,680,"wolbecker"
"9/26/2016 13:00",377,409,20,7,"teilweise bewölkt",786,"wolbecker"
"9/26/2016 14:00",367,391,21,7,"Klarer Himmel",758,"wolbecker"
"9/26/2016 15:00",409,473,21,7,"Klarer Himmel",882,"wolbecker"
"9/26/2016 16:00",465,593,21,6,"Klarer Himmel",1058,"wolbecker"
"9/26/2016 17:00",550,596,20,7,"Klarer Himmel",1146,"wolbecker"
"9/26/2016 18:00",457,506,16,0,"Klarer Himmel",963,"wolbecker"
"9/26/2016 19:00",328,409,15,4,"Klarer Himmel",737,"wolbecker"
"9/26/2016 20:00",211,206,15,2,"Klarer Himmel",417,"wolbecker"
"9/26/2016 21:00",170,137,13,0,"Klarer Himmel",307,"wolbecker"
"9/26/2016 22:00",147,112,11,0,"Klarer Himmel",259,"wolbecker"
"9/26/2016 23:00",63,51,10,0,"Klarer Himmel",114,"wolbecker"
"9/27/2016 0:00",44,33,10,0,"Klarer Himmel",77,"wolbecker"
"9/27/2016 1:00",19,17,10,0,"Klarer Himmel",36,"wolbecker"
"9/27/2016 2:00",5,13,9,0,"Klarer Himmel",18,"wolbecker"
"9/27/2016 3:00",1,3,9,0,"Klarer Himmel",4,"wolbecker"
"9/27/2016 4:00",5,6,8,4,"Klarer Himmel",11,"wolbecker"
"9/27/2016 5:00",46,38,8,0,"Nebel",84,"wolbecker"
"9/27/2016 6:00",161,204,7,0,NA,365,"wolbecker"
"9/27/2016 7:00",668,385,7,0,NA,1053,"wolbecker"
"9/27/2016 8:00",616,316,9,0,"Klarer Himmel",932,"wolbecker"
"9/27/2016 9:00",529,212,14,0,"Klarer Himmel",741,"wolbecker"
"9/27/2016 10:00",332,209,16,7,"Klarer Himmel",541,"wolbecker"
"9/27/2016 11:00",333,255,19,6,"teilweise bewölkt",588,"wolbecker"
"9/27/2016 12:00",337,382,20,7,"teilweise bewölkt",719,"wolbecker"
"9/27/2016 13:00",382,363,21,9,"teilweise bewölkt",745,"wolbecker"
"9/27/2016 14:00",420,408,22,11,"teilweise bewölkt",828,"wolbecker"
"9/27/2016 15:00",446,477,22,13,"Klarer Himmel",923,"wolbecker"
"9/27/2016 16:00",478,608,22,11,"Klarer Himmel",1086,"wolbecker"
"9/27/2016 17:00",570,586,22,13,"Klarer Himmel",1156,"wolbecker"
"9/27/2016 18:00",485,584,20,7,"Klarer Himmel",1069,"wolbecker"
"9/27/2016 19:00",372,450,14,6,"Klarer Himmel",822,"wolbecker"
"9/27/2016 20:00",270,225,13,2,"Klarer Himmel",495,"wolbecker"
"9/27/2016 21:00",178,155,12,0,"Klarer Himmel",333,"wolbecker"
"9/27/2016 22:00",179,148,12,7,"Klarer Himmel",327,"wolbecker"
"9/27/2016 23:00",89,94,13,7,"Klarer Himmel",183,"wolbecker"
"9/28/2016 0:00",54,47,13,7,"Klarer Himmel",101,"wolbecker"
"9/28/2016 1:00",18,21,13,7,"Klarer Himmel",39,"wolbecker"
"9/28/2016 2:00",6,6,14,11,"wolkig",12,"wolbecker"
"9/28/2016 3:00",2,15,15,13,"wolkig",17,"wolbecker"
"9/28/2016 4:00",7,10,15,11,"wolkig",17,"wolbecker"
"9/28/2016 5:00",42,40,15,17,"teilweise bewölkt",82,"wolbecker"
"9/28/2016 6:00",161,189,15,11,"wolkig",350,"wolbecker"
"9/28/2016 7:00",640,369,16,13,"teilweise bewölkt",1009,"wolbecker"
"9/28/2016 8:00",634,317,16,19,"wolkig",951,"wolbecker"
"9/28/2016 9:00",408,218,17,19,"wolkig",626,"wolbecker"
"9/28/2016 10:00",410,234,18,24,"wolkig",644,"wolbecker"
"9/28/2016 11:00",381,309,19,26,"wolkig",690,"wolbecker"
"9/28/2016 12:00",401,346,20,28,"wolkig",747,"wolbecker"
"9/28/2016 13:00",443,430,20,32,"wolkig",873,"wolbecker"
"9/28/2016 14:00",337,431,21,24,"wolkig",768,"wolbecker"
"9/28/2016 15:00",417,474,21,24,"wolkig",891,"wolbecker"
"9/28/2016 16:00",450,537,21,28,"Klarer Himmel",987,"wolbecker"
"9/28/2016 17:00",568,590,22,26,"Klarer Himmel",1158,"wolbecker"
"9/28/2016 18:00",441,544,21,19,"Klarer Himmel",985,"wolbecker"
"9/28/2016 19:00",367,428,20,19,"Klarer Himmel",795,"wolbecker"
"9/28/2016 20:00",188,240,20,13,"wolkig",428,"wolbecker"
"9/28/2016 21:00",163,194,20,13,"wolkig",357,"wolbecker"
"9/28/2016 22:00",149,120,19,15,"Klarer Himmel",269,"wolbecker"
"9/28/2016 23:00",101,108,19,17,"wolkig",209,"wolbecker"
"9/29/2016 0:00",70,44,19,19,"wolkig",114,"wolbecker"
"9/29/2016 1:00",40,39,19,17,"wolkig",79,"wolbecker"
"9/29/2016 2:00",24,25,19,22,"wolkig",49,"wolbecker"
"9/29/2016 3:00",15,21,19,20,"Klarer Himmel",36,"wolbecker"
"9/29/2016 4:00",12,14,18,20,"wolkig",26,"wolbecker"
"9/29/2016 5:00",40,50,18,20,"wolkig",90,"wolbecker"
"9/29/2016 6:00",138,188,18,20,"wolkig",326,"wolbecker"
"9/29/2016 7:00",639,373,17,20,"Klarer Himmel",1012,"wolbecker"
"9/29/2016 8:00",560,308,18,22,"Klarer Himmel",868,"wolbecker"
"9/29/2016 9:00",454,202,18,20,"Klarer Himmel",656,"wolbecker"
"9/29/2016 10:00",342,202,20,26,"wolkig",544,"wolbecker"
"9/29/2016 11:00",341,269,20,30,"wolkig",610,"wolbecker"
"9/29/2016 12:00",361,341,21,37,"wolkig",702,"wolbecker"
"9/29/2016 13:00",351,424,21,33,"wolkig",775,"wolbecker"
"9/29/2016 14:00",363,400,20,28,"wolkig",763,"wolbecker"
"9/29/2016 15:00",420,499,21,32,"wolkig",919,"wolbecker"
"9/29/2016 16:00",472,558,20,28,"wolkig",1030,"wolbecker"
"9/29/2016 17:00",520,586,20,33,"wolkig",1106,"wolbecker"
"9/29/2016 18:00",455,494,20,30,"wolkig",949,"wolbecker"
"9/29/2016 19:00",320,394,19,26,"wolkig",714,"wolbecker"
"9/29/2016 20:00",196,216,18,39,"Regen",412,"wolbecker"
"9/29/2016 21:00",159,126,16,26,"Regen",285,"wolbecker"
"9/29/2016 22:00",145,127,15,19,"wolkig",272,"wolbecker"
"9/29/2016 23:00",86,57,15,19,"Regen",143,"wolbecker"
"9/30/2016 0:00",36,31,15,15,"Regen",67,"wolbecker"
"9/30/2016 1:00",20,23,15,13,"wolkig",43,"wolbecker"
"9/30/2016 2:00",7,19,14,13,"wolkig",26,"wolbecker"
"9/30/2016 3:00",1,7,14,7,"wolkig",8,"wolbecker"
"9/30/2016 4:00",6,8,14,9,"wolkig",14,"wolbecker"
"9/30/2016 5:00",32,37,14,9,"wolkig",69,"wolbecker"
"9/30/2016 6:00",119,168,14,9,"wolkig",287,"wolbecker"
"9/30/2016 7:00",597,286,13,7,NA,883,"wolbecker"
"9/30/2016 8:00",459,232,14,9,"wolkig",691,"wolbecker"
"9/30/2016 9:00",380,179,15,15,"wolkig",559,"wolbecker"
"9/30/2016 10:00",337,218,15,15,"wolkig",555,"wolbecker"
"9/30/2016 11:00",353,298,16,17,"wolkig",651,"wolbecker"
"9/30/2016 12:00",409,361,16,20,"wolkig",770,"wolbecker"
"9/30/2016 13:00",431,505,17,24,"wolkig",936,"wolbecker"
"9/30/2016 14:00",441,488,18,24,"wolkig",929,"wolbecker"
"9/30/2016 15:00",388,470,19,24,"teilweise bewölkt",858,"wolbecker"
"9/30/2016 16:00",415,449,18,28,"Klarer Himmel",864,"wolbecker"
"9/30/2016 17:00",433,435,18,17,"Klarer Himmel",868,"wolbecker"
"9/30/2016 18:00",328,466,17,9,"Klarer Himmel",794,"wolbecker"
"9/30/2016 19:00",303,341,13,7,"Klarer Himmel",644,"wolbecker"
"9/30/2016 20:00",194,228,11,2,"Klarer Himmel",422,"wolbecker"
"9/30/2016 21:00",154,139,9,0,"Klarer Himmel",293,"wolbecker"
"9/30/2016 22:00",172,126,8,0,"Klarer Himmel",298,"wolbecker"
"9/30/2016 23:00",130,126,9,4,"Klarer Himmel",256,"wolbecker"
"10/1/2016 0:00",95,61,9,2,"Klarer Himmel",156,"wolbecker"
"10/1/2016 1:00",88,78,10,4,"Klarer Himmel",166,"wolbecker"
"10/1/2016 2:00",63,58,10,6,"Klarer Himmel",121,"wolbecker"
"10/1/2016 3:00",38,29,10,6,"Regen",67,"wolbecker"
"10/1/2016 4:00",35,18,10,2,"Regen",53,"wolbecker"
"10/1/2016 5:00",49,26,10,4,"wolkig",75,"wolbecker"
"10/1/2016 6:00",36,27,11,2,"wolkig",63,"wolbecker"
"10/1/2016 7:00",66,38,11,6,"wolkig",104,"wolbecker"
"10/1/2016 8:00",122,76,11,6,"wolkig",198,"wolbecker"
"10/1/2016 9:00",289,134,12,6,"wolkig",423,"wolbecker"
"10/1/2016 10:00",408,163,13,7,"Regen",571,"wolbecker"
"10/1/2016 11:00",395,256,14,7,"Regen",651,"wolbecker"
"10/1/2016 12:00",387,300,15,11,"wolkig",687,"wolbecker"
"10/1/2016 13:00",366,348,16,7,"wolkig",714,"wolbecker"
"10/1/2016 14:00",368,422,16,6,"wolkig",790,"wolbecker"
"10/1/2016 15:00",277,387,16,6,"wolkig",664,"wolbecker"
"10/1/2016 16:00",280,369,16,7,"wolkig",649,"wolbecker"
"10/1/2016 17:00",244,325,16,7,"wolkig",569,"wolbecker"
"10/1/2016 18:00",234,375,16,7,"wolkig",609,"wolbecker"
"10/1/2016 19:00",198,244,13,6,"teilweise bewölkt",442,"wolbecker"
"10/1/2016 20:00",132,183,12,7,"Klarer Himmel",315,"wolbecker"
"10/1/2016 21:00",116,119,11,4,"wolkig",235,"wolbecker"
"10/1/2016 22:00",100,71,11,6,"Regen",171,"wolbecker"
"10/1/2016 23:00",107,91,11,7,"wolkig",198,"wolbecker"
"10/2/2016 0:00",126,69,11,7,"Regen",195,"wolbecker"
"10/2/2016 1:00",78,53,11,7,NA,131,"wolbecker"
"10/2/2016 2:00",42,39,11,13,NA,81,"wolbecker"
"10/2/2016 3:00",40,24,11,11,"Klarer Himmel",64,"wolbecker"
"10/2/2016 4:00",36,15,10,11,"Klarer Himmel",51,"wolbecker"
"10/2/2016 5:00",31,17,10,6,"Klarer Himmel",48,"wolbecker"
"10/2/2016 6:00",23,10,9,9,"Klarer Himmel",33,"wolbecker"
"10/2/2016 7:00",25,27,9,11,"teilweise bewölkt",52,"wolbecker"
"10/2/2016 8:00",39,33,11,11,"teilweise bewölkt",72,"wolbecker"
"10/2/2016 9:00",90,81,12,17,"teilweise bewölkt",171,"wolbecker"
"10/2/2016 10:00",148,100,13,19,"wolkig",248,"wolbecker"
"10/2/2016 11:00",124,114,12,17,"Regen",238,"wolbecker"
"10/2/2016 12:00",140,134,12,17,"wolkig",274,"wolbecker"
"10/2/2016 13:00",127,122,12,13,"wolkig",249,"wolbecker"
"10/2/2016 14:00",147,130,13,19,"wolkig",277,"wolbecker"
"10/2/2016 15:00",166,142,14,15,"wolkig",308,"wolbecker"
"10/2/2016 16:00",179,162,14,17,"wolkig",341,"wolbecker"
"10/2/2016 17:00",192,169,14,17,"Regen",361,"wolbecker"
"10/2/2016 18:00",162,139,12,17,"Regen",301,"wolbecker"
"10/2/2016 19:00",123,170,12,15,"wolkig",293,"wolbecker"
"10/2/2016 20:00",111,89,12,13,"Regen",200,"wolbecker"
"10/2/2016 21:00",80,92,12,13,"Regen",172,"wolbecker"
"10/2/2016 22:00",86,49,12,13,"wolkig",135,"wolbecker"
"10/2/2016 23:00",69,54,13,11,"Regen",123,"wolbecker"
"10/3/2016 0:00",70,61,12,13,"wolkig",131,"wolbecker"
"10/3/2016 1:00",52,35,11,17,"wolkig",87,"wolbecker"
"10/3/2016 2:00",33,28,9,9,"teilweise bewölkt",61,"wolbecker"
"10/3/2016 3:00",14,16,9,6,"wolkig",30,"wolbecker"
"10/3/2016 4:00",18,11,10,6,"wolkig",29,"wolbecker"
"10/3/2016 5:00",31,14,10,4,"wolkig",45,"wolbecker"
"10/3/2016 6:00",27,11,10,9,"wolkig",38,"wolbecker"
"10/3/2016 7:00",78,23,10,0,"Nebel",101,"wolbecker"
"10/3/2016 8:00",47,48,11,2,"wolkig",95,"wolbecker"
"10/3/2016 9:00",133,69,11,4,"wolkig",202,"wolbecker"
"10/3/2016 10:00",140,120,12,9,"wolkig",260,"wolbecker"
"10/3/2016 11:00",177,170,13,9,"wolkig",347,"wolbecker"
"10/3/2016 12:00",241,193,15,9,"teilweise bewölkt",434,"wolbecker"
"10/3/2016 13:00",292,174,16,11,"teilweise bewölkt",466,"wolbecker"
"10/3/2016 14:00",272,262,16,7,"wolkig",534,"wolbecker"
"10/3/2016 15:00",290,251,14,2,"Regen",541,"wolbecker"
"10/3/2016 16:00",189,277,13,7,"Regen",466,"wolbecker"
"10/3/2016 17:00",171,273,13,4,"wolkig",444,"wolbecker"
"10/3/2016 18:00",171,188,13,2,"Regen",359,"wolbecker"
"10/3/2016 19:00",135,134,12,2,"Nebel",269,"wolbecker"
"10/3/2016 20:00",139,86,10,6,"Nebel",225,"wolbecker"
"10/3/2016 21:00",100,52,9,4,"Nebel",152,"wolbecker"
"10/3/2016 22:00",81,45,9,0,"Nebel",126,"wolbecker"
"10/3/2016 23:00",45,31,10,0,"Nebel",76,"wolbecker"
"10/4/2016 0:00",21,16,11,9,"wolkig",37,"wolbecker"
"10/4/2016 1:00",10,10,10,2,"wolkig",20,"wolbecker"
"10/4/2016 2:00",5,5,11,17,"wolkig",10,"wolbecker"
"10/4/2016 3:00",2,3,11,17,"wolkig",5,"wolbecker"
"10/4/2016 4:00",7,9,11,11,"wolkig",16,"wolbecker"
"10/4/2016 5:00",36,42,12,15,"wolkig",78,"wolbecker"
"10/4/2016 6:00",146,184,11,9,"wolkig",330,"wolbecker"
"10/4/2016 7:00",628,373,11,4,"teilweise bewölkt",1001,"wolbecker"
"10/4/2016 8:00",592,262,11,6,"teilweise bewölkt",854,"wolbecker"
"10/4/2016 9:00",490,217,12,17,"wolkig",707,"wolbecker"
"10/4/2016 10:00",358,208,12,11,"wolkig",566,"wolbecker"
"10/4/2016 11:00",372,277,14,9,"wolkig",649,"wolbecker"
"10/4/2016 12:00",332,318,15,17,"teilweise bewölkt",650,"wolbecker"
"10/4/2016 13:00",385,379,15,13,"teilweise bewölkt",764,"wolbecker"
"10/4/2016 14:00",385,372,16,15,"teilweise bewölkt",757,"wolbecker"
"10/4/2016 15:00",425,474,17,15,"teilweise bewölkt",899,"wolbecker"
"10/4/2016 16:00",515,593,16,15,"teilweise bewölkt",1108,"wolbecker"
"10/4/2016 17:00",543,653,15,11,"teilweise bewölkt",1196,"wolbecker"
"10/4/2016 18:00",444,568,14,7,"teilweise bewölkt",1012,"wolbecker"
"10/4/2016 19:00",342,444,12,7,"teilweise bewölkt",786,"wolbecker"
"10/4/2016 20:00",207,202,9,0,"Klarer Himmel",409,"wolbecker"
"10/4/2016 21:00",148,164,9,6,"Klarer Himmel",312,"wolbecker"
"10/4/2016 22:00",163,121,10,13,"Klarer Himmel",284,"wolbecker"
"10/4/2016 23:00",79,65,10,11,"Klarer Himmel",144,"wolbecker"
"10/5/2016 0:00",25,45,10,7,"Klarer Himmel",70,"wolbecker"
"10/5/2016 1:00",18,24,9,11,"Klarer Himmel",42,"wolbecker"
"10/5/2016 2:00",10,14,8,11,"Klarer Himmel",24,"wolbecker"
"10/5/2016 3:00",6,4,8,7,"Klarer Himmel",10,"wolbecker"
"10/5/2016 4:00",7,9,7,11,"Klarer Himmel",16,"wolbecker"
"10/5/2016 5:00",30,52,7,9,"Klarer Himmel",82,"wolbecker"
"10/5/2016 6:00",155,185,6,9,"Klarer Himmel",340,"wolbecker"
"10/5/2016 7:00",621,335,5,6,"Klarer Himmel",956,"wolbecker"
"10/5/2016 8:00",634,286,7,15,"Klarer Himmel",920,"wolbecker"
"10/5/2016 9:00",503,206,8,13,"Klarer Himmel",709,"wolbecker"
"10/5/2016 10:00",412,214,9,17,"teilweise bewölkt",626,"wolbecker"
"10/5/2016 11:00",417,325,NA,NA,NA,742,"wolbecker"
"10/5/2016 12:00",388,365,12,11,"teilweise bewölkt",753,"wolbecker"
"10/5/2016 13:00",430,452,13,17,"teilweise bewölkt",882,"wolbecker"
"10/5/2016 14:00",383,453,13,24,NA,836,"wolbecker"
"10/5/2016 15:00",382,456,12,15,"Klarer Himmel",838,"wolbecker"
"10/5/2016 16:00",433,641,13,17,"Klarer Himmel",1074,"wolbecker"
"10/5/2016 17:00",535,595,12,20,"Klarer Himmel",1130,"wolbecker"
"10/5/2016 18:00",456,527,10,11,"Klarer Himmel",983,"wolbecker"
"10/5/2016 19:00",363,425,8,9,"Klarer Himmel",788,"wolbecker"
"10/5/2016 20:00",215,226,7,9,"Klarer Himmel",441,"wolbecker"
"10/5/2016 21:00",182,208,8,13,"Klarer Himmel",390,"wolbecker"
"10/5/2016 22:00",144,134,6,7,"Klarer Himmel",278,"wolbecker"
"10/5/2016 23:00",77,77,6,11,"Klarer Himmel",154,"wolbecker"
"10/6/2016 0:00",41,55,5,2,"teilweise bewölkt",96,"wolbecker"
"10/6/2016 1:00",27,41,4,7,"Klarer Himmel",68,"wolbecker"
"10/6/2016 2:00",8,32,6,15,"Klarer Himmel",40,"wolbecker"
"10/6/2016 3:00",9,18,6,13,"wolkig",27,"wolbecker"
"10/6/2016 4:00",12,12,7,9,"wolkig",24,"wolbecker"
"10/6/2016 5:00",41,59,7,11,"wolkig",100,"wolbecker"
"10/6/2016 6:00",132,180,8,13,"wolkig",312,"wolbecker"
"10/6/2016 7:00",615,337,8,13,"wolkig",952,"wolbecker"
"10/6/2016 8:00",572,292,8,13,"wolkig",864,"wolbecker"
"10/6/2016 9:00",460,180,8,19,"wolkig",640,"wolbecker"
"10/6/2016 10:00",337,180,9,19,"wolkig",517,"wolbecker"
"10/6/2016 11:00",308,248,9,13,"Regen",556,"wolbecker"
"10/6/2016 12:00",276,310,10,15,"wolkig",586,"wolbecker"
"10/6/2016 13:00",370,386,11,17,"wolkig",756,"wolbecker"
"10/6/2016 14:00",355,402,11,17,"wolkig",757,"wolbecker"
"10/6/2016 15:00",395,485,11,17,"wolkig",880,"wolbecker"
"10/6/2016 16:00",442,569,11,19,"wolkig",1011,"wolbecker"
"10/6/2016 17:00",469,613,11,22,"wolkig",1082,"wolbecker"
"10/6/2016 18:00",417,557,10,15,"wolkig",974,"wolbecker"
"10/6/2016 19:00",321,409,10,19,"wolkig",730,"wolbecker"
"10/6/2016 20:00",169,207,11,19,"wolkig",376,"wolbecker"
"10/6/2016 21:00",162,134,10,19,"wolkig",296,"wolbecker"
"10/6/2016 22:00",114,115,10,15,"wolkig",229,"wolbecker"
"10/6/2016 23:00",120,72,10,17,"wolkig",192,"wolbecker"
"10/7/2016 0:00",105,40,10,19,"wolkig",145,"wolbecker"
"10/7/2016 1:00",33,27,10,20,"wolkig",60,"wolbecker"
"10/7/2016 2:00",13,10,10,22,"wolkig",23,"wolbecker"
"10/7/2016 3:00",9,11,10,17,"wolkig",20,"wolbecker"
"10/7/2016 4:00",8,15,10,19,"wolkig",23,"wolbecker"
"10/7/2016 5:00",36,48,10,11,"wolkig",84,"wolbecker"
"10/7/2016 6:00",118,163,10,15,"wolkig",281,"wolbecker"
"10/7/2016 7:00",593,293,10,15,"wolkig",886,"wolbecker"
"10/7/2016 8:00",482,251,10,11,"wolkig",733,"wolbecker"
"10/7/2016 9:00",432,186,11,15,"wolkig",618,"wolbecker"
"10/7/2016 10:00",327,222,11,13,"wolkig",549,"wolbecker"
"10/7/2016 11:00",313,289,12,9,"wolkig",602,"wolbecker"
"10/7/2016 12:00",365,364,13,11,"wolkig",729,"wolbecker"
"10/7/2016 13:00",398,474,14,15,"teilweise bewölkt",872,"wolbecker"
"10/7/2016 14:00",452,498,13,15,"teilweise bewölkt",950,"wolbecker"
"10/7/2016 15:00",416,436,13,17,"wolkig",852,"wolbecker"
"10/7/2016 16:00",378,478,14,15,"wolkig",856,"wolbecker"
"10/7/2016 17:00",412,447,13,19,"wolkig",859,"wolbecker"
"10/7/2016 18:00",329,430,12,17,"wolkig",759,"wolbecker"
"10/7/2016 19:00",227,383,12,11,"wolkig",610,"wolbecker"
"10/7/2016 20:00",186,228,12,17,"wolkig",414,"wolbecker"
"10/7/2016 21:00",175,133,11,11,"Regen",308,"wolbecker"
"10/7/2016 22:00",134,91,11,13,"wolkig",225,"wolbecker"
"10/7/2016 23:00",98,106,11,15,"Regen",204,"wolbecker"
"10/8/2016 0:00",113,103,10,11,"wolkig",216,"wolbecker"
"10/8/2016 1:00",70,128,10,11,"wolkig",198,"wolbecker"
"10/8/2016 2:00",55,46,10,11,"wolkig",101,"wolbecker"
"10/8/2016 3:00",34,29,8,7,"Klarer Himmel",63,"wolbecker"
"10/8/2016 4:00",23,22,7,4,"Klarer Himmel",45,"wolbecker"
"10/8/2016 5:00",43,21,6,2,"Nebel",64,"wolbecker"
"10/8/2016 6:00",50,20,5,4,"Nebel",70,"wolbecker"
"10/8/2016 7:00",74,49,6,0,"Nebel",123,"wolbecker"
"10/8/2016 8:00",145,66,8,6,"teilweise bewölkt",211,"wolbecker"
"10/8/2016 9:00",301,118,10,13,"Klarer Himmel",419,"wolbecker"
"10/8/2016 10:00",418,176,11,15,"teilweise bewölkt",594,"wolbecker"
"10/8/2016 11:00",491,284,12,13,"teilweise bewölkt",775,"wolbecker"
"10/8/2016 12:00",455,333,12,15,"teilweise bewölkt",788,"wolbecker"
"10/8/2016 13:00",403,438,12,22,"teilweise bewölkt",841,"wolbecker"
"10/8/2016 14:00",330,443,13,9,"teilweise bewölkt",773,"wolbecker"
"10/8/2016 15:00",307,380,13,11,"teilweise bewölkt",687,"wolbecker"
"10/8/2016 16:00",212,347,13,11,"teilweise bewölkt",559,"wolbecker"
"10/8/2016 17:00",227,363,12,15,"teilweise bewölkt",590,"wolbecker"
"10/8/2016 18:00",218,350,10,7,"wolkig",568,"wolbecker"
"10/8/2016 19:00",223,308,8,4,"wolkig",531,"wolbecker"
"10/8/2016 20:00",155,158,8,0,"Klarer Himmel",313,"wolbecker"
"10/8/2016 21:00",119,117,8,0,"wolkig",236,"wolbecker"
"10/8/2016 22:00",131,90,8,4,"wolkig",221,"wolbecker"
"10/8/2016 23:00",116,128,8,4,"wolkig",244,"wolbecker"
"10/9/2016 0:00",128,76,8,4,"wolkig",204,"wolbecker"
"10/9/2016 1:00",88,85,7,4,"wolkig",173,"wolbecker"
"10/9/2016 2:00",79,64,6,6,"Klarer Himmel",143,"wolbecker"
"10/9/2016 3:00",52,49,6,0,"Klarer Himmel",101,"wolbecker"
"10/9/2016 4:00",48,28,5,2,"Nebel",76,"wolbecker"
"10/9/2016 5:00",27,19,4,0,"Nebel",46,"wolbecker"
"10/9/2016 6:00",24,13,3,4,"Nebel",37,"wolbecker"
"10/9/2016 7:00",18,21,2,0,"Nebel",39,"wolbecker"
"10/9/2016 8:00",33,35,4,0,"Nebel",68,"wolbecker"
"10/9/2016 9:00",74,71,6,4,"Klarer Himmel",145,"wolbecker"
"10/9/2016 10:00",165,88,8,6,"Klarer Himmel",253,"wolbecker"
"10/9/2016 11:00",129,122,11,7,"teilweise bewölkt",251,"wolbecker"
"10/9/2016 12:00",198,155,11,13,"wolkig",353,"wolbecker"
"10/9/2016 13:00",218,155,11,9,"wolkig",373,"wolbecker"
"10/9/2016 14:00",205,191,12,9,"wolkig",396,"wolbecker"
"10/9/2016 15:00",210,208,12,11,"wolkig",418,"wolbecker"
"10/9/2016 16:00",198,232,11,9,"wolkig",430,"wolbecker"
"10/9/2016 17:00",211,255,11,7,"wolkig",466,"wolbecker"
"10/9/2016 18:00",196,209,10,6,"Regen",405,"wolbecker"
"10/9/2016 19:00",184,155,8,0,"wolkig",339,"wolbecker"
"10/9/2016 20:00",146,107,9,0,"wolkig",253,"wolbecker"
"10/9/2016 21:00",85,61,8,0,"wolkig",146,"wolbecker"
"10/9/2016 22:00",106,67,8,0,"wolkig",173,"wolbecker"
"10/9/2016 23:00",35,44,7,0,"wolkig",79,"wolbecker"
"10/10/2016 0:00",25,14,8,4,"wolkig",39,"wolbecker"
"10/10/2016 1:00",7,10,7,4,"wolkig",17,"wolbecker"
"10/10/2016 2:00",3,2,5,4,"teilweise bewölkt",5,"wolbecker"
"10/10/2016 3:00",1,2,7,7,"wolkig",3,"wolbecker"
"10/10/2016 4:00",7,4,7,0,"wolkig",11,"wolbecker"
"10/10/2016 5:00",37,43,6,7,"wolkig",80,"wolbecker"
"10/10/2016 6:00",131,157,6,6,"Nebel",288,"wolbecker"
"10/10/2016 7:00",378,213,6,4,"Nebel",591,"wolbecker"
"10/10/2016 8:00",482,228,6,6,"Nebel",710,"wolbecker"
"10/10/2016 9:00",477,204,6,4,"Nebel",681,"wolbecker"
"10/10/2016 10:00",315,206,8,4,"teilweise bewölkt",521,"wolbecker"
"10/10/2016 11:00",347,216,10,4,"teilweise bewölkt",563,"wolbecker"
"10/10/2016 12:00",321,268,10,11,"teilweise bewölkt",589,"wolbecker"
"10/10/2016 13:00",336,328,10,11,"wolkig",664,"wolbecker"
"10/10/2016 14:00",328,323,11,9,"wolkig",651,"wolbecker"
"10/10/2016 15:00",368,371,11,11,"wolkig",739,"wolbecker"
"10/10/2016 16:00",419,533,11,9,"wolkig",952,"wolbecker"
"10/10/2016 17:00",465,569,10,9,"wolkig",1034,"wolbecker"
"10/10/2016 18:00",356,499,8,6,"teilweise bewölkt",855,"wolbecker"
"10/10/2016 19:00",300,361,6,0,"teilweise bewölkt",661,"wolbecker"
"10/10/2016 20:00",197,209,6,0,"wolkig",406,"wolbecker"
"10/10/2016 21:00",127,134,5,0,"Nebel",261,"wolbecker"
"10/10/2016 22:00",97,125,4,2,"Nebel",222,"wolbecker"
"10/10/2016 23:00",65,102,2,0,"Nebel",167,"wolbecker"
"10/11/2016 0:00",41,74,2,0,"Nebel",115,"wolbecker"
"10/11/2016 1:00",18,25,1,0,"Nebel",43,"wolbecker"
"10/11/2016 2:00",35,17,0,0,"Nebel",52,"wolbecker"
"10/11/2016 3:00",22,9,1,4,"Nebel",31,"wolbecker"
"10/11/2016 4:00",13,13,1,4,"Nebel",26,"wolbecker"
"10/11/2016 5:00",32,38,3,6,"Nebel",70,"wolbecker"
"10/11/2016 6:00",142,135,4,4,"wolkig",277,"wolbecker"
"10/11/2016 7:00",409,213,4,0,"wolkig",622,"wolbecker"
"10/11/2016 8:00",517,217,5,0,"wolkig",734,"wolbecker"
"10/11/2016 9:00",374,179,6,2,"Regen",553,"wolbecker"
"10/11/2016 10:00",298,155,7,4,"Regen",453,"wolbecker"
"10/11/2016 11:00",271,211,8,0,"Regen",482,"wolbecker"
"10/11/2016 12:00",246,254,9,2,"wolkig",500,"wolbecker"
"10/11/2016 13:00",307,268,9,2,"wolkig",575,"wolbecker"
"10/11/2016 14:00",269,275,10,2,"wolkig",544,"wolbecker"
"10/11/2016 15:00",339,365,10,6,"wolkig",704,"wolbecker"
"10/11/2016 16:00",372,500,10,6,"wolkig",872,"wolbecker"
"10/11/2016 17:00",412,529,10,6,"wolkig",941,"wolbecker"
"10/11/2016 18:00",359,482,10,6,"wolkig",841,"wolbecker"
"10/11/2016 19:00",251,418,9,6,"wolkig",669,"wolbecker"
"10/11/2016 20:00",206,233,9,6,"Regen",439,"wolbecker"
"10/11/2016 21:00",152,141,9,7,"Regen",293,"wolbecker"
"10/11/2016 22:00",167,124,9,11,"Regen",291,"wolbecker"
"10/11/2016 23:00",70,153,9,13,"wolkig",223,"wolbecker"
"10/12/2016 0:00",50,57,9,13,"wolkig",107,"wolbecker"
"10/12/2016 1:00",38,31,8,15,"wolkig",69,"wolbecker"
"10/12/2016 2:00",37,21,8,13,"wolkig",58,"wolbecker"
"10/12/2016 3:00",33,9,8,11,"wolkig",42,"wolbecker"
"10/12/2016 4:00",27,16,8,11,"Regen",43,"wolbecker"
"10/12/2016 5:00",33,41,8,9,"wolkig",74,"wolbecker"
"10/12/2016 6:00",130,139,7,13,"wolkig",269,"wolbecker"
"10/12/2016 7:00",369,218,7,13,"wolkig",587,"wolbecker"
"10/12/2016 8:00",553,220,7,9,"wolkig",773,"wolbecker"
"10/12/2016 9:00",445,155,8,13,"wolkig",600,"wolbecker"
"10/12/2016 10:00",349,186,8,9,"wolkig",535,"wolbecker"
"10/12/2016 11:00",368,223,8,11,"Regen",591,"wolbecker"
"10/12/2016 12:00",329,310,8,13,"wolkig",639,"wolbecker"
"10/12/2016 13:00",301,312,8,7,"wolkig",613,"wolbecker"
"10/12/2016 14:00",312,351,9,11,"wolkig",663,"wolbecker"
"10/12/2016 15:00",289,385,9,11,"wolkig",674,"wolbecker"
"10/12/2016 16:00",368,488,9,7,"wolkig",856,"wolbecker"
"10/12/2016 17:00",409,522,8,11,"Regen",931,"wolbecker"
"10/12/2016 18:00",373,446,8,9,"wolkig",819,"wolbecker"
"10/12/2016 19:00",301,379,7,6,"wolkig",680,"wolbecker"
"10/12/2016 20:00",215,215,7,9,"wolkig",430,"wolbecker"
"10/12/2016 21:00",181,183,7,6,"wolkig",364,"wolbecker"
"10/12/2016 22:00",153,115,8,6,"wolkig",268,"wolbecker"
"10/12/2016 23:00",78,94,8,11,"wolkig",172,"wolbecker"
"10/13/2016 0:00",50,71,8,11,"wolkig",121,"wolbecker"
"10/13/2016 1:00",37,65,8,7,"wolkig",102,"wolbecker"
"10/13/2016 2:00",11,56,8,9,"wolkig",67,"wolbecker"
"10/13/2016 3:00",28,50,8,9,"wolkig",78,"wolbecker"
"10/13/2016 4:00",12,28,8,7,"wolkig",40,"wolbecker"
"10/13/2016 5:00",38,49,8,9,"wolkig",87,"wolbecker"
"10/13/2016 6:00",127,136,8,7,"wolkig",263,"wolbecker"
"10/13/2016 7:00",364,220,8,11,"wolkig",584,"wolbecker"
"10/13/2016 8:00",455,187,8,7,"wolkig",642,"wolbecker"
"10/13/2016 9:00",387,155,8,9,"wolkig",542,"wolbecker"
"10/13/2016 10:00",267,141,9,11,"wolkig",408,"wolbecker"
"10/13/2016 11:00",280,203,9,11,"wolkig",483,"wolbecker"
"10/13/2016 12:00",303,290,9,11,"wolkig",593,"wolbecker"
"10/13/2016 13:00",309,306,9,11,"wolkig",615,"wolbecker"
"10/13/2016 14:00",311,337,9,13,"wolkig",648,"wolbecker"
"10/13/2016 15:00",351,368,10,17,"wolkig",719,"wolbecker"
"10/13/2016 16:00",347,520,10,11,"wolkig",867,"wolbecker"
"10/13/2016 17:00",374,534,9,15,"wolkig",908,"wolbecker"
"10/13/2016 18:00",377,451,9,13,"wolkig",828,"wolbecker"
"10/13/2016 19:00",294,376,9,11,"wolkig",670,"wolbecker"
"10/13/2016 20:00",228,216,8,13,"wolkig",444,"wolbecker"
"10/13/2016 21:00",153,149,8,15,"wolkig",302,"wolbecker"
"10/13/2016 22:00",144,120,8,11,"wolkig",264,"wolbecker"
"10/13/2016 23:00",72,97,8,13,"wolkig",169,"wolbecker"
"10/14/2016 0:00",32,92,8,13,"teilweise bewölkt",124,"wolbecker"
"10/14/2016 1:00",41,49,7,11,"Klarer Himmel",90,"wolbecker"
"10/14/2016 2:00",33,26,7,11,"teilweise bewölkt",59,"wolbecker"
"10/14/2016 3:00",33,13,7,13,"teilweise bewölkt",46,"wolbecker"
"10/14/2016 4:00",38,5,7,11,"wolkig",43,"wolbecker"
"10/14/2016 5:00",43,35,7,11,"Klarer Himmel",78,"wolbecker"
"10/14/2016 6:00",133,114,7,11,"Klarer Himmel",247,"wolbecker"
"10/14/2016 7:00",324,191,7,9,"Klarer Himmel",515,"wolbecker"
"10/14/2016 8:00",413,191,7,13,"Klarer Himmel",604,"wolbecker"
"10/14/2016 9:00",377,151,8,15,"Klarer Himmel",528,"wolbecker"
"10/14/2016 10:00",308,168,9,15,"wolkig",476,"wolbecker"
"10/14/2016 11:00",295,231,10,15,"wolkig",526,"wolbecker"
"10/14/2016 12:00",315,335,12,17,"wolkig",650,"wolbecker"
"10/14/2016 13:00",341,399,13,11,"Klarer Himmel",740,"wolbecker"
"10/14/2016 14:00",351,452,13,15,"Klarer Himmel",803,"wolbecker"
"10/14/2016 15:00",357,396,13,11,"Klarer Himmel",753,"wolbecker"
"10/14/2016 16:00",353,436,12,13,"Klarer Himmel",789,"wolbecker"
"10/14/2016 17:00",380,416,12,9,"Klarer Himmel",796,"wolbecker"
"10/14/2016 18:00",306,437,12,11,"Klarer Himmel",743,"wolbecker"
"10/14/2016 19:00",264,333,10,13,"Klarer Himmel",597,"wolbecker"
"10/14/2016 20:00",188,226,10,9,"Klarer Himmel",414,"wolbecker"
"10/14/2016 21:00",136,165,9,11,"Klarer Himmel",301,"wolbecker"
"10/14/2016 22:00",143,120,9,7,"Klarer Himmel",263,"wolbecker"
"10/14/2016 23:00",82,129,9,7,"Klarer Himmel",211,"wolbecker"
"10/15/2016 0:00",105,122,10,9,"Regen",227,"wolbecker"
"10/15/2016 1:00",98,73,10,9,"Klarer Himmel",171,"wolbecker"
"10/15/2016 2:00",41,49,10,6,"Klarer Himmel",90,"wolbecker"
"10/15/2016 3:00",66,27,10,6,"Klarer Himmel",93,"wolbecker"
"10/15/2016 4:00",39,23,9,6,"Klarer Himmel",62,"wolbecker"
"10/15/2016 5:00",48,26,9,9,"Klarer Himmel",74,"wolbecker"
"10/15/2016 6:00",28,31,8,4,"Klarer Himmel",59,"wolbecker"
"10/15/2016 7:00",55,58,8,7,"teilweise bewölkt",113,"wolbecker"
"10/15/2016 8:00",120,78,9,7,"wolkig",198,"wolbecker"
"10/15/2016 9:00",205,115,10,11,"Regen",320,"wolbecker"
"10/15/2016 10:00",301,160,11,9,"wolkig",461,"wolbecker"
"10/15/2016 11:00",285,201,11,9,NA,486,"wolbecker"
"10/15/2016 12:00",370,301,12,7,"wolkig",671,"wolbecker"
"10/15/2016 13:00",307,304,13,17,"Regen",611,"wolbecker"
"10/15/2016 14:00",252,296,13,13,"wolkig",548,"wolbecker"
"10/15/2016 15:00",218,298,13,11,"Regen",516,"wolbecker"
"10/15/2016 16:00",185,287,13,9,"Regen",472,"wolbecker"
"10/15/2016 17:00",202,265,13,6,"wolkig",467,"wolbecker"
"10/15/2016 18:00",202,282,12,6,"wolkig",484,"wolbecker"
"10/15/2016 19:00",198,217,11,7,"Nebel",415,"wolbecker"
"10/15/2016 20:00",171,158,8,0,"Nebel",329,"wolbecker"
"10/15/2016 21:00",145,103,7,4,"Nebel",248,"wolbecker"
"10/15/2016 22:00",101,128,7,0,"Nebel",229,"wolbecker"
"10/15/2016 23:00",85,93,7,2,"Nebel",178,"wolbecker"
"10/16/2016 0:00",96,98,5,6,"Nebel",194,"wolbecker"
"10/16/2016 1:00",96,101,4,0,"Nebel",197,"wolbecker"
"10/16/2016 2:00",47,61,5,0,"Nebel",108,"wolbecker"
"10/16/2016 3:00",61,28,5,0,"Nebel",89,"wolbecker"
"10/16/2016 4:00",34,22,6,4,"Nebel",56,"wolbecker"
"10/16/2016 5:00",39,15,6,4,"Nebel",54,"wolbecker"
"10/16/2016 6:00",38,16,6,4,"Nebel",54,"wolbecker"
"10/16/2016 7:00",15,35,5,4,"Nebel",50,"wolbecker"
"10/16/2016 8:00",31,42,6,4,"Nebel",73,"wolbecker"
"10/16/2016 9:00",70,56,8,4,"Klarer Himmel",126,"wolbecker"
"10/16/2016 10:00",124,85,10,6,"Klarer Himmel",209,"wolbecker"
"10/16/2016 11:00",144,156,12,7,"Klarer Himmel",300,"wolbecker"
"10/16/2016 12:00",208,150,15,7,"Klarer Himmel",358,"wolbecker"
"10/16/2016 13:00",239,186,17,7,"Klarer Himmel",425,"wolbecker"
"10/16/2016 14:00",298,248,18,9,"Klarer Himmel",546,"wolbecker"
"10/16/2016 15:00",259,248,18,6,"Klarer Himmel",507,"wolbecker"
"10/16/2016 16:00",278,293,17,6,"Klarer Himmel",571,"wolbecker"
"10/16/2016 17:00",254,315,16,4,"Klarer Himmel",569,"wolbecker"
"10/16/2016 18:00",281,278,13,6,"Klarer Himmel",559,"wolbecker"
"10/16/2016 19:00",207,156,13,6,"Klarer Himmel",363,"wolbecker"
"10/16/2016 20:00",188,97,13,6,"Klarer Himmel",285,"wolbecker"
"10/16/2016 21:00",109,66,12,7,"Klarer Himmel",175,"wolbecker"
"10/16/2016 22:00",121,61,12,7,"Klarer Himmel",182,"wolbecker"
"10/16/2016 23:00",41,33,11,11,"Klarer Himmel",74,"wolbecker"
"10/17/2016 0:00",38,25,11,7,"Klarer Himmel",63,"wolbecker"
"10/17/2016 1:00",15,11,11,7,"Klarer Himmel",26,"wolbecker"
"10/17/2016 2:00",6,1,11,7,"Klarer Himmel",7,"wolbecker"
"10/17/2016 3:00",3,1,10,6,"Klarer Himmel",4,"wolbecker"
"10/17/2016 4:00",4,5,10,2,"Klarer Himmel",9,"wolbecker"
"10/17/2016 5:00",32,45,10,6,"Klarer Himmel",77,"wolbecker"
"10/17/2016 6:00",138,150,10,6,"Klarer Himmel",288,"wolbecker"
"10/17/2016 7:00",474,226,10,6,"Klarer Himmel",700,"wolbecker"
"10/17/2016 8:00",531,226,10,2,"Klarer Himmel",757,"wolbecker"
"10/17/2016 9:00",557,183,11,7,"Klarer Himmel",740,"wolbecker"
"10/17/2016 10:00",357,241,13,7,"wolkig",598,"wolbecker"
"10/17/2016 11:00",396,262,15,7,"Klarer Himmel",658,"wolbecker"
"10/17/2016 12:00",376,327,15,9,"wolkig",703,"wolbecker"
"10/17/2016 13:00",394,339,16,7,"wolkig",733,"wolbecker"
"10/17/2016 14:00",311,363,15,13,"wolkig",674,"wolbecker"
"10/17/2016 15:00",370,444,15,7,"wolkig",814,"wolbecker"
"10/17/2016 16:00",421,626,15,7,"wolkig",1047,"wolbecker"
"10/17/2016 17:00",520,642,14,6,"Klarer Himmel",1162,"wolbecker"
"10/17/2016 18:00",412,605,13,6,"Klarer Himmel",1017,"wolbecker"
"10/17/2016 19:00",284,407,12,6,"Klarer Himmel",691,"wolbecker"
"10/17/2016 20:00",187,205,10,0,"Nebel",392,"wolbecker"
"10/17/2016 21:00",120,124,10,4,"Nebel",244,"wolbecker"
"10/17/2016 22:00",133,106,9,2,"Nebel",239,"wolbecker"
"10/17/2016 23:00",71,80,7,7,"Nebel",151,"wolbecker"
"10/18/2016 0:00",38,42,9,4,"Nebel",80,"wolbecker"
"10/18/2016 1:00",9,11,10,6,"Nebel",20,"wolbecker"
"10/18/2016 2:00",8,7,9,4,"Nebel",15,"wolbecker"
"10/18/2016 3:00",1,4,7,4,"Nebel",5,"wolbecker"
"10/18/2016 4:00",6,7,7,4,"Nebel",13,"wolbecker"
"10/18/2016 5:00",31,60,7,4,"Nebel",91,"wolbecker"
"10/18/2016 6:00",141,153,8,6,"Nebel",294,"wolbecker"
"10/18/2016 7:00",549,221,8,7,"Nebel",770,"wolbecker"
"10/18/2016 8:00",581,243,8,6,"Nebel",824,"wolbecker"
"10/18/2016 9:00",529,189,10,13,"wolkig",718,"wolbecker"
"10/18/2016 10:00",365,215,11,15,"wolkig",580,"wolbecker"
"10/18/2016 11:00",374,291,12,15,"wolkig",665,"wolbecker"
"10/18/2016 12:00",318,360,14,17,"wolkig",678,"wolbecker"
"10/18/2016 13:00",366,349,15,20,"wolkig",715,"wolbecker"
"10/18/2016 14:00",310,407,15,19,"wolkig",717,"wolbecker"
"10/18/2016 15:00",366,465,14,13,"Regen",831,"wolbecker"
"10/18/2016 16:00",392,565,13,15,"Regen",957,"wolbecker"
"10/18/2016 17:00",434,599,13,17,"Regen",1033,"wolbecker"
"10/18/2016 18:00",404,554,12,17,"Regen",958,"wolbecker"
"10/18/2016 19:00",255,321,11,15,"Regen",576,"wolbecker"
"10/18/2016 20:00",171,194,9,4,"Regen",365,"wolbecker"
"10/18/2016 21:00",125,127,10,11,"wolkig",252,"wolbecker"
"10/18/2016 22:00",127,131,10,11,"Klarer Himmel",258,"wolbecker"
"10/18/2016 23:00",61,78,9,13,NA,139,"wolbecker"
"10/19/2016 0:00",32,56,8,9,"teilweise bewölkt",88,"wolbecker"
"10/19/2016 1:00",22,28,8,11,"wolkig",50,"wolbecker"
"10/19/2016 2:00",30,5,9,15,"Regen",35,"wolbecker"
"10/19/2016 3:00",30,8,8,17,"wolkig",38,"wolbecker"
"10/19/2016 4:00",33,8,7,17,"wolkig",41,"wolbecker"
"10/19/2016 5:00",36,46,8,17,"wolkig",82,"wolbecker"
"10/19/2016 6:00",112,152,7,13,"Regen",264,"wolbecker"
"10/19/2016 7:00",524,203,7,15,"Regen",727,"wolbecker"
"10/19/2016 8:00",508,205,8,15,"Regen",713,"wolbecker"
"10/19/2016 9:00",388,160,8,11,"Regen",548,"wolbecker"
"10/19/2016 10:00",203,159,7,15,"Regen",362,"wolbecker"
"10/19/2016 11:00",190,148,7,11,"Regen",338,"wolbecker"
"10/19/2016 12:00",150,202,7,13,"Regen",352,"wolbecker"
"10/19/2016 13:00",231,252,7,17,"Regen",483,"wolbecker"
"10/19/2016 14:00",190,266,7,19,"Regen",456,"wolbecker"
"10/19/2016 15:00",218,299,7,20,"Regen",517,"wolbecker"
"10/19/2016 16:00",233,365,8,15,"wolkig",598,"wolbecker"
"10/19/2016 17:00",348,436,7,9,"wolkig",784,"wolbecker"
"10/19/2016 18:00",330,396,8,7,"wolkig",726,"wolbecker"
"10/19/2016 19:00",284,295,7,11,"wolkig",579,"wolbecker"
"10/19/2016 20:00",204,179,7,9,"Regen",383,"wolbecker"
"10/19/2016 21:00",118,119,8,4,"Regen",237,"wolbecker"
"10/19/2016 22:00",130,93,7,11,"Regen",223,"wolbecker"
"10/19/2016 23:00",67,115,7,7,"wolkig",182,"wolbecker"
"10/20/2016 0:00",40,74,6,4,"wolkig",114,"wolbecker"
"10/20/2016 1:00",15,78,5,2,"Nebel",93,"wolbecker"
"10/20/2016 2:00",25,39,5,0,"Nebel",64,"wolbecker"
"10/20/2016 3:00",25,42,4,2,"Nebel",67,"wolbecker"
"10/20/2016 4:00",30,24,2,0,"Nebel",54,"wolbecker"
"10/20/2016 5:00",35,49,3,0,"Nebel",84,"wolbecker"
"10/20/2016 6:00",110,146,4,4,"Nebel",256,"wolbecker"
"10/20/2016 7:00",481,178,4,0,"Nebel",659,"wolbecker"
"10/20/2016 8:00",508,216,4,6,"Nebel",724,"wolbecker"
"10/20/2016 9:00",429,164,6,0,"Nebel",593,"wolbecker"
"10/20/2016 10:00",324,213,7,2,"wolkig",537,"wolbecker"
"10/20/2016 11:00",356,229,8,4,"wolkig",585,"wolbecker"
"10/20/2016 12:00",298,299,9,6,"wolkig",597,"wolbecker"
"10/20/2016 13:00",320,349,9,6,"wolkig",669,"wolbecker"
"10/20/2016 14:00",273,358,9,7,"wolkig",631,"wolbecker"
"10/20/2016 15:00",363,431,9,7,"wolkig",794,"wolbecker"
"10/20/2016 16:00",390,578,9,7,"wolkig",968,"wolbecker"
"10/20/2016 17:00",472,567,8,4,"wolkig",1039,"wolbecker"
"10/20/2016 18:00",365,472,8,9,"Regen",837,"wolbecker"
"10/20/2016 19:00",281,354,8,6,"wolkig",635,"wolbecker"
"10/20/2016 20:00",165,230,8,6,"wolkig",395,"wolbecker"
"10/20/2016 21:00",147,134,7,6,"wolkig",281,"wolbecker"
"10/20/2016 22:00",122,118,7,7,"wolkig",240,"wolbecker"
"10/20/2016 23:00",60,81,7,7,"wolkig",141,"wolbecker"
"10/21/2016 0:00",65,53,7,4,"wolkig",118,"wolbecker"
"10/21/2016 1:00",29,31,7,11,"wolkig",60,"wolbecker"
"10/21/2016 2:00",13,24,7,11,"wolkig",37,"wolbecker"
"10/21/2016 3:00",14,9,5,6,"Nebel",23,"wolbecker"
"10/21/2016 4:00",7,9,6,9,"wolkig",16,"wolbecker"
"10/21/2016 5:00",26,48,6,9,"wolkig",74,"wolbecker"
"10/21/2016 6:00",111,128,6,6,"wolkig",239,"wolbecker"
"10/21/2016 7:00",385,172,6,13,"wolkig",557,"wolbecker"
"10/21/2016 8:00",454,195,6,9,"wolkig",649,"wolbecker"
"10/21/2016 9:00",422,160,6,11,"wolkig",582,"wolbecker"
"10/21/2016 10:00",332,228,7,9,"wolkig",560,"wolbecker"
"10/21/2016 11:00",333,301,7,13,"wolkig",634,"wolbecker"
"10/21/2016 12:00",318,330,8,11,"wolkig",648,"wolbecker"
"10/21/2016 13:00",325,389,9,19,"wolkig",714,"wolbecker"
"10/21/2016 14:00",307,432,8,22,"Regen",739,"wolbecker"
"10/21/2016 15:00",350,404,8,17,"Regen",754,"wolbecker"
"10/21/2016 16:00",266,363,8,13,"Regen",629,"wolbecker"
"10/21/2016 17:00",230,340,8,11,"Regen",570,"wolbecker"
"10/21/2016 18:00",177,275,8,11,"Regen",452,"wolbecker"
"10/21/2016 19:00",202,230,8,9,"Regen",432,"wolbecker"
"10/21/2016 20:00",152,162,8,7,"Regen",314,"wolbecker"
"10/21/2016 21:00",112,114,8,6,"wolkig",226,"wolbecker"
"10/21/2016 22:00",105,88,8,4,"wolkig",193,"wolbecker"
"10/21/2016 23:00",88,88,8,4,"wolkig",176,"wolbecker"
"10/22/2016 0:00",59,105,8,6,"wolkig",164,"wolbecker"
"10/22/2016 1:00",49,78,8,6,"wolkig",127,"wolbecker"
"10/22/2016 2:00",45,42,8,7,"wolkig",87,"wolbecker"
"10/22/2016 3:00",24,30,7,7,"wolkig",54,"wolbecker"
"10/22/2016 4:00",33,27,7,7,"wolkig",60,"wolbecker"
"10/22/2016 5:00",34,24,7,7,"wolkig",58,"wolbecker"
"10/22/2016 6:00",31,24,7,7,"wolkig",55,"wolbecker"
"10/22/2016 7:00",75,33,7,9,"wolkig",108,"wolbecker"
"10/22/2016 8:00",110,73,7,11,"wolkig",183,"wolbecker"
"10/22/2016 9:00",247,108,7,11,"wolkig",355,"wolbecker"
"10/22/2016 10:00",298,191,7,9,"wolkig",489,"wolbecker"
"10/22/2016 11:00",372,245,8,11,"wolkig",617,"wolbecker"
"10/22/2016 12:00",382,296,8,7,"wolkig",678,"wolbecker"
"10/22/2016 13:00",351,322,8,11,"wolkig",673,"wolbecker"
"10/22/2016 14:00",288,382,8,9,"wolkig",670,"wolbecker"
"10/22/2016 15:00",296,356,8,9,"Regen",652,"wolbecker"
"10/22/2016 16:00",244,339,8,6,"wolkig",583,"wolbecker"
"10/22/2016 17:00",230,289,8,4,"wolkig",519,"wolbecker"
"10/22/2016 18:00",239,318,7,4,"Nebel",557,"wolbecker"
"10/22/2016 19:00",218,233,7,0,NA,451,"wolbecker"
"10/22/2016 20:00",153,193,6,0,"Nebel",346,"wolbecker"
"10/22/2016 21:00",133,134,5,2,"Nebel",267,"wolbecker"
"10/22/2016 22:00",137,137,4,4,"Nebel",274,"wolbecker"
"10/22/2016 23:00",81,116,2,0,"Nebel",197,"wolbecker"
"10/23/2016 0:00",103,122,2,2,"Nebel",225,"wolbecker"
"10/23/2016 1:00",86,105,1,0,"Nebel",191,"wolbecker"
"10/23/2016 2:00",54,50,1,4,"Nebel",104,"wolbecker"
"10/23/2016 3:00",50,54,1,2,"Nebel",104,"wolbecker"
"10/23/2016 4:00",45,28,1,4,"Nebel",73,"wolbecker"
"10/23/2016 5:00",33,19,1,2,"Nebel",52,"wolbecker"
"10/23/2016 6:00",29,9,1,2,"Nebel",38,"wolbecker"
"10/23/2016 7:00",25,22,1,4,"Nebel",47,"wolbecker"
"10/23/2016 8:00",28,49,2,4,"Nebel",77,"wolbecker"
"10/23/2016 9:00",53,63,2,6,"Nebel",116,"wolbecker"
"10/23/2016 10:00",94,93,3,4,"Nebel",187,"wolbecker"
"10/23/2016 11:00",116,109,4,6,"Nebel",225,"wolbecker"
"10/23/2016 12:00",140,135,6,6,"wolkig",275,"wolbecker"
"10/23/2016 13:00",183,164,7,6,"teilweise bewölkt",347,"wolbecker"
"10/23/2016 14:00",232,177,9,6,"teilweise bewölkt",409,"wolbecker"
"10/23/2016 15:00",277,192,10,7,"teilweise bewölkt",469,"wolbecker"
"10/23/2016 16:00",236,193,11,4,"teilweise bewölkt",429,"wolbecker"
"10/23/2016 17:00",270,277,9,4,"teilweise bewölkt",547,"wolbecker"
"10/23/2016 18:00",210,209,6,4,"Nebel",419,"wolbecker"
"10/23/2016 19:00",146,170,5,6,"Nebel",316,"wolbecker"
"10/23/2016 20:00",157,102,5,6,"Nebel",259,"wolbecker"
"10/23/2016 21:00",117,55,5,4,"Nebel",172,"wolbecker"
"10/23/2016 22:00",91,71,4,6,"Nebel",162,"wolbecker"
"10/23/2016 23:00",47,21,5,4,"Nebel",68,"wolbecker"
"10/24/2016 0:00",22,8,5,6,"Nebel",30,"wolbecker"
"10/24/2016 1:00",1,9,4,6,"Nebel",10,"wolbecker"
"10/24/2016 2:00",2,2,4,7,"Nebel",4,"wolbecker"
"10/24/2016 3:00",3,2,4,6,"Nebel",5,"wolbecker"
"10/24/2016 4:00",5,5,4,6,"Nebel",10,"wolbecker"
"10/24/2016 5:00",29,47,5,7,NA,76,"wolbecker"
"10/24/2016 6:00",153,185,5,7,NA,338,"wolbecker"
"10/24/2016 7:00",684,308,5,9,NA,992,"wolbecker"
"10/24/2016 8:00",608,298,5,6,NA,906,"wolbecker"
"10/24/2016 9:00",535,190,6,9,NA,725,"wolbecker"
"10/24/2016 10:00",356,193,7,11,"Klarer Himmel",549,"wolbecker"
"10/24/2016 11:00",390,229,8,9,"Klarer Himmel",619,"wolbecker"
"10/24/2016 12:00",310,373,8,9,"Klarer Himmel",683,"wolbecker"
"10/24/2016 13:00",396,399,9,6,"Klarer Himmel",795,"wolbecker"
"10/24/2016 14:00",375,388,9,7,"Regen",763,"wolbecker"
"10/24/2016 15:00",289,410,8,7,"Regen",699,"wolbecker"
"10/24/2016 16:00",313,495,8,9,"Regen",808,"wolbecker"
"10/24/2016 17:00",377,455,8,7,"Regen",832,"wolbecker"
"10/24/2016 18:00",348,467,8,6,"Regen",815,"wolbecker"
"10/24/2016 19:00",222,350,8,6,"Regen",572,"wolbecker"
"10/24/2016 20:00",139,186,8,4,"Regen",325,"wolbecker"
"10/24/2016 21:00",117,146,8,6,"Regen",263,"wolbecker"
"10/24/2016 22:00",86,85,8,4,"wolkig",171,"wolbecker"
"10/24/2016 23:00",51,40,8,7,"wolkig",91,"wolbecker"
"10/25/2016 0:00",27,37,8,6,"wolkig",64,"wolbecker"
"10/25/2016 1:00",6,24,8,6,"Regen",30,"wolbecker"
"10/25/2016 2:00",2,14,8,2,"Regen",16,"wolbecker"
"10/25/2016 3:00",2,10,8,6,"Regen",12,"wolbecker"
"10/25/2016 4:00",8,6,8,4,"Regen",14,"wolbecker"
"10/25/2016 5:00",35,46,8,4,"Regen",81,"wolbecker"
"10/25/2016 6:00",127,185,8,6,"Regen",312,"wolbecker"
"10/25/2016 7:00",716,324,8,4,"wolkig",1040,"wolbecker"
"10/25/2016 8:00",639,284,8,7,"wolkig",923,"wolbecker"
"10/25/2016 9:00",538,198,8,7,"wolkig",736,"wolbecker"
"10/25/2016 10:00",294,192,8,7,"wolkig",486,"wolbecker"
"10/25/2016 11:00",279,232,8,9,"wolkig",511,"wolbecker"
"10/25/2016 12:00",325,331,9,7,"wolkig",656,"wolbecker"
"10/25/2016 13:00",348,376,9,7,"wolkig",724,"wolbecker"
"10/25/2016 14:00",324,403,9,6,"wolkig",727,"wolbecker"
"10/25/2016 15:00",415,463,9,4,"wolkig",878,"wolbecker"
"10/25/2016 16:00",426,596,9,4,"wolkig",1022,"wolbecker"
"10/25/2016 17:00",525,649,9,6,"wolkig",1174,"wolbecker"
"10/25/2016 18:00",393,569,7,0,"Nebel",962,"wolbecker"
"10/25/2016 19:00",337,490,6,0,"Nebel",827,"wolbecker"
"10/25/2016 20:00",209,253,7,2,"Nebel",462,"wolbecker"
"10/25/2016 21:00",184,185,4,0,"Nebel",369,"wolbecker"
"10/25/2016 22:00",170,184,5,4,"Nebel",354,"wolbecker"
"10/25/2016 23:00",98,85,4,4,"Nebel",183,"wolbecker"
"10/26/2016 0:00",40,28,2,2,"Nebel",68,"wolbecker"
"10/26/2016 1:00",13,21,2,0,"Nebel",34,"wolbecker"
"10/26/2016 2:00",4,17,2,0,"Nebel",21,"wolbecker"
"10/26/2016 3:00",9,12,3,2,"wolkig",21,"wolbecker"
"10/26/2016 4:00",4,7,4,0,"wolkig",11,"wolbecker"
"10/26/2016 5:00",41,46,5,0,"wolkig",87,"wolbecker"
"10/26/2016 6:00",152,204,5,0,"wolkig",356,"wolbecker"
"10/26/2016 7:00",739,328,5,0,"wolkig",1067,"wolbecker"
"10/26/2016 8:00",691,283,6,0,"wolkig",974,"wolbecker"
"10/26/2016 9:00",597,221,7,6,"wolkig",818,"wolbecker"
"10/26/2016 10:00",386,244,8,2,"wolkig",630,"wolbecker"
"10/26/2016 11:00",423,281,9,0,"wolkig",704,"wolbecker"
"10/26/2016 12:00",377,423,10,6,"wolkig",800,"wolbecker"
"10/26/2016 13:00",447,457,10,4,"wolkig",904,"wolbecker"
"10/26/2016 14:00",400,462,10,4,"wolkig",862,"wolbecker"
"10/26/2016 15:00",422,480,11,4,"wolkig",902,"wolbecker"
"10/26/2016 16:00",432,619,11,6,"wolkig",1051,"wolbecker"
"10/26/2016 17:00",563,585,10,6,NA,1148,"wolbecker"
"10/26/2016 18:00",440,611,8,6,"Nebel",1051,"wolbecker"
"10/26/2016 19:00",352,475,8,6,"wolkig",827,"wolbecker"
"10/26/2016 20:00",244,265,8,7,"wolkig",509,"wolbecker"
"10/26/2016 21:00",150,213,8,6,"wolkig",363,"wolbecker"
"10/26/2016 22:00",197,196,8,7,"wolkig",393,"wolbecker"
"10/26/2016 23:00",85,135,9,9,"wolkig",220,"wolbecker"
"10/27/2016 0:00",44,64,9,7,NA,108,"wolbecker"
"10/27/2016 1:00",39,37,9,6,"wolkig",76,"wolbecker"
"10/27/2016 2:00",25,29,9,6,"wolkig",54,"wolbecker"
"10/27/2016 3:00",21,10,9,7,"wolkig",31,"wolbecker"
"10/27/2016 4:00",21,9,9,7,"wolkig",30,"wolbecker"
"10/27/2016 5:00",37,45,9,6,"wolkig",82,"wolbecker"
"10/27/2016 6:00",146,189,9,7,"wolkig",335,"wolbecker"
"10/27/2016 7:00",713,306,10,9,"wolkig",1019,"wolbecker"
"10/27/2016 8:00",667,274,10,9,"wolkig",941,"wolbecker"
"10/27/2016 9:00",576,220,10,9,"wolkig",796,"wolbecker"
"10/27/2016 10:00",355,216,10,11,"wolkig",571,"wolbecker"
"10/27/2016 11:00",348,260,11,11,"wolkig",608,"wolbecker"
"10/27/2016 12:00",332,348,12,13,"wolkig",680,"wolbecker"
"10/27/2016 13:00",403,401,12,13,"wolkig",804,"wolbecker"
"10/27/2016 14:00",353,440,12,15,"wolkig",793,"wolbecker"
"10/27/2016 15:00",446,513,12,17,"wolkig",959,"wolbecker"
"10/27/2016 16:00",512,628,12,11,"wolkig",1140,"wolbecker"
"10/27/2016 17:00",511,654,12,13,"wolkig",1165,"wolbecker"
"10/27/2016 18:00",461,555,11,11,"wolkig",1016,"wolbecker"
"10/27/2016 19:00",374,470,11,9,"wolkig",844,"wolbecker"
"10/27/2016 20:00",207,319,11,13,"wolkig",526,"wolbecker"
"10/27/2016 21:00",174,215,11,13,"wolkig",389,"wolbecker"
"10/27/2016 22:00",206,189,11,11,"teilweise bewölkt",395,"wolbecker"
"10/27/2016 23:00",91,80,11,17,"wolkig",171,"wolbecker"
"10/28/2016 0:00",46,46,11,17,"wolkig",92,"wolbecker"
"10/28/2016 1:00",30,23,12,15,"wolkig",53,"wolbecker"
"10/28/2016 2:00",17,16,11,15,"teilweise bewölkt",33,"wolbecker"
"10/28/2016 3:00",8,4,12,17,"wolkig",12,"wolbecker"
"10/28/2016 4:00",6,10,12,19,"wolkig",16,"wolbecker"
"10/28/2016 5:00",32,43,12,19,"wolkig",75,"wolbecker"
"10/28/2016 6:00",144,165,12,17,"wolkig",309,"wolbecker"
"10/28/2016 7:00",643,290,12,17,"wolkig",933,"wolbecker"
"10/28/2016 8:00",552,260,12,19,"wolkig",812,"wolbecker"
"10/28/2016 9:00",495,194,12,19,"wolkig",689,"wolbecker"
"10/28/2016 10:00",345,223,13,19,"wolkig",568,"wolbecker"
"10/28/2016 11:00",373,272,13,22,"wolkig",645,"wolbecker"
"10/28/2016 12:00",406,414,13,24,"Regen",820,"wolbecker"
"10/28/2016 13:00",408,532,13,24,"Regen",940,"wolbecker"
"10/28/2016 14:00",426,512,13,19,"Regen",938,"wolbecker"
"10/28/2016 15:00",416,539,13,20,"wolkig",955,"wolbecker"
"10/28/2016 16:00",378,493,13,19,"Regen",871,"wolbecker"
"10/28/2016 17:00",432,466,13,17,"Regen",898,"wolbecker"
"10/28/2016 18:00",340,422,13,15,"Regen",762,"wolbecker"
"10/28/2016 19:00",271,339,13,11,"wolkig",610,"wolbecker"
"10/28/2016 20:00",232,220,12,9,"wolkig",452,"wolbecker"
"10/28/2016 21:00",160,166,12,11,"wolkig",326,"wolbecker"
"10/28/2016 22:00",169,163,11,11,"wolkig",332,"wolbecker"
"10/28/2016 23:00",91,170,9,7,NA,261,"wolbecker"
"10/29/2016 0:00",80,100,8,7,"Nebel",180,"wolbecker"
"10/29/2016 1:00",61,107,8,7,"Nebel",168,"wolbecker"
"10/29/2016 2:00",59,59,6,6,"Nebel",118,"wolbecker"
"10/29/2016 3:00",42,31,7,6,"Nebel",73,"wolbecker"
"10/29/2016 4:00",32,24,6,4,"Nebel",56,"wolbecker"
"10/29/2016 5:00",27,19,7,6,"Nebel",46,"wolbecker"
"10/29/2016 6:00",28,30,6,9,"Nebel",58,"wolbecker"
"10/29/2016 7:00",74,48,6,0,"Nebel",122,"wolbecker"
"10/29/2016 8:00",132,107,5,0,"Nebel",239,"wolbecker"
"10/29/2016 9:00",300,140,8,0,"Nebel",440,"wolbecker"
"10/29/2016 10:00",360,205,9,6,"teilweise bewölkt",565,"wolbecker"
"10/29/2016 11:00",476,293,11,7,"teilweise bewölkt",769,"wolbecker"
"10/29/2016 12:00",446,377,12,13,"teilweise bewölkt",823,"wolbecker"
"10/29/2016 13:00",436,416,13,13,"teilweise bewölkt",852,"wolbecker"
"10/29/2016 14:00",386,423,14,13,"teilweise bewölkt",809,"wolbecker"
"10/29/2016 15:00",309,391,13,9,"teilweise bewölkt",700,"wolbecker"
"10/29/2016 16:00",270,396,13,6,"teilweise bewölkt",666,"wolbecker"
"10/29/2016 17:00",299,393,11,6,"teilweise bewölkt",692,"wolbecker"
"10/29/2016 18:00",319,375,9,4,"teilweise bewölkt",694,"wolbecker"
"10/29/2016 19:00",219,290,8,6,"teilweise bewölkt",509,"wolbecker"
"10/29/2016 20:00",184,202,7,2,"Nebel",386,"wolbecker"
"10/29/2016 21:00",147,154,5,0,"Nebel",301,"wolbecker"
"10/29/2016 22:00",171,142,5,0,"Nebel",313,"wolbecker"
"10/29/2016 23:00",134,116,5,2,"Klarer Himmel",250,"wolbecker"
"10/30/2016 0:00",85,98,7,0,"Klarer Himmel",183,"wolbecker"
"10/30/2016 1:00",100,92,6,2,"Nebel",192,"wolbecker"
"10/30/2016 2:00",107,124,6,2,"Nebel",231,"wolbecker"
"10/30/2016 3:00",20,38,4,0,"Nebel",58,"wolbecker"
"10/30/2016 4:00",29,19,5,4,"Nebel",48,"wolbecker"
"10/30/2016 5:00",17,15,6,9,"wolkig",32,"wolbecker"
"10/30/2016 6:00",24,16,5,4,"Nebel",40,"wolbecker"
"10/30/2016 7:00",19,25,6,4,"wolkig",44,"wolbecker"
"10/30/2016 8:00",50,58,7,2,NA,108,"wolbecker"
"10/30/2016 9:00",106,86,8,2,"wolkig",192,"wolbecker"
"10/30/2016 10:00",135,111,9,4,"wolkig",246,"wolbecker"
"10/30/2016 11:00",171,120,10,6,"wolkig",291,"wolbecker"
"10/30/2016 12:00",184,138,12,4,"wolkig",322,"wolbecker"
"10/30/2016 13:00",222,178,12,2,"wolkig",400,"wolbecker"
"10/30/2016 14:00",258,217,12,7,"wolkig",475,"wolbecker"
"10/30/2016 15:00",269,230,12,2,"wolkig",499,"wolbecker"
"10/30/2016 16:00",247,255,9,2,"Nebel",502,"wolbecker"
"10/30/2016 17:00",258,264,8,0,"Nebel",522,"wolbecker"
"10/30/2016 18:00",225,196,9,0,"wolkig",421,"wolbecker"
"10/30/2016 19:00",169,153,9,4,"wolkig",322,"wolbecker"
"10/30/2016 20:00",130,120,9,4,"wolkig",250,"wolbecker"
"10/30/2016 21:00",114,86,9,4,"wolkig",200,"wolbecker"
"10/30/2016 22:00",105,58,9,6,"wolkig",163,"wolbecker"
"10/30/2016 23:00",50,39,NA,NA,NA,89,"wolbecker"
"10/31/2016 0:00",14,21,9,4,"wolkig",35,"wolbecker"
"10/31/2016 1:00",9,7,9,4,"wolkig",16,"wolbecker"
"10/31/2016 2:00",3,4,9,0,"wolkig",7,"wolbecker"
"10/31/2016 3:00",2,7,10,7,"wolkig",9,"wolbecker"
"10/31/2016 4:00",0,0,9,2,"wolkig",0,"wolbecker"
"10/31/2016 5:00",32,31,9,2,"wolkig",63,"wolbecker"
"10/31/2016 6:00",118,147,9,2,"wolkig",265,"wolbecker"
"10/31/2016 7:00",523,271,9,2,"wolkig",794,"wolbecker"
"10/31/2016 8:00",481,231,10,6,"wolkig",712,"wolbecker"
"10/31/2016 9:00",511,187,10,6,"wolkig",698,"wolbecker"
"10/31/2016 10:00",418,249,11,2,"wolkig",667,"wolbecker"
"10/31/2016 11:00",462,285,13,4,"wolkig",747,"wolbecker"
"10/31/2016 12:00",422,389,13,6,"wolkig",811,"wolbecker"
"10/31/2016 13:00",446,438,15,6,"wolkig",884,"wolbecker"
"10/31/2016 14:00",400,449,15,6,"wolkig",849,"wolbecker"
"10/31/2016 15:00",463,492,14,9,"wolkig",955,"wolbecker"
"10/31/2016 16:00",460,652,13,4,"wolkig",1112,"wolbecker"
"10/31/2016 17:00",470,578,11,4,"teilweise bewölkt",1048,"wolbecker"
"10/31/2016 18:00",363,565,9,4,"Klarer Himmel",928,"wolbecker"
"10/31/2016 19:00",332,442,8,0,"Nebel",774,"wolbecker"
"10/31/2016 20:00",259,297,8,4,"Nebel",556,"wolbecker"
"10/31/2016 21:00",198,211,6,2,"Nebel",409,"wolbecker"
"10/31/2016 22:00",174,146,5,2,"Nebel",320,"wolbecker"
"10/31/2016 23:00",136,134,6,6,"Nebel",270,"wolbecker"
"11/1/2016 0:00",103,155,NA,NA,NA,258,"wolbecker"
"11/1/2016 1:00",113,169,NA,NA,NA,282,"wolbecker"
"11/1/2016 2:00",96,107,NA,NA,NA,203,"wolbecker"
"11/1/2016 3:00",96,80,NA,NA,NA,176,"wolbecker"
"11/1/2016 4:00",77,33,NA,NA,NA,110,"wolbecker"
"11/1/2016 5:00",56,20,NA,NA,NA,76,"wolbecker"
"11/1/2016 6:00",43,48,NA,NA,NA,91,"wolbecker"
"11/1/2016 7:00",30,46,NA,NA,NA,76,"wolbecker"
"11/1/2016 8:00",65,63,NA,NA,NA,128,"wolbecker"
"11/1/2016 9:00",111,106,NA,NA,NA,217,"wolbecker"
"11/1/2016 10:00",136,132,NA,NA,NA,268,"wolbecker"
"11/1/2016 11:00",180,170,NA,NA,NA,350,"wolbecker"
"11/1/2016 12:00",181,187,NA,NA,NA,368,"wolbecker"
"11/1/2016 13:00",208,193,NA,NA,NA,401,"wolbecker"
"11/1/2016 14:00",216,197,NA,NA,NA,413,"wolbecker"
"11/1/2016 15:00",189,203,NA,NA,NA,392,"wolbecker"
"11/1/2016 16:00",181,264,NA,NA,NA,445,"wolbecker"
"11/1/2016 17:00",245,233,NA,NA,NA,478,"wolbecker"
"11/1/2016 18:00",205,160,NA,NA,NA,365,"wolbecker"
"11/1/2016 19:00",166,151,NA,NA,NA,317,"wolbecker"
"11/1/2016 20:00",143,118,NA,NA,NA,261,"wolbecker"
"11/1/2016 21:00",139,85,NA,NA,NA,224,"wolbecker"
"11/1/2016 22:00",113,68,NA,NA,NA,181,"wolbecker"
"11/1/2016 23:00",62,38,NA,NA,NA,100,"wolbecker"
"11/2/2016 0:00",14,10,4,9,"Nebel",24,"wolbecker"
"11/2/2016 1:00",9,11,5,9,"Klarer Himmel",20,"wolbecker"
"11/2/2016 2:00",1,4,4,9,"teilweise bewölkt",5,"wolbecker"
"11/2/2016 3:00",4,3,4,11,"teilweise bewölkt",7,"wolbecker"
"11/2/2016 4:00",8,8,4,7,"teilweise bewölkt",16,"wolbecker"
"11/2/2016 5:00",43,47,5,15,"wolkig",90,"wolbecker"
"11/2/2016 6:00",144,231,5,13,"Klarer Himmel",375,"wolbecker"
"11/2/2016 7:00",676,278,6,15,"Regen",954,"wolbecker"
"11/2/2016 8:00",635,262,6,17,"teilweise bewölkt",897,"wolbecker"
"11/2/2016 9:00",578,188,8,28,"wolkig",766,"wolbecker"
"11/2/2016 10:00",399,238,9,26,"teilweise bewölkt",637,"wolbecker"
"11/2/2016 11:00",379,290,9,20,"Regen",669,"wolbecker"
"11/2/2016 12:00",352,372,10,22,"wolkig",724,"wolbecker"
"11/2/2016 13:00",384,378,5,26,"Regen",762,"wolbecker"
"11/2/2016 14:00",381,431,10,24,"Regen",812,"wolbecker"
"11/2/2016 15:00",365,452,8,20,"Regen",817,"wolbecker"
"11/2/2016 16:00",431,576,8,11,"Regen",1007,"wolbecker"
"11/2/2016 17:00",502,590,6,11,"teilweise bewölkt",1092,"wolbecker"
"11/2/2016 18:00",388,587,6,15,"teilweise bewölkt",975,"wolbecker"
"11/2/2016 19:00",333,431,7,15,"wolkig",764,"wolbecker"
"11/2/2016 20:00",197,260,6,11,"teilweise bewölkt",457,"wolbecker"
"11/2/2016 21:00",153,218,5,6,"teilweise bewölkt",371,"wolbecker"
"11/2/2016 22:00",166,182,5,4,"wolkig",348,"wolbecker"
"11/2/2016 23:00",84,164,5,0,"wolkig",248,"wolbecker"
"11/3/2016 0:00",72,82,6,2,"wolkig",154,"wolbecker"
"11/3/2016 1:00",39,51,5,6,"wolkig",90,"wolbecker"
"11/3/2016 2:00",35,15,6,7,"wolkig",50,"wolbecker"
"11/3/2016 3:00",44,6,6,7,"wolkig",50,"wolbecker"
"11/3/2016 4:00",48,13,6,9,"wolkig",61,"wolbecker"
"11/3/2016 5:00",40,45,5,4,"wolkig",85,"wolbecker"
"11/3/2016 6:00",149,201,3,6,"Nebel",350,"wolbecker"
"11/3/2016 7:00",737,336,4,6,"Nebel",1073,"wolbecker"
"11/3/2016 8:00",630,302,5,7,"wolkig",932,"wolbecker"
"11/3/2016 9:00",566,204,6,7,"wolkig",770,"wolbecker"
"11/3/2016 10:00",417,214,7,7,"wolkig",631,"wolbecker"
"11/3/2016 11:00",389,308,8,11,"teilweise bewölkt",697,"wolbecker"
"11/3/2016 12:00",348,404,9,15,"teilweise bewölkt",752,"wolbecker"
"11/3/2016 13:00",410,392,9,17,"teilweise bewölkt",802,"wolbecker"
"11/3/2016 14:00",377,465,9,17,"teilweise bewölkt",842,"wolbecker"
"11/3/2016 15:00",422,547,8,11,"wolkig",969,"wolbecker"
"11/3/2016 16:00",467,613,8,11,"Klarer Himmel",1080,"wolbecker"
"11/3/2016 17:00",494,592,8,7,"wolkig",1086,"wolbecker"
"11/3/2016 18:00",441,595,7,7,"Klarer Himmel",1036,"wolbecker"
"11/3/2016 19:00",325,441,7,7,NA,766,"wolbecker"
"11/3/2016 20:00",215,260,7,9,NA,475,"wolbecker"
"11/3/2016 21:00",173,158,7,9,"wolkig",331,"wolbecker"
"11/3/2016 22:00",152,169,7,7,"wolkig",321,"wolbecker"
"11/3/2016 23:00",81,89,7,11,"wolkig",170,"wolbecker"
"11/4/2016 0:00",40,46,7,9,"wolkig",86,"wolbecker"
"11/4/2016 1:00",25,20,7,11,"wolkig",45,"wolbecker"
"11/4/2016 2:00",13,7,7,13,"Klarer Himmel",20,"wolbecker"
"11/4/2016 3:00",1,4,7,15,"Klarer Himmel",5,"wolbecker"
"11/4/2016 4:00",4,6,7,15,"Klarer Himmel",10,"wolbecker"
"11/4/2016 5:00",32,40,7,13,"wolkig",72,"wolbecker"
"11/4/2016 6:00",141,178,7,15,"Klarer Himmel",319,"wolbecker"
"11/4/2016 7:00",681,310,7,11,"Klarer Himmel",991,"wolbecker"
"11/4/2016 8:00",538,250,7,17,"wolkig",788,"wolbecker"
"11/4/2016 9:00",509,232,8,17,"Klarer Himmel",741,"wolbecker"
"11/4/2016 10:00",387,223,8,15,"Klarer Himmel",610,"wolbecker"
"11/4/2016 11:00",359,336,9,13,"wolkig",695,"wolbecker"
"11/4/2016 12:00",406,430,10,15,"wolkig",836,"wolbecker"
"11/4/2016 13:00",438,510,10,17,"wolkig",948,"wolbecker"
"11/4/2016 14:00",438,538,10,11,"Klarer Himmel",976,"wolbecker"
"11/4/2016 15:00",400,518,10,9,"Klarer Himmel",918,"wolbecker"
"11/4/2016 16:00",420,488,8,6,"Klarer Himmel",908,"wolbecker"
"11/4/2016 17:00",386,471,7,7,"Klarer Himmel",857,"wolbecker"
"11/4/2016 18:00",298,487,7,7,"Klarer Himmel",785,"wolbecker"
"11/4/2016 19:00",264,342,6,7,"Klarer Himmel",606,"wolbecker"
"11/4/2016 20:00",175,213,6,9,"Klarer Himmel",388,"wolbecker"
"11/4/2016 21:00",140,151,6,9,"Klarer Himmel",291,"wolbecker"
"11/4/2016 22:00",173,124,6,11,"Klarer Himmel",297,"wolbecker"
"11/4/2016 23:00",130,119,6,9,"Klarer Himmel",249,"wolbecker"
"11/5/2016 0:00",112,107,7,11,"wolkig",219,"wolbecker"
"11/5/2016 1:00",73,80,7,9,"wolkig",153,"wolbecker"
"11/5/2016 2:00",44,35,7,9,"wolkig",79,"wolbecker"
"11/5/2016 3:00",43,48,7,9,"wolkig",91,"wolbecker"
"11/5/2016 4:00",33,16,7,7,"Regen",49,"wolbecker"
"11/5/2016 5:00",35,18,6,9,"Regen",53,"wolbecker"
"11/5/2016 6:00",34,27,7,9,"wolkig",61,"wolbecker"
"11/5/2016 7:00",74,47,7,11,"Regen",121,"wolbecker"
"11/5/2016 8:00",123,83,7,13,"wolkig",206,"wolbecker"
"11/5/2016 9:00",279,138,7,17,"wolkig",417,"wolbecker"
"11/5/2016 10:00",303,207,7,13,"wolkig",510,"wolbecker"
"11/5/2016 11:00",298,238,8,15,"wolkig",536,"wolbecker"
"11/5/2016 12:00",380,298,8,11,"wolkig",678,"wolbecker"
"11/5/2016 13:00",367,361,8,17,"wolkig",728,"wolbecker"
"11/5/2016 14:00",310,379,9,19,"teilweise bewölkt",689,"wolbecker"
"11/5/2016 15:00",283,342,9,11,"teilweise bewölkt",625,"wolbecker"
"11/5/2016 16:00",289,334,7,7,"wolkig",623,"wolbecker"
"11/5/2016 17:00",217,317,6,7,"wolkig",534,"wolbecker"
"11/5/2016 18:00",172,272,6,7,"wolkig",444,"wolbecker"
"11/5/2016 19:00",186,217,5,9,"Klarer Himmel",403,"wolbecker"
"11/5/2016 20:00",142,146,6,11,"wolkig",288,"wolbecker"
"11/5/2016 21:00",106,89,6,13,"teilweise bewölkt",195,"wolbecker"
"11/5/2016 22:00",116,78,6,15,"wolkig",194,"wolbecker"
"11/5/2016 23:00",107,109,6,13,"wolkig",216,"wolbecker"
"11/6/2016 0:00",87,82,6,13,"teilweise bewölkt",169,"wolbecker"
"11/6/2016 1:00",72,54,6,15,"wolkig",126,"wolbecker"
"11/6/2016 2:00",36,45,5,11,"teilweise bewölkt",81,"wolbecker"
"11/6/2016 3:00",46,33,5,15,"teilweise bewölkt",79,"wolbecker"
"11/6/2016 4:00",30,15,5,13,"wolkig",45,"wolbecker"
"11/6/2016 5:00",27,14,5,19,"wolkig",41,"wolbecker"
"11/6/2016 6:00",15,8,5,17,"wolkig",23,"wolbecker"
"11/6/2016 7:00",20,28,5,13,"wolkig",48,"wolbecker"
"11/6/2016 8:00",34,43,6,19,"wolkig",77,"wolbecker"
"11/6/2016 9:00",88,56,6,17,"wolkig",144,"wolbecker"
"11/6/2016 10:00",142,110,6,17,"wolkig",252,"wolbecker"
"11/6/2016 11:00",108,83,7,19,"wolkig",191,"wolbecker"
"11/6/2016 12:00",177,134,7,22,"wolkig",311,"wolbecker"
"11/6/2016 13:00",162,152,7,20,"wolkig",314,"wolbecker"
"11/6/2016 14:00",187,164,7,20,"wolkig",351,"wolbecker"
"11/6/2016 15:00",175,153,7,13,"Regen",328,"wolbecker"
"11/6/2016 16:00",173,156,7,15,"Regen",329,"wolbecker"
"11/6/2016 17:00",172,130,6,9,"Regen",302,"wolbecker"
"11/6/2016 18:00",160,137,6,13,"wolkig",297,"wolbecker"
"11/6/2016 19:00",168,148,6,11,"wolkig",316,"wolbecker"
"11/6/2016 20:00",144,81,6,9,"wolkig",225,"wolbecker"
"11/6/2016 21:00",106,72,6,7,"wolkig",178,"wolbecker"
"11/6/2016 22:00",85,55,6,7,"wolkig",140,"wolbecker"
"11/6/2016 23:00",41,20,6,4,"wolkig",61,"wolbecker"
"11/7/2016 0:00",17,12,6,4,"wolkig",29,"wolbecker"
"11/7/2016 1:00",10,8,6,4,"wolkig",18,"wolbecker"
"11/7/2016 2:00",3,2,6,4,"wolkig",5,"wolbecker"
"11/7/2016 3:00",1,1,6,6,"wolkig",2,"wolbecker"
"11/7/2016 4:00",7,3,6,2,"wolkig",10,"wolbecker"
"11/7/2016 5:00",24,29,6,4,"Regen",53,"wolbecker"
"11/7/2016 6:00",137,183,6,2,"Regen",320,"wolbecker"
"11/7/2016 7:00",651,314,6,2,"Regen",965,"wolbecker"
"11/7/2016 8:00",585,251,6,2,"Regen",836,"wolbecker"
"11/7/2016 9:00",441,170,6,9,"Regen",611,"wolbecker"
"11/7/2016 10:00",300,170,6,13,"Regen",470,"wolbecker"
"11/7/2016 11:00",251,175,5,9,"Regen",426,"wolbecker"
"11/7/2016 12:00",253,267,5,11,"Regen",520,"wolbecker"
"11/7/2016 13:00",291,299,5,13,"Regen",590,"wolbecker"
"11/7/2016 14:00",246,292,5,7,"Regen",538,"wolbecker"
"11/7/2016 15:00",288,341,4,13,"Regen",629,"wolbecker"
"11/7/2016 16:00",352,442,4,6,"Regen",794,"wolbecker"
"11/7/2016 17:00",409,491,4,13,"Regen",900,"wolbecker"
"11/7/2016 18:00",281,430,3,15,"Regen",711,"wolbecker"
"11/7/2016 19:00",211,285,3,15,"Regen",496,"wolbecker"
"11/7/2016 20:00",119,194,3,15,"Regen",313,"wolbecker"
"11/7/2016 21:00",105,117,2,13,"Regen",222,"wolbecker"
"11/7/2016 22:00",79,96,2,13,"Regen",175,"wolbecker"
"11/7/2016 23:00",44,50,2,11,"Regen",94,"wolbecker"
"11/8/2016 0:00",26,21,2,11,"Regen",47,"wolbecker"
"11/8/2016 1:00",9,14,2,11,"wolkig",23,"wolbecker"
"11/8/2016 2:00",0,4,2,9,"Regen",4,"wolbecker"
"11/8/2016 3:00",4,2,2,11,"wolkig",6,"wolbecker"
"11/8/2016 4:00",1,3,2,9,"wolkig",4,"wolbecker"
"11/8/2016 5:00",29,34,2,9,"wolkig",63,"wolbecker"
"11/8/2016 6:00",131,188,2,11,"wolkig",319,"wolbecker"
"11/8/2016 7:00",671,324,2,9,"wolkig",995,"wolbecker"
"11/8/2016 8:00",600,258,2,7,"wolkig",858,"wolbecker"
"11/8/2016 9:00",460,199,2,7,"wolkig",659,"wolbecker"
"11/8/2016 10:00",314,205,3,11,"wolkig",519,"wolbecker"
"11/8/2016 11:00",344,227,3,7,"wolkig",571,"wolbecker"
"11/8/2016 12:00",291,336,3,7,"wolkig",627,"wolbecker"
"11/8/2016 13:00",362,335,3,7,"wolkig",697,"wolbecker"
"11/8/2016 14:00",348,395,4,13,"wolkig",743,"wolbecker"
"11/8/2016 15:00",401,486,3,7,"wolkig",887,"wolbecker"
"11/8/2016 16:00",428,585,2,6,"teilweise bewölkt",1013,"wolbecker"
"11/8/2016 17:00",493,586,0,4,"Klarer Himmel",1079,"wolbecker"
"11/8/2016 18:00",384,535,0,6,"wolkig",919,"wolbecker"
"11/8/2016 19:00",313,437,0,6,"wolkig",750,"wolbecker"
"11/8/2016 20:00",201,236,0,6,"wolkig",437,"wolbecker"
"11/8/2016 21:00",158,179,0,6,NA,337,"wolbecker"
"11/8/2016 22:00",156,149,0,7,NA,305,"wolbecker"
"11/8/2016 23:00",73,70,0,7,"wolkig",143,"wolbecker"
"11/9/2016 0:00",41,32,1,9,"wolkig",73,"wolbecker"
"11/9/2016 1:00",17,20,1,11,"Schnee",37,"wolbecker"
"11/9/2016 2:00",5,7,1,7,"wolkig",12,"wolbecker"
"11/9/2016 3:00",4,10,1,7,"wolkig",14,"wolbecker"
"11/9/2016 4:00",5,4,0,6,"teilweise bewölkt",9,"wolbecker"
"11/9/2016 5:00",38,44,0,4,NA,82,"wolbecker"
"11/9/2016 6:00",107,188,0,4,"wolkig",295,"wolbecker"
"11/9/2016 7:00",695,316,0,6,"teilweise bewölkt",1011,"wolbecker"
"11/9/2016 8:00",639,274,0,6,"teilweise bewölkt",913,"wolbecker"
"11/9/2016 9:00",509,211,1,6,"wolkig",720,"wolbecker"
"11/9/2016 10:00",401,227,2,9,"teilweise bewölkt",628,"wolbecker"
"11/9/2016 11:00",354,254,3,7,"teilweise bewölkt",608,"wolbecker"
"11/9/2016 12:00",345,341,4,7,"wolkig",686,"wolbecker"
"11/9/2016 13:00",374,383,4,11,"wolkig",757,"wolbecker"
"11/9/2016 14:00",336,397,5,11,"Regen",733,"wolbecker"
"11/9/2016 15:00",336,456,4,7,"Regen",792,"wolbecker"
"11/9/2016 16:00",403,522,4,6,"Regen",925,"wolbecker"
"11/9/2016 17:00",452,491,4,7,"Regen",943,"wolbecker"
"11/9/2016 18:00",310,476,3,6,"Regen",786,"wolbecker"
"11/9/2016 19:00",263,352,3,7,"Regen",615,"wolbecker"
"11/9/2016 20:00",167,225,3,7,"Regen",392,"wolbecker"
"11/9/2016 21:00",129,165,3,6,"Regen",294,"wolbecker"
"11/9/2016 22:00",139,100,3,6,"Regen",239,"wolbecker"
"11/9/2016 23:00",70,61,3,4,"wolkig",131,"wolbecker"
"11/10/2016 0:00",37,38,3,4,"wolkig",75,"wolbecker"
"11/10/2016 1:00",18,29,3,4,"wolkig",47,"wolbecker"
"11/10/2016 2:00",12,21,3,6,"wolkig",33,"wolbecker"
"11/10/2016 3:00",7,12,3,4,"wolkig",19,"wolbecker"
"11/10/2016 4:00",12,8,3,2,"wolkig",20,"wolbecker"
"11/10/2016 5:00",36,44,3,4,"wolkig",80,"wolbecker"
"11/10/2016 6:00",109,181,3,4,"wolkig",290,"wolbecker"
"11/10/2016 7:00",611,317,3,2,"Regen",928,"wolbecker"
"11/10/2016 8:00",552,248,3,2,"Regen",800,"wolbecker"
"11/10/2016 9:00",474,182,3,2,"Regen",656,"wolbecker"
"11/10/2016 10:00",255,158,4,0,"wolkig",413,"wolbecker"
"11/10/2016 11:00",216,194,4,4,"wolkig",410,"wolbecker"
"11/10/2016 12:00",244,268,4,7,"wolkig",512,"wolbecker"
"11/10/2016 13:00",278,325,4,7,"wolkig",603,"wolbecker"
"11/10/2016 14:00",287,333,4,4,"wolkig",620,"wolbecker"
"11/10/2016 15:00",353,378,4,6,"wolkig",731,"wolbecker"
"11/10/2016 16:00",412,497,4,4,"wolkig",909,"wolbecker"
"11/10/2016 17:00",437,544,4,4,"wolkig",981,"wolbecker"
"11/10/2016 18:00",393,482,4,4,"wolkig",875,"wolbecker"
"11/10/2016 19:00",298,362,4,6,"wolkig",660,"wolbecker"
"11/10/2016 20:00",181,218,4,7,"wolkig",399,"wolbecker"
"11/10/2016 21:00",142,181,4,7,"wolkig",323,"wolbecker"
"11/10/2016 22:00",133,148,4,9,"wolkig",281,"wolbecker"
"11/10/2016 23:00",72,84,4,6,"wolkig",156,"wolbecker"
"11/11/2016 0:00",30,48,4,7,"Regen",78,"wolbecker"
"11/11/2016 1:00",17,34,4,15,"Regen",51,"wolbecker"
"11/11/2016 2:00",26,9,3,15,"Regen",35,"wolbecker"
"11/11/2016 3:00",12,6,3,13,"Regen",18,"wolbecker"
"11/11/2016 4:00",11,4,3,17,"Regen",15,"wolbecker"
"11/11/2016 5:00",39,41,3,22,"wolkig",80,"wolbecker"
"11/11/2016 6:00",97,146,3,24,"wolkig",243,"wolbecker"
"11/11/2016 7:00",582,276,3,17,"wolkig",858,"wolbecker"
"11/11/2016 8:00",471,289,2,20,"wolkig",760,"wolbecker"
"11/11/2016 9:00",431,210,2,15,"wolkig",641,"wolbecker"
"11/11/2016 10:00",343,212,2,19,"wolkig",555,"wolbecker"
"11/11/2016 11:00",317,255,3,19,"teilweise bewölkt",572,"wolbecker"
"11/11/2016 12:00",340,363,3,11,"teilweise bewölkt",703,"wolbecker"
"11/11/2016 13:00",404,506,3,17,"teilweise bewölkt",910,"wolbecker"
"11/11/2016 14:00",353,471,3,13,"wolkig",824,"wolbecker"
"11/11/2016 15:00",369,473,3,11,"wolkig",842,"wolbecker"
"11/11/2016 16:00",344,483,2,7,"wolkig",827,"wolbecker"
"11/11/2016 17:00",346,434,2,9,"wolkig",780,"wolbecker"
"11/11/2016 18:00",302,361,1,7,"wolkig",663,"wolbecker"
"11/11/2016 19:00",246,350,1,4,"wolkig",596,"wolbecker"
"11/11/2016 20:00",175,179,1,9,"wolkig",354,"wolbecker"
"11/11/2016 21:00",138,159,-1,4,"teilweise bewölkt",297,"wolbecker"
"11/11/2016 22:00",158,113,-2,2,NA,271,"wolbecker"
"11/11/2016 23:00",114,115,-3,0,"Nebel",229,"wolbecker"
"11/12/2016 0:00",78,91,-3,0,"Nebel",169,"wolbecker"
"11/12/2016 1:00",62,50,-2,4,"Nebel",112,"wolbecker"
"11/12/2016 2:00",54,50,-2,4,"Nebel",104,"wolbecker"
"11/12/2016 3:00",36,23,-2,7,"Nebel",59,"wolbecker"
"11/12/2016 4:00",44,12,-2,6,"Nebel",56,"wolbecker"
"11/12/2016 5:00",31,17,-2,4,"Nebel",48,"wolbecker"
"11/12/2016 6:00",26,23,-2,6,"Nebel",49,"wolbecker"
"11/12/2016 7:00",69,49,-2,7,"Nebel",118,"wolbecker"
"11/12/2016 8:00",137,71,-2,9,"Nebel",208,"wolbecker"
"11/12/2016 9:00",282,136,-1,7,NA,418,"wolbecker"
"11/12/2016 10:00",332,166,1,9,NA,498,"wolbecker"
"11/12/2016 11:00",376,216,2,13,"Klarer Himmel",592,"wolbecker"
"11/12/2016 12:00",361,283,3,13,"Klarer Himmel",644,"wolbecker"
"11/12/2016 13:00",371,344,3,19,"Klarer Himmel",715,"wolbecker"
"11/12/2016 14:00",305,373,3,17,"Klarer Himmel",678,"wolbecker"
"11/12/2016 15:00",287,391,3,9,"wolkig",678,"wolbecker"
"11/12/2016 16:00",258,361,1,6,"Klarer Himmel",619,"wolbecker"
"11/12/2016 17:00",216,288,1,9,"wolkig",504,"wolbecker"
"11/12/2016 18:00",177,292,1,9,"Klarer Himmel",469,"wolbecker"
"11/12/2016 19:00",190,232,1,11,"Klarer Himmel",422,"wolbecker"
"11/12/2016 20:00",161,160,1,9,"Klarer Himmel",321,"wolbecker"
"11/12/2016 21:00",122,103,1,7,"Klarer Himmel",225,"wolbecker"
"11/12/2016 22:00",95,117,1,11,"Klarer Himmel",212,"wolbecker"
"11/12/2016 23:00",89,92,1,7,"Klarer Himmel",181,"wolbecker"
"11/13/2016 0:00",94,104,1,7,"Klarer Himmel",198,"wolbecker"
"11/13/2016 1:00",84,96,1,7,"Klarer Himmel",180,"wolbecker"
"11/13/2016 2:00",63,51,1,7,"Klarer Himmel",114,"wolbecker"
"11/13/2016 3:00",68,41,1,7,"Klarer Himmel",109,"wolbecker"
"11/13/2016 4:00",49,24,1,7,"Klarer Himmel",73,"wolbecker"
"11/13/2016 5:00",24,13,1,11,"Klarer Himmel",37,"wolbecker"
"11/13/2016 6:00",23,17,1,9,"Klarer Himmel",40,"wolbecker"
"11/13/2016 7:00",17,26,1,11,"Klarer Himmel",43,"wolbecker"
"11/13/2016 8:00",29,40,1,7,"Klarer Himmel",69,"wolbecker"
"11/13/2016 9:00",81,69,1,9,"Klarer Himmel",150,"wolbecker"
"11/13/2016 10:00",128,87,2,9,"Klarer Himmel",215,"wolbecker"
"11/13/2016 11:00",115,100,3,11,"Klarer Himmel",215,"wolbecker"
"11/13/2016 12:00",140,114,3,7,"Klarer Himmel",254,"wolbecker"
"11/13/2016 13:00",167,128,4,7,"Klarer Himmel",295,"wolbecker"
"11/13/2016 14:00",167,176,4,6,"Klarer Himmel",343,"wolbecker"
"11/13/2016 15:00",229,139,3,6,"Klarer Himmel",368,"wolbecker"
"11/13/2016 16:00",191,153,2,6,"Klarer Himmel",344,"wolbecker"
"11/13/2016 17:00",185,147,1,6,"Klarer Himmel",332,"wolbecker"
"11/13/2016 18:00",148,123,1,6,"Klarer Himmel",271,"wolbecker"
"11/13/2016 19:00",143,154,0,4,"Klarer Himmel",297,"wolbecker"
"11/13/2016 20:00",136,80,-1,4,"Klarer Himmel",216,"wolbecker"
"11/13/2016 21:00",94,56,0,6,"Klarer Himmel",150,"wolbecker"
"11/13/2016 22:00",86,66,-1,4,"Klarer Himmel",152,"wolbecker"
"11/13/2016 23:00",53,37,-2,4,"Klarer Himmel",90,"wolbecker"
"11/14/2016 0:00",21,11,-2,6,"Klarer Himmel",32,"wolbecker"
"11/14/2016 1:00",9,7,-2,2,"Klarer Himmel",16,"wolbecker"
"11/14/2016 2:00",4,3,-2,2,"Klarer Himmel",7,"wolbecker"
"11/14/2016 3:00",0,1,-2,4,"Klarer Himmel",1,"wolbecker"
"11/14/2016 4:00",2,6,-3,4,"Klarer Himmel",8,"wolbecker"
"11/14/2016 5:00",32,48,-3,4,"Klarer Himmel",80,"wolbecker"
"11/14/2016 6:00",126,187,-3,6,"Klarer Himmel",313,"wolbecker"
"11/14/2016 7:00",635,337,-3,7,"Klarer Himmel",972,"wolbecker"
"11/14/2016 8:00",596,276,-2,6,"Klarer Himmel",872,"wolbecker"
"11/14/2016 9:00",495,187,0,11,"Klarer Himmel",682,"wolbecker"
"11/14/2016 10:00",373,182,2,9,"Klarer Himmel",555,"wolbecker"
"11/14/2016 11:00",313,226,3,11,"Klarer Himmel",539,"wolbecker"
"11/14/2016 12:00",337,329,4,15,"Klarer Himmel",666,"wolbecker"
"11/14/2016 13:00",363,328,4,13,"Klarer Himmel",691,"wolbecker"
"11/14/2016 14:00",359,331,4,11,"Klarer Himmel",690,"wolbecker"
"11/14/2016 15:00",375,454,4,6,"Klarer Himmel",829,"wolbecker"
"11/14/2016 16:00",439,561,4,6,"Klarer Himmel",1000,"wolbecker"
"11/14/2016 17:00",535,582,4,7,"wolkig",1117,"wolbecker"
"11/14/2016 18:00",352,508,3,6,"Regen",860,"wolbecker"
"11/14/2016 19:00",278,387,4,11,"Regen",665,"wolbecker"
"11/14/2016 20:00",186,228,4,15,"Regen",414,"wolbecker"
"11/14/2016 21:00",152,140,4,17,"Regen",292,"wolbecker"
"11/14/2016 22:00",105,122,3,17,"wolkig",227,"wolbecker"
"11/14/2016 23:00",50,54,3,15,"Regen",104,"wolbecker"
"11/15/2016 0:00",36,25,3,13,"Regen",61,"wolbecker"
"11/15/2016 1:00",7,7,3,11,"Regen",14,"wolbecker"
"11/15/2016 2:00",5,2,3,11,"Regen",7,"wolbecker"
"11/15/2016 3:00",1,2,3,11,"Regen",3,"wolbecker"
"11/15/2016 4:00",6,6,4,11,"Regen",12,"wolbecker"
"11/15/2016 5:00",38,44,5,11,"Regen",82,"wolbecker"
"11/15/2016 6:00",109,175,5,11,"Regen",284,"wolbecker"
"11/15/2016 7:00",614,289,6,13,"Regen",903,"wolbecker"
"11/15/2016 8:00",561,239,6,13,"Regen",800,"wolbecker"
"11/15/2016 9:00",433,155,6,15,"Regen",588,"wolbecker"
"11/15/2016 10:00",253,166,7,13,"Regen",419,"wolbecker"
"11/15/2016 11:00",256,181,7,15,"Regen",437,"wolbecker"
"11/15/2016 12:00",257,259,8,17,"Regen",516,"wolbecker"
"11/15/2016 13:00",265,293,8,15,"Regen",558,"wolbecker"
"11/15/2016 14:00",293,294,9,15,"Regen",587,"wolbecker"
"11/15/2016 15:00",342,369,9,13,"Regen",711,"wolbecker"
"11/15/2016 16:00",342,501,9,15,"wolkig",843,"wolbecker"
"11/15/2016 17:00",405,503,10,15,"Regen",908,"wolbecker"
"11/15/2016 18:00",324,498,NA,NA,NA,822,"wolbecker"
"11/15/2016 19:00",252,362,10,11,"Regen",614,"wolbecker"
"11/15/2016 20:00",201,243,10,11,"Regen",444,"wolbecker"
"11/15/2016 21:00",149,161,10,11,"Regen",310,"wolbecker"
"11/15/2016 22:00",152,116,10,9,"Regen",268,"wolbecker"
"11/15/2016 23:00",62,69,10,9,"wolkig",131,"wolbecker"
"11/16/2016 0:00",32,34,10,6,"Regen",66,"wolbecker"
"11/16/2016 1:00",14,17,10,6,"wolkig",31,"wolbecker"
"11/16/2016 2:00",8,5,10,7,"wolkig",13,"wolbecker"
"11/16/2016 3:00",5,3,10,7,"Nebel",8,"wolbecker"
"11/16/2016 4:00",4,6,10,7,"Nebel",10,"wolbecker"
"11/16/2016 5:00",34,54,10,7,"Regen",88,"wolbecker"
"11/16/2016 6:00",136,204,10,11,"Regen",340,"wolbecker"
"11/16/2016 7:00",603,295,10,13,"Regen",898,"wolbecker"
"11/16/2016 8:00",569,269,11,15,"Regen",838,"wolbecker"
"11/16/2016 9:00",400,164,12,17,"Regen",564,"wolbecker"
"11/16/2016 10:00",292,171,13,19,"wolkig",463,"wolbecker"
"11/16/2016 11:00",289,179,13,20,"Regen",468,"wolbecker"
"11/16/2016 12:00",303,295,13,19,"Regen",598,"wolbecker"
"11/16/2016 13:00",334,342,13,20,"wolkig",676,"wolbecker"
"11/16/2016 14:00",302,348,13,24,"wolkig",650,"wolbecker"
"11/16/2016 15:00",335,418,13,24,"wolkig",753,"wolbecker"
"11/16/2016 16:00",344,510,12,17,"wolkig",854,"wolbecker"
"11/16/2016 17:00",432,499,12,17,"wolkig",931,"wolbecker"
"11/16/2016 18:00",370,525,12,15,"wolkig",895,"wolbecker"
"11/16/2016 19:00",260,397,12,24,"wolkig",657,"wolbecker"
"11/16/2016 20:00",187,233,11,19,"wolkig",420,"wolbecker"
"11/16/2016 21:00",150,184,11,20,"teilweise bewölkt",334,"wolbecker"
"11/16/2016 22:00",123,144,11,17,"teilweise bewölkt",267,"wolbecker"
"11/16/2016 23:00",91,91,11,20,"wolkig",182,"wolbecker"
"11/17/2016 0:00",47,94,11,24,"Regen",141,"wolbecker"
"11/17/2016 1:00",20,53,10,20,"wolkig",73,"wolbecker"
"11/17/2016 2:00",29,14,9,11,"wolkig",43,"wolbecker"
"11/17/2016 3:00",34,11,9,11,"Regen",45,"wolbecker"
"11/17/2016 4:00",45,4,9,9,"Regen",49,"wolbecker"
"11/17/2016 5:00",47,31,8,6,"Regen",78,"wolbecker"
"11/17/2016 6:00",94,173,8,6,"Regen",267,"wolbecker"
"11/17/2016 7:00",574,268,8,6,"wolkig",842,"wolbecker"
"11/17/2016 8:00",545,250,8,13,"Regen",795,"wolbecker"
"11/17/2016 9:00",473,174,9,15,"wolkig",647,"wolbecker"
"11/17/2016 10:00",321,183,9,17,"wolkig",504,"wolbecker"
"11/17/2016 11:00",337,215,10,22,"wolkig",552,"wolbecker"
"11/17/2016 12:00",356,336,11,20,"wolkig",692,"wolbecker"
"11/17/2016 13:00",361,371,11,24,"wolkig",732,"wolbecker"
"11/17/2016 14:00",305,361,10,22,"wolkig",666,"wolbecker"
"11/17/2016 15:00",328,435,10,17,"teilweise bewölkt",763,"wolbecker"
"11/17/2016 16:00",363,519,9,20,"wolkig",882,"wolbecker"
"11/17/2016 17:00",421,510,9,19,"wolkig",931,"wolbecker"
"11/17/2016 18:00",376,477,11,26,"Regen",853,"wolbecker"
"11/17/2016 19:00",261,339,10,28,"Regen",600,"wolbecker"
"11/17/2016 20:00",172,230,10,24,"Regen",402,"wolbecker"
"11/17/2016 21:00",147,160,11,20,"wolkig",307,"wolbecker"
"11/17/2016 22:00",127,133,12,22,"wolkig",260,"wolbecker"
"11/17/2016 23:00",85,99,11,22,"wolkig",184,"wolbecker"
"11/18/2016 0:00",39,29,11,19,"Regen",68,"wolbecker"
"11/18/2016 1:00",27,23,8,24,"Regen",50,"wolbecker"
"11/18/2016 2:00",16,10,8,7,"Regen",26,"wolbecker"
"11/18/2016 3:00",20,4,7,9,"Regen",24,"wolbecker"
"11/18/2016 4:00",9,4,7,4,"Regen",13,"wolbecker"
"11/18/2016 5:00",27,32,6,19,"Regen",59,"wolbecker"
"11/18/2016 6:00",102,158,6,13,"teilweise bewölkt",260,"wolbecker"
"11/18/2016 7:00",538,262,5,17,"wolkig",800,"wolbecker"
"11/18/2016 8:00",462,229,5,15,"teilweise bewölkt",691,"wolbecker"
"11/18/2016 9:00",449,198,6,19,"teilweise bewölkt",647,"wolbecker"
"11/18/2016 10:00",354,202,8,20,"wolkig",556,"wolbecker"
"11/18/2016 11:00",320,266,9,22,"wolkig",586,"wolbecker"
"11/18/2016 12:00",331,383,8,22,"teilweise bewölkt",714,"wolbecker"
"11/18/2016 13:00",410,467,9,28,"teilweise bewölkt",877,"wolbecker"
"11/18/2016 14:00",391,446,9,26,"teilweise bewölkt",837,"wolbecker"
"11/18/2016 15:00",377,459,8,28,"teilweise bewölkt",836,"wolbecker"
"11/18/2016 16:00",335,420,7,20,"teilweise bewölkt",755,"wolbecker"
"11/18/2016 17:00",325,425,6,11,"Klarer Himmel",750,"wolbecker"
"11/18/2016 18:00",301,422,6,9,"Regen",723,"wolbecker"
"11/18/2016 19:00",244,346,5,19,"teilweise bewölkt",590,"wolbecker"
"11/18/2016 20:00",169,203,6,30,"wolkig",372,"wolbecker"
"11/18/2016 21:00",172,119,6,19,"wolkig",291,"wolbecker"
"11/18/2016 22:00",132,113,6,17,"wolkig",245,"wolbecker"
"11/18/2016 23:00",123,104,5,9,"teilweise bewölkt",227,"wolbecker"
"11/19/2016 0:00",93,74,6,9,"wolkig",167,"wolbecker"
"11/19/2016 1:00",77,92,4,9,"teilweise bewölkt",169,"wolbecker"
"11/19/2016 2:00",58,61,4,13,"teilweise bewölkt",119,"wolbecker"
"11/19/2016 3:00",34,37,4,13,"teilweise bewölkt",71,"wolbecker"
"11/19/2016 4:00",38,27,4,11,"teilweise bewölkt",65,"wolbecker"
"11/19/2016 5:00",37,23,4,11,"teilweise bewölkt",60,"wolbecker"
"11/19/2016 6:00",28,23,5,15,"wolkig",51,"wolbecker"
"11/19/2016 7:00",80,43,5,15,"wolkig",123,"wolbecker"
"11/19/2016 8:00",130,115,6,7,"wolkig",245,"wolbecker"
"11/19/2016 9:00",293,137,6,13,"wolkig",430,"wolbecker"
"11/19/2016 10:00",328,177,7,15,"Regen",505,"wolbecker"
"11/19/2016 11:00",330,210,6,17,"Regen",540,"wolbecker"
"11/19/2016 12:00",323,278,7,19,"teilweise bewölkt",601,"wolbecker"
"11/19/2016 13:00",314,306,7,22,"teilweise bewölkt",620,"wolbecker"
"11/19/2016 14:00",307,335,7,26,"teilweise bewölkt",642,"wolbecker"
"11/19/2016 15:00",246,352,7,17,"teilweise bewölkt",598,"wolbecker"
"11/19/2016 16:00",235,289,6,11,NA,524,"wolbecker"
"11/19/2016 17:00",230,319,6,11,"Klarer Himmel",549,"wolbecker"
"11/19/2016 18:00",208,279,5,7,"Klarer Himmel",487,"wolbecker"
"11/19/2016 19:00",188,203,5,11,"Klarer Himmel",391,"wolbecker"
"11/19/2016 20:00",157,197,5,9,"teilweise bewölkt",354,"wolbecker"
"11/19/2016 21:00",121,99,4,9,"teilweise bewölkt",220,"wolbecker"
"11/19/2016 22:00",118,93,5,11,"wolkig",211,"wolbecker"
"11/19/2016 23:00",111,103,5,13,"wolkig",214,"wolbecker"
"11/20/2016 0:00",74,127,5,15,"Klarer Himmel",201,"wolbecker"
"11/20/2016 1:00",90,88,4,11,"Klarer Himmel",178,"wolbecker"
"11/20/2016 2:00",56,46,4,13,"Klarer Himmel",102,"wolbecker"
"11/20/2016 3:00",71,43,5,11,"Klarer Himmel",114,"wolbecker"
"11/20/2016 4:00",45,26,5,13,"Klarer Himmel",71,"wolbecker"
"11/20/2016 5:00",32,19,5,13,"Klarer Himmel",51,"wolbecker"
"11/20/2016 6:00",30,14,5,17,"Klarer Himmel",44,"wolbecker"
"11/20/2016 7:00",18,27,6,22,"Klarer Himmel",45,"wolbecker"
"11/20/2016 8:00",42,38,7,24,"wolkig",80,"wolbecker"
"11/20/2016 9:00",62,44,7,22,"Regen",106,"wolbecker"
"11/20/2016 10:00",67,58,7,17,"wolkig",125,"wolbecker"
"11/20/2016 11:00",94,78,10,30,"teilweise bewölkt",172,"wolbecker"
"11/20/2016 12:00",96,75,11,30,"wolkig",171,"wolbecker"
"11/20/2016 13:00",146,134,13,32,"wolkig",280,"wolbecker"
"11/20/2016 14:00",144,115,14,35,"Klarer Himmel",259,"wolbecker"
"11/20/2016 15:00",167,151,14,30,"Klarer Himmel",318,"wolbecker"
"11/20/2016 16:00",164,138,14,35,"Klarer Himmel",302,"wolbecker"
"11/20/2016 17:00",170,118,14,28,"wolkig",288,"wolbecker"
"11/20/2016 18:00",148,143,12,26,"wolkig",291,"wolbecker"
"11/20/2016 19:00",157,130,12,26,"teilweise bewölkt",287,"wolbecker"
"11/20/2016 20:00",104,67,12,19,"wolkig",171,"wolbecker"
"11/20/2016 21:00",99,59,11,7,"teilweise bewölkt",158,"wolbecker"
"11/20/2016 22:00",88,50,12,11,"wolkig",138,"wolbecker"
"11/20/2016 23:00",59,30,11,13,"Regen",89,"wolbecker"
"11/21/2016 0:00",20,10,10,6,"Regen",30,"wolbecker"
"11/21/2016 1:00",3,2,10,6,"teilweise bewölkt",5,"wolbecker"
"11/21/2016 2:00",2,5,10,7,"wolkig",7,"wolbecker"
"11/21/2016 3:00",1,2,10,11,"wolkig",3,"wolbecker"
"11/21/2016 4:00",4,7,10,11,"wolkig",11,"wolbecker"
"11/21/2016 5:00",37,44,11,11,"Regen",81,"wolbecker"
"11/21/2016 6:00",131,181,12,11,"wolkig",312,"wolbecker"
"11/21/2016 7:00",628,309,12,11,"wolkig",937,"wolbecker"
"11/21/2016 8:00",528,276,12,13,"Regen",804,"wolbecker"
"11/21/2016 9:00",484,181,13,17,"Regen",665,"wolbecker"
"11/21/2016 10:00",306,175,12,13,"Regen",481,"wolbecker"
"11/21/2016 11:00",268,192,13,20,"Regen",460,"wolbecker"
"11/21/2016 12:00",269,284,12,9,"Regen",553,"wolbecker"
"11/21/2016 13:00",303,326,12,6,"Regen",629,"wolbecker"
"11/21/2016 14:00",328,279,13,11,"Regen",607,"wolbecker"
"11/21/2016 15:00",384,407,13,9,"Regen",791,"wolbecker"
"11/21/2016 16:00",422,489,13,11,"wolkig",911,"wolbecker"
"11/21/2016 17:00",548,560,13,11,"Klarer Himmel",1108,"wolbecker"
"11/21/2016 18:00",404,505,12,7,"Klarer Himmel",909,"wolbecker"
"11/21/2016 19:00",303,460,12,9,"Klarer Himmel",763,"wolbecker"
"11/21/2016 20:00",186,290,12,7,"wolkig",476,"wolbecker"
"11/21/2016 21:00",142,136,13,7,"wolkig",278,"wolbecker"
"11/21/2016 22:00",164,122,13,11,"wolkig",286,"wolbecker"
"11/21/2016 23:00",64,75,14,22,"Klarer Himmel",139,"wolbecker"
"11/22/2016 0:00",23,29,14,20,"Klarer Himmel",52,"wolbecker"
"11/22/2016 1:00",14,8,14,22,"Klarer Himmel",22,"wolbecker"
"11/22/2016 2:00",2,4,13,17,"Klarer Himmel",6,"wolbecker"
"11/22/2016 3:00",4,2,13,22,"Klarer Himmel",6,"wolbecker"
"11/22/2016 4:00",3,9,13,15,"Klarer Himmel",12,"wolbecker"
"11/22/2016 5:00",42,41,12,13,"Klarer Himmel",83,"wolbecker"
"11/22/2016 6:00",140,199,11,9,"Klarer Himmel",339,"wolbecker"
"11/22/2016 7:00",675,342,10,9,"Klarer Himmel",1017,"wolbecker"
"11/22/2016 8:00",643,287,11,9,"Klarer Himmel",930,"wolbecker"
"11/22/2016 9:00",543,198,12,9,"Klarer Himmel",741,"wolbecker"
"11/22/2016 10:00",344,218,12,11,"Klarer Himmel",562,"wolbecker"
"11/22/2016 11:00",374,231,13,11,"Klarer Himmel",605,"wolbecker"
"11/22/2016 12:00",347,376,14,13,"Klarer Himmel",723,"wolbecker"
"11/22/2016 13:00",357,396,14,13,"Klarer Himmel",753,"wolbecker"
"11/22/2016 14:00",339,448,13,11,"Klarer Himmel",787,"wolbecker"
"11/22/2016 15:00",450,495,12,7,"Klarer Himmel",945,"wolbecker"
"11/22/2016 16:00",492,526,12,7,"Klarer Himmel",1018,"wolbecker"
"11/22/2016 17:00",551,601,11,6,"Klarer Himmel",1152,"wolbecker"
"11/22/2016 18:00",429,575,11,6,"Klarer Himmel",1004,"wolbecker"
"11/22/2016 19:00",349,487,11,4,"Regen",836,"wolbecker"
"11/22/2016 20:00",218,332,10,4,"Regen",550,"wolbecker"
"11/22/2016 21:00",139,163,9,7,"Regen",302,"wolbecker"
"11/22/2016 22:00",172,162,9,7,"Klarer Himmel",334,"wolbecker"
"11/22/2016 23:00",119,71,9,4,"wolkig",190,"wolbecker"
"11/23/2016 0:00",38,37,9,2,"wolkig",75,"wolbecker"
"11/23/2016 1:00",6,26,8,2,NA,32,"wolbecker"
"11/23/2016 2:00",9,24,9,2,"wolkig",33,"wolbecker"
"11/23/2016 3:00",5,9,9,0,"wolkig",14,"wolbecker"
"11/23/2016 4:00",7,18,8,2,"wolkig",25,"wolbecker"
"11/23/2016 5:00",35,37,9,0,"wolkig",72,"wolbecker"
"11/23/2016 6:00",137,200,8,0,"teilweise bewölkt",337,"wolbecker"
"11/23/2016 7:00",662,321,7,0,"Nebel",983,"wolbecker"
"11/23/2016 8:00",678,305,7,0,"Nebel",983,"wolbecker"
"11/23/2016 9:00",548,224,7,2,"Nebel",772,"wolbecker"
"11/23/2016 10:00",411,219,9,2,"Klarer Himmel",630,"wolbecker"
"11/23/2016 11:00",396,271,10,4,"Klarer Himmel",667,"wolbecker"
"11/23/2016 12:00",379,369,12,7,"Klarer Himmel",748,"wolbecker"
"11/23/2016 13:00",393,427,12,6,"Klarer Himmel",820,"wolbecker"
"11/23/2016 14:00",375,481,12,4,"Klarer Himmel",856,"wolbecker"
"11/23/2016 15:00",433,473,11,9,"Klarer Himmel",906,"wolbecker"
"11/23/2016 16:00",460,576,9,6,"Klarer Himmel",1036,"wolbecker"
"11/23/2016 17:00",560,579,9,6,"Klarer Himmel",1139,"wolbecker"
"11/23/2016 18:00",446,539,9,4,"Klarer Himmel",985,"wolbecker"
"11/23/2016 19:00",347,438,8,7,"Klarer Himmel",785,"wolbecker"
"11/23/2016 20:00",205,304,9,9,"Klarer Himmel",509,"wolbecker"
"11/23/2016 21:00",151,177,9,9,"Klarer Himmel",328,"wolbecker"
"11/23/2016 22:00",147,179,9,7,"Klarer Himmel",326,"wolbecker"
"11/23/2016 23:00",90,94,8,11,"Klarer Himmel",184,"wolbecker"
"11/24/2016 0:00",41,60,8,11,"Klarer Himmel",101,"wolbecker"
"11/24/2016 1:00",21,40,8,11,"Klarer Himmel",61,"wolbecker"
"11/24/2016 2:00",14,17,8,9,"Klarer Himmel",31,"wolbecker"
"11/24/2016 3:00",19,15,8,17,"Klarer Himmel",34,"wolbecker"
"11/24/2016 4:00",23,19,7,17,"Klarer Himmel",42,"wolbecker"
"11/24/2016 5:00",37,41,8,13,"wolkig",78,"wolbecker"
"11/24/2016 6:00",137,209,8,20,"wolkig",346,"wolbecker"
"11/24/2016 7:00",657,328,7,19,"wolkig",985,"wolbecker"
"11/24/2016 8:00",600,287,7,17,"wolkig",887,"wolbecker"
"11/24/2016 9:00",555,187,7,17,"wolkig",742,"wolbecker"
"11/24/2016 10:00",351,197,7,17,"wolkig",548,"wolbecker"
"11/24/2016 11:00",343,274,7,15,"wolkig",617,"wolbecker"
"11/24/2016 12:00",328,372,7,13,"wolkig",700,"wolbecker"
"11/24/2016 13:00",356,389,7,19,"wolkig",745,"wolbecker"
"11/24/2016 14:00",399,464,7,22,"wolkig",863,"wolbecker"
"11/24/2016 15:00",396,509,7,20,"Klarer Himmel",905,"wolbecker"
"11/24/2016 16:00",525,624,6,17,"Klarer Himmel",1149,"wolbecker"
"11/24/2016 17:00",514,591,6,19,"Klarer Himmel",1105,"wolbecker"
"11/24/2016 18:00",461,496,5,13,"Klarer Himmel",957,"wolbecker"
"11/24/2016 19:00",306,442,5,11,"Klarer Himmel",748,"wolbecker"
"11/24/2016 20:00",174,291,5,13,"teilweise bewölkt",465,"wolbecker"
"11/24/2016 21:00",146,221,4,15,"Klarer Himmel",367,"wolbecker"
"11/24/2016 22:00",139,153,4,9,"Klarer Himmel",292,"wolbecker"
"11/24/2016 23:00",101,97,3,17,"Klarer Himmel",198,"wolbecker"
"11/25/2016 0:00",92,56,3,11,"Klarer Himmel",148,"wolbecker"
"11/25/2016 1:00",36,38,2,7,"Klarer Himmel",74,"wolbecker"
"11/25/2016 2:00",6,41,2,9,"Klarer Himmel",47,"wolbecker"
"11/25/2016 3:00",8,25,1,9,"teilweise bewölkt",33,"wolbecker"
"11/25/2016 4:00",9,15,1,13,"teilweise bewölkt",24,"wolbecker"
"11/25/2016 5:00",36,36,1,11,NA,72,"wolbecker"
"11/25/2016 6:00",123,156,1,11,"Klarer Himmel",279,"wolbecker"
"11/25/2016 7:00",596,277,2,6,"Klarer Himmel",873,"wolbecker"
"11/25/2016 8:00",547,239,2,9,"Klarer Himmel",786,"wolbecker"
"11/25/2016 9:00",445,214,3,13,"Klarer Himmel",659,"wolbecker"
"11/25/2016 10:00",363,224,4,13,"Klarer Himmel",587,"wolbecker"
"11/25/2016 11:00",366,276,6,11,"Klarer Himmel",642,"wolbecker"
"11/25/2016 12:00",413,388,7,13,"Klarer Himmel",801,"wolbecker"
"11/25/2016 13:00",410,514,6,17,"Klarer Himmel",924,"wolbecker"
"11/25/2016 14:00",440,483,6,15,"Klarer Himmel",923,"wolbecker"
"11/25/2016 15:00",448,530,4,11,"Klarer Himmel",978,"wolbecker"
"11/25/2016 16:00",385,463,2,11,"Klarer Himmel",848,"wolbecker"
"11/25/2016 17:00",412,496,1,7,"Klarer Himmel",908,"wolbecker"
"11/25/2016 18:00",365,406,1,6,"Klarer Himmel",771,"wolbecker"
"11/25/2016 19:00",278,332,0,11,"Klarer Himmel",610,"wolbecker"
"11/25/2016 20:00",173,259,0,6,NA,432,"wolbecker"
"11/25/2016 21:00",137,191,0,6,NA,328,"wolbecker"
"11/25/2016 22:00",147,130,-1,7,NA,277,"wolbecker"
"11/25/2016 23:00",101,121,0,6,NA,222,"wolbecker"
"11/26/2016 0:00",103,94,-1,2,NA,197,"wolbecker"
"11/26/2016 1:00",59,66,-2,4,"Nebel",125,"wolbecker"
"11/26/2016 2:00",54,58,-2,2,NA,112,"wolbecker"
"11/26/2016 3:00",31,45,-3,6,"Nebel",76,"wolbecker"
"11/26/2016 4:00",25,18,-3,6,"Nebel",43,"wolbecker"
"11/26/2016 5:00",29,29,-3,4,"Nebel",58,"wolbecker"
"11/26/2016 6:00",25,33,-4,0,"Nebel",58,"wolbecker"
"11/26/2016 7:00",72,50,-3,2,"Nebel",122,"wolbecker"
"11/26/2016 8:00",117,97,-3,4,"Nebel",214,"wolbecker"
"11/26/2016 9:00",293,106,-3,2,"Nebel",399,"wolbecker"
"11/26/2016 10:00",344,178,-1,2,"wolkig",522,"wolbecker"
"11/26/2016 11:00",373,250,-1,9,"Nebel",623,"wolbecker"
"11/26/2016 12:00",400,303,-1,4,"Nebel",703,"wolbecker"
"11/26/2016 13:00",332,384,-1,6,"Nebel",716,"wolbecker"
"11/26/2016 14:00",259,361,-1,6,"Nebel",620,"wolbecker"
"11/26/2016 15:00",287,326,-1,6,"Nebel",613,"wolbecker"
"11/26/2016 16:00",246,271,-1,4,"Nebel",517,"wolbecker"
"11/26/2016 17:00",242,283,-1,2,"Nebel",525,"wolbecker"
"11/26/2016 18:00",206,329,-2,4,"Nebel",535,"wolbecker"
"11/26/2016 19:00",184,284,-2,4,"Nebel",468,"wolbecker"
"11/26/2016 20:00",141,224,-2,4,"Nebel",365,"wolbecker"
"11/26/2016 21:00",109,182,-1,0,"wolkig",291,"wolbecker"
"11/26/2016 22:00",101,82,-1,4,"wolkig",183,"wolbecker"
"11/26/2016 23:00",139,78,-1,4,"wolkig",217,"wolbecker"
"11/27/2016 0:00",80,95,0,2,"Regen",175,"wolbecker"
"11/27/2016 1:00",94,88,0,2,"wolkig",182,"wolbecker"
"11/27/2016 2:00",44,45,0,0,"Regen",89,"wolbecker"
"11/27/2016 3:00",32,35,1,0,"wolkig",67,"wolbecker"
"11/27/2016 4:00",42,17,1,4,"wolkig",59,"wolbecker"
"11/27/2016 5:00",29,10,2,0,"Nebel",39,"wolbecker"
"11/27/2016 6:00",31,17,2,4,"wolkig",48,"wolbecker"
"11/27/2016 7:00",30,24,4,7,"wolkig",54,"wolbecker"
"11/27/2016 8:00",29,35,4,9,"wolkig",64,"wolbecker"
"11/27/2016 9:00",68,60,5,11,"wolkig",128,"wolbecker"
"11/27/2016 10:00",139,102,6,9,"wolkig",241,"wolbecker"
"11/27/2016 11:00",127,97,7,9,"wolkig",224,"wolbecker"
"11/27/2016 12:00",139,124,8,9,"wolkig",263,"wolbecker"
"11/27/2016 13:00",165,131,8,9,"wolkig",296,"wolbecker"
"11/27/2016 14:00",205,158,9,7,"wolkig",363,"wolbecker"
"11/27/2016 15:00",234,167,7,6,"wolkig",401,"wolbecker"
"11/27/2016 16:00",205,173,4,0,"Nebel",378,"wolbecker"
"11/27/2016 17:00",227,168,3,0,"Nebel",395,"wolbecker"
"11/27/2016 18:00",205,156,1,0,"Nebel",361,"wolbecker"
"11/27/2016 19:00",202,171,0,0,"Nebel",373,"wolbecker"
"11/27/2016 20:00",131,117,-1,6,"Nebel",248,"wolbecker"
"11/27/2016 21:00",117,71,0,11,"Klarer Himmel",188,"wolbecker"
"11/27/2016 22:00",83,53,1,11,"Klarer Himmel",136,"wolbecker"
"11/27/2016 23:00",51,34,0,6,"Klarer Himmel",85,"wolbecker"
"11/28/2016 0:00",28,22,-1,6,"Nebel",50,"wolbecker"
"11/28/2016 1:00",12,5,-2,2,"Nebel",17,"wolbecker"
"11/28/2016 2:00",3,2,-3,4,"Nebel",5,"wolbecker"
"11/28/2016 3:00",2,4,-5,7,"Nebel",6,"wolbecker"
"11/28/2016 4:00",7,8,-3,2,"Nebel",15,"wolbecker"
"11/28/2016 5:00",41,48,-5,6,"Nebel",89,"wolbecker"
"11/28/2016 6:00",125,191,-5,4,"Nebel",316,"wolbecker"
"11/28/2016 7:00",632,284,-4,2,"Klarer Himmel",916,"wolbecker"
"11/28/2016 8:00",563,266,-5,7,"Klarer Himmel",829,"wolbecker"
"11/28/2016 9:00",493,177,-1,7,"Klarer Himmel",670,"wolbecker"
"11/28/2016 10:00",375,216,1,11,"Klarer Himmel",591,"wolbecker"
"11/28/2016 11:00",335,243,2,13,"Klarer Himmel",578,"wolbecker"
"11/28/2016 12:00",334,316,3,13,"Klarer Himmel",650,"wolbecker"
"11/28/2016 13:00",401,361,3,7,"teilweise bewölkt",762,"wolbecker"
"11/28/2016 14:00",383,338,3,9,"Klarer Himmel",721,"wolbecker"
"11/28/2016 15:00",422,481,2,7,"Klarer Himmel",903,"wolbecker"
"11/28/2016 16:00",448,542,0,6,"Klarer Himmel",990,"wolbecker"
"11/28/2016 17:00",508,540,-2,2,"Klarer Himmel",1048,"wolbecker"
"11/28/2016 18:00",405,507,-3,2,"Klarer Himmel",912,"wolbecker"
"11/28/2016 19:00",294,432,-4,2,"Klarer Himmel",726,"wolbecker"
"11/28/2016 20:00",161,279,-4,2,"Klarer Himmel",440,"wolbecker"
"11/28/2016 21:00",128,151,-5,2,"Nebel",279,"wolbecker"
"11/28/2016 22:00",107,160,-4,6,"Nebel",267,"wolbecker"
"11/28/2016 23:00",50,67,-5,6,"Nebel",117,"wolbecker"
"11/29/2016 0:00",20,25,-5,0,"Nebel",45,"wolbecker"
"11/29/2016 1:00",22,16,-5,0,"Nebel",38,"wolbecker"
"11/29/2016 2:00",3,4,-6,2,"Nebel",7,"wolbecker"
"11/29/2016 3:00",2,4,-7,0,"Nebel",6,"wolbecker"
"11/29/2016 4:00",6,7,-7,2,"Nebel",13,"wolbecker"
"11/29/2016 5:00",33,44,-7,2,"Nebel",77,"wolbecker"
"11/29/2016 6:00",123,182,-7,0,"Nebel",305,"wolbecker"
"11/29/2016 7:00",631,286,-7,0,"Nebel",917,"wolbecker"
"11/29/2016 8:00",619,265,-7,0,NA,884,"wolbecker"
"11/29/2016 9:00",514,166,-5,2,NA,680,"wolbecker"
"11/29/2016 10:00",333,177,-2,2,"Klarer Himmel",510,"wolbecker"
"11/29/2016 11:00",325,214,0,4,"Klarer Himmel",539,"wolbecker"
"11/29/2016 12:00",325,331,1,4,"Klarer Himmel",656,"wolbecker"
"11/29/2016 13:00",327,357,1,6,"Klarer Himmel",684,"wolbecker"
"11/29/2016 14:00",346,425,2,4,"Klarer Himmel",771,"wolbecker"
"11/29/2016 15:00",370,445,0,2,"Klarer Himmel",815,"wolbecker"
"11/29/2016 16:00",426,531,-3,2,"Nebel",957,"wolbecker"
"11/29/2016 17:00",487,567,-3,0,"Nebel",1054,"wolbecker"
"11/29/2016 18:00",415,558,-4,6,"Nebel",973,"wolbecker"
"11/29/2016 19:00",300,455,-5,4,"Nebel",755,"wolbecker"
"11/29/2016 20:00",176,317,-6,2,"Nebel",493,"wolbecker"
"11/29/2016 21:00",151,192,-6,4,"Nebel",343,"wolbecker"
"11/29/2016 22:00",167,143,-6,6,"Klarer Himmel",310,"wolbecker"
"11/29/2016 23:00",78,83,-7,2,"Klarer Himmel",161,"wolbecker"
"11/30/2016 0:00",34,33,-7,2,"Klarer Himmel",67,"wolbecker"
"11/30/2016 1:00",10,15,-7,0,"Klarer Himmel",25,"wolbecker"
"11/30/2016 2:00",10,4,-8,7,"Klarer Himmel",14,"wolbecker"
"11/30/2016 3:00",3,6,-8,2,"Klarer Himmel",9,"wolbecker"
"11/30/2016 4:00",4,8,-7,4,"Klarer Himmel",12,"wolbecker"
"11/30/2016 5:00",30,43,-7,4,"Klarer Himmel",73,"wolbecker"
"11/30/2016 6:00",135,195,-6,2,"Klarer Himmel",330,"wolbecker"
"11/30/2016 7:00",628,306,-7,2,"Klarer Himmel",934,"wolbecker"
"11/30/2016 8:00",606,287,-7,4,"Klarer Himmel",893,"wolbecker"
"11/30/2016 9:00",532,202,-4,4,"wolkig",734,"wolbecker"
"11/30/2016 10:00",369,208,-2,7,"wolkig",577,"wolbecker"
"11/30/2016 11:00",392,257,0,11,"wolkig",649,"wolbecker"
"11/30/2016 12:00",291,341,2,13,"wolkig",632,"wolbecker"
"11/30/2016 13:00",367,384,2,15,"wolkig",751,"wolbecker"
"11/30/2016 14:00",354,399,2,19,"wolkig",753,"wolbecker"
"11/30/2016 15:00",373,433,2,17,"wolkig",806,"wolbecker"
"11/30/2016 16:00",422,466,3,19,"wolkig",888,"wolbecker"
"11/30/2016 17:00",467,492,3,17,"wolkig",959,"wolbecker"
"11/30/2016 18:00",440,511,4,17,"wolkig",951,"wolbecker"
"11/30/2016 19:00",328,430,3,17,"wolkig",758,"wolbecker"
"11/30/2016 20:00",191,289,4,17,"wolkig",480,"wolbecker"
"11/30/2016 21:00",131,208,4,19,"wolkig",339,"wolbecker"
"11/30/2016 22:00",124,173,4,15,"wolkig",297,"wolbecker"
"11/30/2016 23:00",67,108,4,19,"wolkig",175,"wolbecker"
"12/1/2016 0:00",45,67,4,17,"wolkig",112,"wolbecker"
"12/1/2016 1:00",23,30,4,17,"wolkig",53,"wolbecker"
"12/1/2016 2:00",9,20,4,22,"wolkig",29,"wolbecker"
"12/1/2016 3:00",3,8,4,20,"wolkig",11,"wolbecker"
"12/1/2016 4:00",9,13,4,17,"wolkig",22,"wolbecker"
"12/1/2016 5:00",35,42,4,17,"wolkig",77,"wolbecker"
"12/1/2016 6:00",137,192,4,19,"wolkig",329,"wolbecker"
"12/1/2016 7:00",626,310,5,20,"wolkig",936,"wolbecker"
"12/1/2016 8:00",567,265,5,20,"wolkig",832,"wolbecker"
"12/1/2016 9:00",493,186,5,20,"wolkig",679,"wolbecker"
"12/1/2016 10:00",348,198,5,20,"wolkig",546,"wolbecker"
"12/1/2016 11:00",332,220,6,24,"wolkig",552,"wolbecker"
"12/1/2016 12:00",290,321,6,26,"wolkig",611,"wolbecker"
"12/1/2016 13:00",358,342,6,28,"wolkig",700,"wolbecker"
"12/1/2016 14:00",372,383,7,24,"wolkig",755,"wolbecker"
"12/1/2016 15:00",386,463,7,22,"wolkig",849,"wolbecker"
"12/1/2016 16:00",416,513,7,22,"wolkig",929,"wolbecker"
"12/1/2016 17:00",482,560,7,22,"wolkig",1042,"wolbecker"
"12/1/2016 18:00",451,486,8,24,"wolkig",937,"wolbecker"
"12/1/2016 19:00",301,369,8,24,"wolkig",670,"wolbecker"
"12/1/2016 20:00",206,312,8,28,"wolkig",518,"wolbecker"
"12/1/2016 21:00",123,211,8,20,"wolkig",334,"wolbecker"
"12/1/2016 22:00",124,167,8,19,"wolkig",291,"wolbecker"
"12/1/2016 23:00",62,94,9,22,"wolkig",156,"wolbecker"
"12/2/2016 0:00",50,55,8,19,"wolkig",105,"wolbecker"
"12/2/2016 1:00",16,31,8,19,"Regen",47,"wolbecker"
"12/2/2016 2:00",2,18,8,20,"Regen",20,"wolbecker"
"12/2/2016 3:00",2,9,8,19,"Regen",11,"wolbecker"
"12/2/2016 4:00",9,11,7,17,"wolkig",20,"wolbecker"
"12/2/2016 5:00",24,41,8,17,"Regen",65,"wolbecker"
"12/2/2016 6:00",128,168,8,17,"Regen",296,"wolbecker"
"12/2/2016 7:00",546,262,7,9,"wolkig",808,"wolbecker"
"12/2/2016 8:00",529,243,8,9,"wolkig",772,"wolbecker"
"12/2/2016 9:00",442,186,7,11,"teilweise bewölkt",628,"wolbecker"
"12/2/2016 10:00",350,209,8,9,"teilweise bewölkt",559,"wolbecker"
"12/2/2016 11:00",333,254,8,11,"teilweise bewölkt",587,"wolbecker"
"12/2/2016 12:00",369,395,8,15,"teilweise bewölkt",764,"wolbecker"
"12/2/2016 13:00",429,503,8,13,"teilweise bewölkt",932,"wolbecker"
"12/2/2016 14:00",409,488,7,13,"teilweise bewölkt",897,"wolbecker"
"12/2/2016 15:00",396,451,7,11,"Klarer Himmel",847,"wolbecker"
"12/2/2016 16:00",359,421,4,2,"Klarer Himmel",780,"wolbecker"
"12/2/2016 17:00",404,438,2,0,"Klarer Himmel",842,"wolbecker"
"12/2/2016 18:00",355,416,1,0,"Klarer Himmel",771,"wolbecker"
"12/2/2016 19:00",295,325,0,0,"Nebel",620,"wolbecker"
"12/2/2016 20:00",199,247,-1,0,"Nebel",446,"wolbecker"
"12/2/2016 21:00",147,207,-2,0,"Nebel",354,"wolbecker"
"12/2/2016 22:00",147,152,-2,0,"Nebel",299,"wolbecker"
"12/2/2016 23:00",126,155,-3,0,"Nebel",281,"wolbecker"
"12/3/2016 0:00",103,119,-2,2,"Nebel",222,"wolbecker"
"12/3/2016 1:00",60,102,-3,2,"Nebel",162,"wolbecker"
"12/3/2016 2:00",49,59,-3,2,NA,108,"wolbecker"
"12/3/2016 3:00",36,50,-2,4,"wolkig",86,"wolbecker"
"12/3/2016 4:00",37,34,-3,0,"wolkig",71,"wolbecker"
"12/3/2016 5:00",36,25,-3,4,"Nebel",61,"wolbecker"
"12/3/2016 6:00",42,31,-3,2,"Nebel",73,"wolbecker"
"12/3/2016 7:00",63,47,-2,4,"Nebel",110,"wolbecker"
"12/3/2016 8:00",129,102,-2,2,"wolkig",231,"wolbecker"
"12/3/2016 9:00",271,137,-1,4,"wolkig",408,"wolbecker"
"12/3/2016 10:00",342,154,0,6,"wolkig",496,"wolbecker"
"12/3/2016 11:00",353,230,0,4,"wolkig",583,"wolbecker"
"12/3/2016 12:00",347,275,1,4,"wolkig",622,"wolbecker"
"12/3/2016 13:00",341,327,2,2,"teilweise bewölkt",668,"wolbecker"
"12/3/2016 14:00",321,393,3,4,"teilweise bewölkt",714,"wolbecker"
"12/3/2016 15:00",319,317,2,4,"teilweise bewölkt",636,"wolbecker"
"12/3/2016 16:00",286,323,0,2,"Nebel",609,"wolbecker"
"12/3/2016 17:00",227,329,-2,0,"Nebel",556,"wolbecker"
"12/3/2016 18:00",239,311,-2,0,"Nebel",550,"wolbecker"
"12/3/2016 19:00",220,256,-3,0,"Nebel",476,"wolbecker"
"12/3/2016 20:00",149,200,-3,0,"Nebel",349,"wolbecker"
"12/3/2016 21:00",126,145,-4,4,"Nebel",271,"wolbecker"
"12/3/2016 22:00",116,117,-4,0,"Nebel",233,"wolbecker"
"12/3/2016 23:00",107,105,-4,0,"Nebel",212,"wolbecker"
"12/4/2016 0:00",64,121,-5,4,"Nebel",185,"wolbecker"
"12/4/2016 1:00",63,106,-5,4,"Nebel",169,"wolbecker"
"12/4/2016 2:00",42,78,-4,2,"Nebel",120,"wolbecker"
"12/4/2016 3:00",36,34,-5,2,"Nebel",70,"wolbecker"
"12/4/2016 4:00",38,14,-6,4,"Nebel",52,"wolbecker"
"12/4/2016 5:00",28,12,-5,6,"Nebel",40,"wolbecker"
"12/4/2016 6:00",15,16,-6,4,"Nebel",31,"wolbecker"
"12/4/2016 7:00",18,20,-6,2,"Nebel",38,"wolbecker"
"12/4/2016 8:00",28,27,-6,2,"Klarer Himmel",55,"wolbecker"
"12/4/2016 9:00",80,75,-3,0,"Klarer Himmel",155,"wolbecker"
"12/4/2016 10:00",147,91,-1,0,"Klarer Himmel",238,"wolbecker"
"12/4/2016 11:00",140,92,1,4,"Klarer Himmel",232,"wolbecker"
"12/4/2016 12:00",152,132,3,4,"Klarer Himmel",284,"wolbecker"
"12/4/2016 13:00",194,136,5,6,"Klarer Himmel",330,"wolbecker"
"12/4/2016 14:00",211,171,5,4,"Klarer Himmel",382,"wolbecker"
"12/4/2016 15:00",221,172,4,4,"Klarer Himmel",393,"wolbecker"
"12/4/2016 16:00",254,170,0,6,"Klarer Himmel",424,"wolbecker"
"12/4/2016 17:00",179,206,-2,4,"Klarer Himmel",385,"wolbecker"
"12/4/2016 18:00",157,176,-2,6,"Klarer Himmel",333,"wolbecker"
"12/4/2016 19:00",165,165,-2,6,"Klarer Himmel",330,"wolbecker"
"12/4/2016 20:00",119,120,0,4,"Klarer Himmel",239,"wolbecker"
"12/4/2016 21:00",111,73,-1,4,"Klarer Himmel",184,"wolbecker"
"12/4/2016 22:00",89,45,-2,6,"Klarer Himmel",134,"wolbecker"
"12/4/2016 23:00",41,32,-4,2,"Klarer Himmel",73,"wolbecker"
"12/5/2016 0:00",25,13,-4,4,"Klarer Himmel",38,"wolbecker"
"12/5/2016 1:00",8,7,-4,4,"Klarer Himmel",15,"wolbecker"
"12/5/2016 2:00",4,2,-4,2,"Klarer Himmel",6,"wolbecker"
"12/5/2016 3:00",2,2,-4,4,"Klarer Himmel",4,"wolbecker"
"12/5/2016 4:00",6,8,-5,2,"Klarer Himmel",14,"wolbecker"
"12/5/2016 5:00",37,41,-6,4,"Klarer Himmel",78,"wolbecker"
"12/5/2016 6:00",134,171,-7,2,"Klarer Himmel",305,"wolbecker"
"12/5/2016 7:00",559,290,-6,0,"Klarer Himmel",849,"wolbecker"
"12/5/2016 8:00",568,249,-7,2,"Klarer Himmel",817,"wolbecker"
"12/5/2016 9:00",490,181,-4,0,"Klarer Himmel",671,"wolbecker"
"12/5/2016 10:00",382,180,0,0,"Klarer Himmel",562,"wolbecker"
"12/5/2016 11:00",322,234,2,4,"Klarer Himmel",556,"wolbecker"
"12/5/2016 12:00",333,353,4,0,"Klarer Himmel",686,"wolbecker"
"12/5/2016 13:00",370,344,4,2,"Klarer Himmel",714,"wolbecker"
"12/5/2016 14:00",364,336,5,0,"Klarer Himmel",700,"wolbecker"
"12/5/2016 15:00",418,407,4,0,"Klarer Himmel",825,"wolbecker"
"12/5/2016 16:00",436,567,-1,0,"Klarer Himmel",1003,"wolbecker"
"12/5/2016 17:00",519,570,-3,0,"Klarer Himmel",1089,"wolbecker"
"12/5/2016 18:00",401,530,-4,0,"Klarer Himmel",931,"wolbecker"
"12/5/2016 19:00",275,445,-4,2,"Klarer Himmel",720,"wolbecker"
"12/5/2016 20:00",166,308,-5,0,"Klarer Himmel",474,"wolbecker"
"12/5/2016 21:00",152,189,-6,0,"Klarer Himmel",341,"wolbecker"
"12/5/2016 22:00",111,126,-6,0,"Nebel",237,"wolbecker"
"12/5/2016 23:00",52,61,-7,0,"Nebel",113,"wolbecker"
"12/6/2016 0:00",26,33,-7,2,"Nebel",59,"wolbecker"
"12/6/2016 1:00",18,12,-7,0,"Nebel",30,"wolbecker"
"12/6/2016 2:00",3,8,-7,4,"Nebel",11,"wolbecker"
"12/6/2016 3:00",1,6,-7,0,"Klarer Himmel",7,"wolbecker"
"12/6/2016 4:00",6,3,-7,2,"Klarer Himmel",9,"wolbecker"
"12/6/2016 5:00",38,39,-7,4,"Klarer Himmel",77,"wolbecker"
"12/6/2016 6:00",137,183,-7,0,"Klarer Himmel",320,"wolbecker"
"12/6/2016 7:00",632,296,-7,2,"Klarer Himmel",928,"wolbecker"
"12/6/2016 8:00",607,288,-6,4,"Klarer Himmel",895,"wolbecker"
"12/6/2016 9:00",462,175,-3,4,"Klarer Himmel",637,"wolbecker"
"12/6/2016 10:00",323,187,-1,4,"Klarer Himmel",510,"wolbecker"
"12/6/2016 11:00",334,217,1,6,"Klarer Himmel",551,"wolbecker"
"12/6/2016 12:00",323,345,2,6,"Klarer Himmel",668,"wolbecker"
"12/6/2016 13:00",334,368,3,6,"Klarer Himmel",702,"wolbecker"
"12/6/2016 14:00",350,411,3,4,"Klarer Himmel",761,"wolbecker"
"12/6/2016 15:00",409,481,2,2,"Klarer Himmel",890,"wolbecker"
"12/6/2016 16:00",476,541,0,4,"Klarer Himmel",1017,"wolbecker"
"12/6/2016 17:00",493,567,0,6,"Klarer Himmel",1060,"wolbecker"
"12/6/2016 18:00",433,528,0,6,"Klarer Himmel",961,"wolbecker"
"12/6/2016 19:00",309,435,-1,6,"Klarer Himmel",744,"wolbecker"
"12/6/2016 20:00",174,271,-2,2,"Klarer Himmel",445,"wolbecker"
"12/6/2016 21:00",120,187,-1,6,"Klarer Himmel",307,"wolbecker"
"12/6/2016 22:00",149,167,-2,7,"Klarer Himmel",316,"wolbecker"
"12/6/2016 23:00",77,70,-1,6,"Klarer Himmel",147,"wolbecker"
"12/7/2016 0:00",37,31,-2,6,"Klarer Himmel",68,"wolbecker"
"12/7/2016 1:00",10,21,-2,6,"Klarer Himmel",31,"wolbecker"
"12/7/2016 2:00",3,7,-2,6,"Klarer Himmel",10,"wolbecker"
"12/7/2016 3:00",3,7,-2,6,"Klarer Himmel",10,"wolbecker"
"12/7/2016 4:00",5,8,-2,7,"Klarer Himmel",13,"wolbecker"
"12/7/2016 5:00",41,37,-1,7,"Klarer Himmel",78,"wolbecker"
"12/7/2016 6:00",128,181,-1,7,"Klarer Himmel",309,"wolbecker"
"12/7/2016 7:00",586,305,-1,9,"Klarer Himmel",891,"wolbecker"
"12/7/2016 8:00",587,293,-1,7,"Klarer Himmel",880,"wolbecker"
"12/7/2016 9:00",512,183,0,7,"wolkig",695,"wolbecker"
"12/7/2016 10:00",361,207,1,9,"Klarer Himmel",568,"wolbecker"
"12/7/2016 11:00",402,274,3,9,"Klarer Himmel",676,"wolbecker"
"12/7/2016 12:00",374,349,4,11,"Klarer Himmel",723,"wolbecker"
"12/7/2016 13:00",391,413,6,6,"Klarer Himmel",804,"wolbecker"
"12/7/2016 14:00",356,404,7,9,"Klarer Himmel",760,"wolbecker"
"12/7/2016 15:00",389,406,7,9,"Klarer Himmel",795,"wolbecker"
"12/7/2016 16:00",444,532,7,9,"Klarer Himmel",976,"wolbecker"
"12/7/2016 17:00",488,506,7,9,"Klarer Himmel",994,"wolbecker"
"12/7/2016 18:00",449,525,7,9,"Klarer Himmel",974,"wolbecker"
"12/7/2016 19:00",322,456,8,11,"Klarer Himmel",778,"wolbecker"
"12/7/2016 20:00",194,347,8,11,"Klarer Himmel",541,"wolbecker"
"12/7/2016 21:00",160,212,8,13,"Klarer Himmel",372,"wolbecker"
"12/7/2016 22:00",166,181,8,19,"Klarer Himmel",347,"wolbecker"
"12/7/2016 23:00",74,136,8,17,"Klarer Himmel",210,"wolbecker"
"12/8/2016 0:00",61,93,8,19,"Klarer Himmel",154,"wolbecker"
"12/8/2016 1:00",18,51,8,17,"Klarer Himmel",69,"wolbecker"
"12/8/2016 2:00",22,16,8,15,"Klarer Himmel",38,"wolbecker"
"12/8/2016 3:00",36,26,8,17,"Klarer Himmel",62,"wolbecker"
"12/8/2016 4:00",50,12,8,15,"Klarer Himmel",62,"wolbecker"
"12/8/2016 5:00",52,40,8,13,"Klarer Himmel",92,"wolbecker"
"12/8/2016 6:00",120,182,7,13,"Klarer Himmel",302,"wolbecker"
"12/8/2016 7:00",629,300,7,15,"Klarer Himmel",929,"wolbecker"
"12/8/2016 8:00",628,300,7,17,"Klarer Himmel",928,"wolbecker"
"12/8/2016 9:00",564,183,8,19,"Klarer Himmel",747,"wolbecker"
"12/8/2016 10:00",384,214,9,22,"Klarer Himmel",598,"wolbecker"
"12/8/2016 11:00",337,230,9,19,"Klarer Himmel",567,"wolbecker"
"12/8/2016 12:00",333,339,10,15,"Klarer Himmel",672,"wolbecker"
"12/8/2016 13:00",386,379,9,13,"Klarer Himmel",765,"wolbecker"
"12/8/2016 14:00",337,397,9,13,"Klarer Himmel",734,"wolbecker"
"12/8/2016 15:00",371,478,9,13,"Klarer Himmel",849,"wolbecker"
"12/8/2016 16:00",445,574,8,11,"Klarer Himmel",1019,"wolbecker"
"12/8/2016 17:00",545,562,8,13,"Klarer Himmel",1107,"wolbecker"
"12/8/2016 18:00",442,507,8,13,"Klarer Himmel",949,"wolbecker"
"12/8/2016 19:00",301,479,8,19,"wolkig",780,"wolbecker"
"12/8/2016 20:00",179,334,8,17,"wolkig",513,"wolbecker"
"12/8/2016 21:00",143,181,7,19,"Regen",324,"wolbecker"
"12/8/2016 22:00",192,205,7,15,"Regen",397,"wolbecker"
"12/8/2016 23:00",110,104,7,13,"Regen",214,"wolbecker"
"12/9/2016 0:00",49,58,7,15,"wolkig",107,"wolbecker"
"12/9/2016 1:00",24,22,7,17,"Regen",46,"wolbecker"
"12/9/2016 2:00",12,11,7,17,"Regen",23,"wolbecker"
"12/9/2016 3:00",12,9,8,15,"Regen",21,"wolbecker"
"12/9/2016 4:00",11,11,8,20,"wolkig",22,"wolbecker"
"12/9/2016 5:00",35,33,8,19,"Regen",68,"wolbecker"
"12/9/2016 6:00",111,158,8,17,"Regen",269,"wolbecker"
"12/9/2016 7:00",603,278,9,17,"wolkig",881,"wolbecker"
"12/9/2016 8:00",487,263,9,19,"wolkig",750,"wolbecker"
"12/9/2016 9:00",455,180,9,15,"wolkig",635,"wolbecker"
"12/9/2016 10:00",372,210,9,15,"wolkig",582,"wolbecker"
"12/9/2016 11:00",354,281,9,11,"wolkig",635,"wolbecker"
"12/9/2016 12:00",393,392,9,13,"wolkig",785,"wolbecker"
"12/9/2016 13:00",378,486,9,13,"wolkig",864,"wolbecker"
"12/9/2016 14:00",428,502,9,11,"wolkig",930,"wolbecker"
"12/9/2016 15:00",433,489,9,9,"Regen",922,"wolbecker"
"12/9/2016 16:00",356,446,10,13,"wolkig",802,"wolbecker"
"12/9/2016 17:00",414,425,9,7,"wolkig",839,"wolbecker"
"12/9/2016 18:00",411,383,10,13,"wolkig",794,"wolbecker"
"12/9/2016 19:00",287,373,10,15,"wolkig",660,"wolbecker"
"12/9/2016 20:00",181,256,9,13,"Klarer Himmel",437,"wolbecker"
"12/9/2016 21:00",130,232,9,13,"Klarer Himmel",362,"wolbecker"
"12/9/2016 22:00",131,175,9,11,"Klarer Himmel",306,"wolbecker"
"12/9/2016 23:00",134,160,9,11,"Klarer Himmel",294,"wolbecker"
"12/10/2016 0:00",109,114,9,9,"Klarer Himmel",223,"wolbecker"
"12/10/2016 1:00",94,116,8,11,"Klarer Himmel",210,"wolbecker"
"12/10/2016 2:00",68,66,8,9,"Klarer Himmel",134,"wolbecker"
"12/10/2016 3:00",56,28,8,15,"Klarer Himmel",84,"wolbecker"
"12/10/2016 4:00",34,30,8,15,"Klarer Himmel",64,"wolbecker"
"12/10/2016 5:00",40,21,8,13,"Klarer Himmel",61,"wolbecker"
"12/10/2016 6:00",38,22,7,15,"Klarer Himmel",60,"wolbecker"
"12/10/2016 7:00",76,41,8,17,"Klarer Himmel",117,"wolbecker"
"12/10/2016 8:00",139,97,7,13,"Klarer Himmel",236,"wolbecker"
"12/10/2016 9:00",293,152,8,11,"wolkig",445,"wolbecker"
"12/10/2016 10:00",392,176,8,13,"wolkig",568,"wolbecker"
"12/10/2016 11:00",410,260,8,19,"wolkig",670,"wolbecker"
"12/10/2016 12:00",382,325,8,19,"Regen",707,"wolbecker"
"12/10/2016 13:00",319,385,7,13,"Regen",704,"wolbecker"
"12/10/2016 14:00",277,356,7,13,"Regen",633,"wolbecker"
"12/10/2016 15:00",260,298,7,11,"Regen",558,"wolbecker"
"12/10/2016 16:00",234,257,7,11,"Regen",491,"wolbecker"
"12/10/2016 17:00",237,278,7,7,NA,515,"wolbecker"
"12/10/2016 18:00",215,310,7,7,"Regen",525,"wolbecker"
"12/10/2016 19:00",163,235,8,9,"Regen",398,"wolbecker"
"12/10/2016 20:00",150,181,8,9,"Regen",331,"wolbecker"
"12/10/2016 21:00",107,149,8,9,"Regen",256,"wolbecker"
"12/10/2016 22:00",95,93,8,9,"Regen",188,"wolbecker"
"12/10/2016 23:00",116,118,9,11,"Regen",234,"wolbecker"
"12/11/2016 0:00",109,110,9,20,"Regen",219,"wolbecker"
"12/11/2016 1:00",60,69,9,20,"Regen",129,"wolbecker"
"12/11/2016 2:00",40,55,9,26,"Regen",95,"wolbecker"
"12/11/2016 3:00",47,28,9,26,"Regen",75,"wolbecker"
"12/11/2016 4:00",30,25,9,32,"Regen",55,"wolbecker"
"12/11/2016 5:00",28,14,9,35,"Regen",42,"wolbecker"
"12/11/2016 6:00",16,14,8,24,"wolkig",30,"wolbecker"
"12/11/2016 7:00",20,20,7,22,"wolkig",40,"wolbecker"
"12/11/2016 8:00",27,38,7,19,"wolkig",65,"wolbecker"
"12/11/2016 9:00",84,66,7,20,"wolkig",150,"wolbecker"
"12/11/2016 10:00",110,87,8,22,"wolkig",197,"wolbecker"
"12/11/2016 11:00",113,125,9,24,"wolkig",238,"wolbecker"
"12/11/2016 12:00",143,142,9,28,"wolkig",285,"wolbecker"
"12/11/2016 13:00",191,144,9,26,"wolkig",335,"wolbecker"
"12/11/2016 14:00",156,147,8,22,"wolkig",303,"wolbecker"
"12/11/2016 15:00",180,166,8,15,"Regen",346,"wolbecker"
"12/11/2016 16:00",191,163,8,19,"Regen",354,"wolbecker"
"12/11/2016 17:00",203,153,8,20,"wolkig",356,"wolbecker"
"12/11/2016 18:00",208,157,7,20,"wolkig",365,"wolbecker"
"12/11/2016 19:00",186,154,7,20,"Regen",340,"wolbecker"
"12/11/2016 20:00",155,107,7,17,"Regen",262,"wolbecker"
"12/11/2016 21:00",107,65,7,15,"Regen",172,"wolbecker"
"12/11/2016 22:00",94,70,7,15,"wolkig",164,"wolbecker"
"12/11/2016 23:00",36,34,7,17,"wolkig",70,"wolbecker"
"12/12/2016 0:00",22,19,7,15,"wolkig",41,"wolbecker"
"12/12/2016 1:00",9,5,7,17,"wolkig",14,"wolbecker"
"12/12/2016 2:00",1,5,7,13,"wolkig",6,"wolbecker"
"12/12/2016 3:00",2,5,7,15,"wolkig",7,"wolbecker"
"12/12/2016 4:00",11,10,7,13,"Regen",21,"wolbecker"
"12/12/2016 5:00",37,41,7,11,"Regen",78,"wolbecker"
"12/12/2016 6:00",134,176,7,9,"wolkig",310,"wolbecker"
"12/12/2016 7:00",617,307,6,9,"Nebel",924,"wolbecker"
"12/12/2016 8:00",537,277,7,7,"wolkig",814,"wolbecker"
"12/12/2016 9:00",516,184,7,9,"wolkig",700,"wolbecker"
"12/12/2016 10:00",404,177,8,9,"wolkig",581,"wolbecker"
"12/12/2016 11:00",327,232,8,9,"wolkig",559,"wolbecker"
"12/12/2016 12:00",348,351,8,9,"wolkig",699,"wolbecker"
"12/12/2016 13:00",376,405,8,13,"wolkig",781,"wolbecker"
"12/12/2016 14:00",388,354,7,13,"wolkig",742,"wolbecker"
"12/12/2016 15:00",404,459,7,9,"wolkig",863,"wolbecker"
"12/12/2016 16:00",502,550,7,4,"wolkig",1052,"wolbecker"
"12/12/2016 17:00",539,578,7,9,"wolkig",1117,"wolbecker"
"12/12/2016 18:00",402,518,7,6,"wolkig",920,"wolbecker"
"12/12/2016 19:00",287,414,6,4,"wolkig",701,"wolbecker"
"12/12/2016 20:00",157,338,6,6,"wolkig",495,"wolbecker"
"12/12/2016 21:00",118,159,6,6,"wolkig",277,"wolbecker"
"12/12/2016 22:00",125,176,6,6,"wolkig",301,"wolbecker"
"12/12/2016 23:00",54,68,6,7,"wolkig",122,"wolbecker"
"12/13/2016 0:00",31,44,6,7,"wolkig",75,"wolbecker"
"12/13/2016 1:00",25,15,6,6,"wolkig",40,"wolbecker"
"12/13/2016 2:00",22,10,5,7,"wolkig",32,"wolbecker"
"12/13/2016 3:00",4,4,5,7,"wolkig",8,"wolbecker"
"12/13/2016 4:00",7,15,4,6,"wolkig",22,"wolbecker"
"12/13/2016 5:00",32,45,5,7,"wolkig",77,"wolbecker"
"12/13/2016 6:00",145,195,5,7,"Klarer Himmel",340,"wolbecker"
"12/13/2016 7:00",614,313,6,7,"Regen",927,"wolbecker"
"12/13/2016 8:00",580,286,6,7,"Regen",866,"wolbecker"
"12/13/2016 9:00",506,181,6,7,"wolkig",687,"wolbecker"
"12/13/2016 10:00",377,188,6,7,"wolkig",565,"wolbecker"
"12/13/2016 11:00",350,211,6,6,"Regen",561,"wolbecker"
"12/13/2016 12:00",300,331,6,11,"Regen",631,"wolbecker"
"12/13/2016 13:00",319,358,6,9,"Regen",677,"wolbecker"
"12/13/2016 14:00",378,371,6,13,"Regen",749,"wolbecker"
"12/13/2016 15:00",394,443,6,9,"wolkig",837,"wolbecker"
"12/13/2016 16:00",447,530,6,9,"wolkig",977,"wolbecker"
"12/13/2016 17:00",490,561,6,7,"wolkig",1051,"wolbecker"
"12/13/2016 18:00",474,504,7,6,"wolkig",978,"wolbecker"
"12/13/2016 19:00",314,455,7,7,"wolkig",769,"wolbecker"
"12/13/2016 20:00",182,298,7,6,"wolkig",480,"wolbecker"
"12/13/2016 21:00",132,190,7,6,"wolkig",322,"wolbecker"
"12/13/2016 22:00",143,190,7,7,"wolkig",333,"wolbecker"
"12/13/2016 23:00",73,89,7,11,"wolkig",162,"wolbecker"
"12/14/2016 0:00",35,66,7,0,"wolkig",101,"wolbecker"
"12/14/2016 1:00",18,17,7,4,"wolkig",35,"wolbecker"
"12/14/2016 2:00",9,9,7,0,"wolkig",18,"wolbecker"
"12/14/2016 3:00",2,7,7,4,"Nebel",9,"wolbecker"
"12/14/2016 4:00",6,9,7,6,"Nebel",15,"wolbecker"
"12/14/2016 5:00",34,46,7,6,"wolkig",80,"wolbecker"
"12/14/2016 6:00",136,198,7,6,"wolkig",334,"wolbecker"
"12/14/2016 7:00",610,308,7,4,"wolkig",918,"wolbecker"
"12/14/2016 8:00",610,280,7,0,"wolkig",890,"wolbecker"
"12/14/2016 9:00",546,187,7,6,"wolkig",733,"wolbecker"
"12/14/2016 10:00",380,215,7,6,"Nebel",595,"wolbecker"
"12/14/2016 11:00",339,273,8,6,"Regen",612,"wolbecker"
"12/14/2016 12:00",382,352,8,6,"Regen",734,"wolbecker"
"12/14/2016 13:00",383,372,8,4,"wolkig",755,"wolbecker"
"12/14/2016 14:00",389,422,8,7,"Nebel",811,"wolbecker"
"12/14/2016 15:00",398,457,8,4,"wolkig",855,"wolbecker"
"12/14/2016 16:00",453,553,8,6,"wolkig",1006,"wolbecker"
"12/14/2016 17:00",566,501,8,4,"wolkig",1067,"wolbecker"
"12/14/2016 18:00",489,512,8,4,"Nebel",1001,"wolbecker"
"12/14/2016 19:00",327,449,8,4,"wolkig",776,"wolbecker"
"12/14/2016 20:00",182,356,8,6,"wolkig",538,"wolbecker"
"12/14/2016 21:00",154,209,8,4,"wolkig",363,"wolbecker"
"12/14/2016 22:00",147,210,8,2,"wolkig",357,"wolbecker"
"12/14/2016 23:00",105,117,8,7,"wolkig",222,"wolbecker"
"12/15/2016 0:00",48,90,7,4,"wolkig",138,"wolbecker"
"12/15/2016 1:00",20,32,6,4,"teilweise bewölkt",52,"wolbecker"
"12/15/2016 2:00",21,16,6,6,"teilweise bewölkt",37,"wolbecker"
"12/15/2016 3:00",18,17,5,6,"teilweise bewölkt",35,"wolbecker"
"12/15/2016 4:00",6,17,5,6,"teilweise bewölkt",23,"wolbecker"
"12/15/2016 5:00",33,41,5,7,NA,74,"wolbecker"
"12/15/2016 6:00",127,210,5,9,NA,337,"wolbecker"
"12/15/2016 7:00",620,317,5,6,NA,937,"wolbecker"
"12/15/2016 8:00",604,263,4,6,NA,867,"wolbecker"
"12/15/2016 9:00",553,212,5,9,"teilweise bewölkt",765,"wolbecker"
"12/15/2016 10:00",432,222,5,11,"wolkig",654,"wolbecker"
"12/15/2016 11:00",371,281,6,11,"wolkig",652,"wolbecker"
"12/15/2016 12:00",354,370,6,9,"wolkig",724,"wolbecker"
"12/15/2016 13:00",405,421,6,9,"wolkig",826,"wolbecker"
"12/15/2016 14:00",371,430,6,9,"wolkig",801,"wolbecker"
"12/15/2016 15:00",468,469,6,7,"wolkig",937,"wolbecker"
"12/15/2016 16:00",489,557,6,6,"teilweise bewölkt",1046,"wolbecker"
"12/15/2016 17:00",541,602,5,6,"Klarer Himmel",1143,"wolbecker"
"12/15/2016 18:00",488,559,5,7,"Klarer Himmel",1047,"wolbecker"
"12/15/2016 19:00",332,461,4,9,"Klarer Himmel",793,"wolbecker"
"12/15/2016 20:00",204,352,4,7,"Klarer Himmel",556,"wolbecker"
"12/15/2016 21:00",143,230,4,6,"Klarer Himmel",373,"wolbecker"
"12/15/2016 22:00",155,182,4,6,"Klarer Himmel",337,"wolbecker"
"12/15/2016 23:00",114,101,3,7,"Klarer Himmel",215,"wolbecker"
"12/16/2016 0:00",62,79,3,7,"Klarer Himmel",141,"wolbecker"
"12/16/2016 1:00",35,38,3,7,"Klarer Himmel",73,"wolbecker"
"12/16/2016 2:00",24,23,2,6,"Klarer Himmel",47,"wolbecker"
"12/16/2016 3:00",20,16,2,6,"Klarer Himmel",36,"wolbecker"
"12/16/2016 4:00",22,14,2,6,"Klarer Himmel",36,"wolbecker"
"12/16/2016 5:00",33,42,2,6,"Klarer Himmel",75,"wolbecker"
"12/16/2016 6:00",120,143,2,6,NA,263,"wolbecker"
"12/16/2016 7:00",534,272,2,6,"Nebel",806,"wolbecker"
"12/16/2016 8:00",497,276,2,7,"Nebel",773,"wolbecker"
"12/16/2016 9:00",462,203,2,6,NA,665,"wolbecker"
"12/16/2016 10:00",400,200,3,9,"Klarer Himmel",600,"wolbecker"
"12/16/2016 11:00",355,266,4,9,"Klarer Himmel",621,"wolbecker"
"12/16/2016 12:00",412,370,5,7,"Klarer Himmel",782,"wolbecker"
"12/16/2016 13:00",445,502,6,7,"Klarer Himmel",947,"wolbecker"
"12/16/2016 14:00",469,535,6,7,"Klarer Himmel",1004,"wolbecker"
"12/16/2016 15:00",444,523,5,2,"Klarer Himmel",967,"wolbecker"
"12/16/2016 16:00",399,474,3,4,"Klarer Himmel",873,"wolbecker"
"12/16/2016 17:00",432,431,1,2,"Klarer Himmel",863,"wolbecker"
"12/16/2016 18:00",398,414,1,4,"Klarer Himmel",812,"wolbecker"
"12/16/2016 19:00",320,408,1,6,"Nebel",728,"wolbecker"
"12/16/2016 20:00",163,288,1,7,NA,451,"wolbecker"
"12/16/2016 21:00",133,190,1,7,NA,323,"wolbecker"
"12/16/2016 22:00",130,161,0,4,NA,291,"wolbecker"
"12/16/2016 23:00",116,179,0,4,NA,295,"wolbecker"
"12/17/2016 0:00",116,128,-1,4,"Nebel",244,"wolbecker"
"12/17/2016 1:00",70,121,0,6,"Nebel",191,"wolbecker"
"12/17/2016 2:00",51,56,0,4,NA,107,"wolbecker"
"12/17/2016 3:00",53,55,0,6,NA,108,"wolbecker"
"12/17/2016 4:00",28,35,1,4,NA,63,"wolbecker"
"12/17/2016 5:00",42,15,0,2,NA,57,"wolbecker"
"12/17/2016 6:00",39,24,0,7,NA,63,"wolbecker"
"12/17/2016 7:00",65,51,0,6,"Nebel",116,"wolbecker"
"12/17/2016 8:00",122,91,1,6,"Nebel",213,"wolbecker"
"12/17/2016 9:00",275,121,1,6,NA,396,"wolbecker"
"12/17/2016 10:00",383,175,2,6,NA,558,"wolbecker"
"12/17/2016 11:00",399,245,2,6,NA,644,"wolbecker"
"12/17/2016 12:00",394,304,3,6,NA,698,"wolbecker"
"12/17/2016 13:00",347,371,4,2,NA,718,"wolbecker"
"12/17/2016 14:00",322,343,4,9,NA,665,"wolbecker"
"12/17/2016 15:00",291,352,4,2,NA,643,"wolbecker"
"12/17/2016 16:00",288,324,4,7,"wolkig",612,"wolbecker"
"12/17/2016 17:00",287,323,5,4,"wolkig",610,"wolbecker"
"12/17/2016 18:00",239,320,5,7,"Regen",559,"wolbecker"
"12/17/2016 19:00",221,316,5,7,"Regen",537,"wolbecker"
"12/17/2016 20:00",156,226,5,6,"Regen",382,"wolbecker"
"12/17/2016 21:00",122,154,5,7,"Regen",276,"wolbecker"
"12/17/2016 22:00",126,113,5,9,"wolkig",239,"wolbecker"
"12/17/2016 23:00",98,128,6,9,"wolkig",226,"wolbecker"
"12/18/2016 0:00",109,132,6,9,"Regen",241,"wolbecker"
"12/18/2016 1:00",91,80,6,13,"Regen",171,"wolbecker"
"12/18/2016 2:00",52,49,5,9,"wolkig",101,"wolbecker"
"12/18/2016 3:00",55,44,6,13,"wolkig",99,"wolbecker"
"12/18/2016 4:00",36,27,6,13,"wolkig",63,"wolbecker"
"12/18/2016 5:00",42,13,6,11,"wolkig",55,"wolbecker"
"12/18/2016 6:00",25,18,5,9,"wolkig",43,"wolbecker"
"12/18/2016 7:00",21,21,5,11,"wolkig",42,"wolbecker"
"12/18/2016 8:00",28,27,6,15,"wolkig",55,"wolbecker"
"12/18/2016 9:00",83,59,6,11,"wolkig",142,"wolbecker"
"12/18/2016 10:00",134,92,6,11,"wolkig",226,"wolbecker"
"12/18/2016 11:00",114,84,7,13,"wolkig",198,"wolbecker"
"12/18/2016 12:00",173,120,7,11,"wolkig",293,"wolbecker"
"12/18/2016 13:00",179,142,7,13,"wolkig",321,"wolbecker"
"12/18/2016 14:00",190,144,7,9,"wolkig",334,"wolbecker"
"12/18/2016 15:00",215,194,7,7,"wolkig",409,"wolbecker"
"12/18/2016 16:00",218,191,6,13,"wolkig",409,"wolbecker"
"12/18/2016 17:00",255,205,6,7,"wolkig",460,"wolbecker"
"12/18/2016 18:00",188,179,6,6,"wolkig",367,"wolbecker"
"12/18/2016 19:00",173,193,6,2,"wolkig",366,"wolbecker"
"12/18/2016 20:00",144,164,5,6,"wolkig",308,"wolbecker"
"12/18/2016 21:00",105,88,5,0,"wolkig",193,"wolbecker"
"12/18/2016 22:00",101,62,5,0,"wolkig",163,"wolbecker"
"12/18/2016 23:00",59,38,5,4,"wolkig",97,"wolbecker"
"12/19/2016 0:00",30,13,5,4,"wolkig",43,"wolbecker"
"12/19/2016 1:00",13,10,5,0,"wolkig",23,"wolbecker"
"12/19/2016 2:00",8,2,5,0,"wolkig",10,"wolbecker"
"12/19/2016 3:00",6,2,5,0,"wolkig",8,"wolbecker"
"12/19/2016 4:00",9,13,5,0,"Regen",22,"wolbecker"
"12/19/2016 5:00",28,45,5,0,"wolkig",73,"wolbecker"
"12/19/2016 6:00",120,162,4,0,"Nebel",282,"wolbecker"
"12/19/2016 7:00",573,279,5,4,"wolkig",852,"wolbecker"
"12/19/2016 8:00",520,262,4,6,"wolkig",782,"wolbecker"
"12/19/2016 9:00",505,179,4,4,"wolkig",684,"wolbecker"
"12/19/2016 10:00",422,203,4,7,"wolkig",625,"wolbecker"
"12/19/2016 11:00",434,247,5,4,"teilweise bewölkt",681,"wolbecker"
"12/19/2016 12:00",379,378,6,7,"teilweise bewölkt",757,"wolbecker"
"12/19/2016 13:00",415,393,7,7,"teilweise bewölkt",808,"wolbecker"
"12/19/2016 14:00",444,395,6,9,"teilweise bewölkt",839,"wolbecker"
"12/19/2016 15:00",437,455,5,7,"teilweise bewölkt",892,"wolbecker"
"12/19/2016 16:00",461,558,5,6,"wolkig",1019,"wolbecker"
"12/19/2016 17:00",591,572,5,9,"wolkig",1163,"wolbecker"
"12/19/2016 18:00",453,521,4,4,"teilweise bewölkt",974,"wolbecker"
"12/19/2016 19:00",308,464,3,6,"Klarer Himmel",772,"wolbecker"
"12/19/2016 20:00",152,315,3,7,"Klarer Himmel",467,"wolbecker"
"12/19/2016 21:00",121,192,1,6,"Klarer Himmel",313,"wolbecker"
"12/19/2016 22:00",137,132,1,6,"Klarer Himmel",269,"wolbecker"
"12/19/2016 23:00",70,92,0,4,"Klarer Himmel",162,"wolbecker"
"12/20/2016 0:00",46,48,0,4,"Klarer Himmel",94,"wolbecker"
"12/20/2016 1:00",16,24,-1,4,"Klarer Himmel",40,"wolbecker"
"12/20/2016 2:00",6,18,-1,4,NA,24,"wolbecker"
"12/20/2016 3:00",4,13,0,6,"Nebel",17,"wolbecker"
"12/20/2016 4:00",7,9,-1,4,"Nebel",16,"wolbecker"
"12/20/2016 5:00",31,49,-1,4,"Nebel",80,"wolbecker"
"12/20/2016 6:00",137,173,-3,0,"Nebel",310,"wolbecker"
"12/20/2016 7:00",582,285,-3,6,"Nebel",867,"wolbecker"
"12/20/2016 8:00",542,247,-3,0,"Nebel",789,"wolbecker"
"12/20/2016 9:00",523,184,-2,6,"Nebel",707,"wolbecker"
"12/20/2016 10:00",395,192,1,0,"Klarer Himmel",587,"wolbecker"
"12/20/2016 11:00",402,271,3,6,"Klarer Himmel",673,"wolbecker"
"12/20/2016 12:00",390,353,4,7,"Klarer Himmel",743,"wolbecker"
"12/20/2016 13:00",384,395,3,13,"Klarer Himmel",779,"wolbecker"
"12/20/2016 14:00",382,409,2,7,"Klarer Himmel",791,"wolbecker"
"12/20/2016 15:00",436,525,1,9,"Klarer Himmel",961,"wolbecker"
"12/20/2016 16:00",509,563,0,6,NA,1072,"wolbecker"
"12/20/2016 17:00",542,554,-1,4,"Nebel",1096,"wolbecker"
"12/20/2016 18:00",434,556,-2,4,"Nebel",990,"wolbecker"
"12/20/2016 19:00",307,491,-2,4,"Nebel",798,"wolbecker"
"12/20/2016 20:00",170,308,-3,2,"Nebel",478,"wolbecker"
"12/20/2016 21:00",114,153,-2,6,"Nebel",267,"wolbecker"
"12/20/2016 22:00",162,163,-2,7,"Nebel",325,"wolbecker"
"12/20/2016 23:00",125,101,-2,7,NA,226,"wolbecker"
"12/21/2016 0:00",61,61,-2,9,NA,122,"wolbecker"
"12/21/2016 1:00",22,27,-2,6,NA,49,"wolbecker"
"12/21/2016 2:00",15,19,-2,7,"Klarer Himmel",34,"wolbecker"
"12/21/2016 3:00",19,6,0,7,"wolkig",25,"wolbecker"
"12/21/2016 4:00",22,15,0,9,"wolkig",37,"wolbecker"
"12/21/2016 5:00",39,44,0,7,"wolkig",83,"wolbecker"
"12/21/2016 6:00",123,177,0,4,"teilweise bewölkt",300,"wolbecker"
"12/21/2016 7:00",573,262,0,9,"Klarer Himmel",835,"wolbecker"
"12/21/2016 8:00",520,262,0,9,"Klarer Himmel",782,"wolbecker"
"12/21/2016 9:00",532,220,1,7,"Klarer Himmel",752,"wolbecker"
"12/21/2016 10:00",475,244,2,9,"Klarer Himmel",719,"wolbecker"
"12/21/2016 11:00",445,319,4,13,"Klarer Himmel",764,"wolbecker"
"12/21/2016 12:00",427,394,4,15,"Klarer Himmel",821,"wolbecker"
"12/21/2016 13:00",466,459,6,17,"Klarer Himmel",925,"wolbecker"
"12/21/2016 14:00",379,503,6,13,"wolkig",882,"wolbecker"
"12/21/2016 15:00",448,471,5,13,"wolkig",919,"wolbecker"
"12/21/2016 16:00",453,546,5,13,"wolkig",999,"wolbecker"
"12/21/2016 17:00",575,491,5,17,"Klarer Himmel",1066,"wolbecker"
"12/21/2016 18:00",459,479,4,9,"Klarer Himmel",938,"wolbecker"
"12/21/2016 19:00",319,429,4,13,"wolkig",748,"wolbecker"
"12/21/2016 20:00",176,340,4,17,"Regen",516,"wolbecker"
"12/21/2016 21:00",141,209,4,11,"Regen",350,"wolbecker"
"12/21/2016 22:00",131,189,3,7,"Regen",320,"wolbecker"
"12/21/2016 23:00",91,105,3,6,"Regen",196,"wolbecker"
"12/22/2016 0:00",50,76,3,6,"Regen",126,"wolbecker"
"12/22/2016 1:00",53,51,3,7,"Regen",104,"wolbecker"
"12/22/2016 2:00",41,38,4,13,"Regen",79,"wolbecker"
"12/22/2016 3:00",12,20,4,11,"Regen",32,"wolbecker"
"12/22/2016 4:00",21,19,4,11,"Regen",40,"wolbecker"
"12/22/2016 5:00",33,37,3,6,"Regen",70,"wolbecker"
"12/22/2016 6:00",90,147,3,7,"Regen",237,"wolbecker"
"12/22/2016 7:00",366,201,3,7,"Regen",567,"wolbecker"
"12/22/2016 8:00",399,179,4,11,"Regen",578,"wolbecker"
"12/22/2016 9:00",356,171,4,11,"Regen",527,"wolbecker"
"12/22/2016 10:00",338,187,4,4,"wolkig",525,"wolbecker"
"12/22/2016 11:00",323,205,4,9,"wolkig",528,"wolbecker"
"12/22/2016 12:00",377,331,5,7,"wolkig",708,"wolbecker"
"12/22/2016 13:00",351,357,5,7,"Regen",708,"wolbecker"
"12/22/2016 14:00",420,375,6,9,"Regen",795,"wolbecker"
"12/22/2016 15:00",386,453,5,9,"wolkig",839,"wolbecker"
"12/22/2016 16:00",412,436,6,9,"wolkig",848,"wolbecker"
"12/22/2016 17:00",424,437,5,11,"wolkig",861,"wolbecker"
"12/22/2016 18:00",367,382,5,9,"wolkig",749,"wolbecker"
"12/22/2016 19:00",260,404,5,15,"wolkig",664,"wolbecker"
"12/22/2016 20:00",148,281,5,19,"Regen",429,"wolbecker"
"12/22/2016 21:00",92,138,5,15,"Regen",230,"wolbecker"
"12/22/2016 22:00",120,136,6,15,"wolkig",256,"wolbecker"
"12/22/2016 23:00",74,104,5,11,"teilweise bewölkt",178,"wolbecker"
"12/23/2016 0:00",58,56,5,11,"wolkig",114,"wolbecker"
"12/23/2016 1:00",36,36,4,9,"teilweise bewölkt",72,"wolbecker"
"12/23/2016 2:00",22,20,4,7,"wolkig",42,"wolbecker"
"12/23/2016 3:00",22,13,4,9,"teilweise bewölkt",35,"wolbecker"
"12/23/2016 4:00",8,17,5,9,"wolkig",25,"wolbecker"
"12/23/2016 5:00",26,33,5,11,"wolkig",59,"wolbecker"
"12/23/2016 6:00",78,65,5,13,"wolkig",143,"wolbecker"
"12/23/2016 7:00",201,119,5,13,"wolkig",320,"wolbecker"
"12/23/2016 8:00",249,133,5,13,"wolkig",382,"wolbecker"
"12/23/2016 9:00",289,130,5,15,"wolkig",419,"wolbecker"
"12/23/2016 10:00",314,162,6,17,"wolkig",476,"wolbecker"
"12/23/2016 11:00",339,231,6,15,"wolkig",570,"wolbecker"
"12/23/2016 12:00",394,352,7,17,"wolkig",746,"wolbecker"
"12/23/2016 13:00",416,370,8,15,"wolkig",786,"wolbecker"
"12/23/2016 14:00",331,399,8,17,"wolkig",730,"wolbecker"
"12/23/2016 15:00",396,367,8,15,"wolkig",763,"wolbecker"
"12/23/2016 16:00",332,391,7,15,"Klarer Himmel",723,"wolbecker"
"12/23/2016 17:00",298,368,6,17,"Klarer Himmel",666,"wolbecker"
"12/23/2016 18:00",232,312,6,17,"Klarer Himmel",544,"wolbecker"
"12/23/2016 19:00",190,243,5,20,"Klarer Himmel",433,"wolbecker"
"12/23/2016 20:00",114,176,5,19,"Klarer Himmel",290,"wolbecker"
"12/23/2016 21:00",73,68,5,22,"Klarer Himmel",141,"wolbecker"
"12/23/2016 22:00",78,73,4,22,"wolkig",151,"wolbecker"
"12/23/2016 23:00",76,89,5,26,"wolkig",165,"wolbecker"
"12/24/2016 0:00",37,67,6,22,"wolkig",104,"wolbecker"
"12/24/2016 1:00",41,93,6,26,"Regen",134,"wolbecker"
"12/24/2016 2:00",22,41,6,22,"Regen",63,"wolbecker"
"12/24/2016 3:00",27,30,6,24,"Regen",57,"wolbecker"
"12/24/2016 4:00",14,15,7,20,"Regen",29,"wolbecker"
"12/24/2016 5:00",12,9,7,22,"Regen",21,"wolbecker"
"12/24/2016 6:00",37,17,7,20,"wolkig",54,"wolbecker"
"12/24/2016 7:00",71,35,7,20,"wolkig",106,"wolbecker"
"12/24/2016 8:00",131,74,7,19,"wolkig",205,"wolbecker"
"12/24/2016 9:00",232,115,7,19,"wolkig",347,"wolbecker"
"12/24/2016 10:00",323,210,8,24,"wolkig",533,"wolbecker"
"12/24/2016 11:00",261,238,8,32,"wolkig",499,"wolbecker"
"12/24/2016 12:00",154,288,8,30,"wolkig",442,"wolbecker"
"12/24/2016 13:00",95,224,8,30,"wolkig",319,"wolbecker"
"12/24/2016 14:00",79,152,8,28,"wolkig",231,"wolbecker"
"12/24/2016 15:00",56,55,7,28,"wolkig",111,"wolbecker"
"12/24/2016 16:00",61,57,7,24,"wolkig",118,"wolbecker"
"12/24/2016 17:00",41,37,7,24,"wolkig",78,"wolbecker"
"12/24/2016 18:00",22,33,7,26,"wolkig",55,"wolbecker"
"12/24/2016 19:00",20,24,8,26,"wolkig",44,"wolbecker"
"12/24/2016 20:00",15,21,8,24,"wolkig",36,"wolbecker"
"12/24/2016 21:00",20,11,8,30,"wolkig",31,"wolbecker"
"12/24/2016 22:00",27,21,8,32,"wolkig",48,"wolbecker"
"12/24/2016 23:00",25,18,8,35,"wolkig",43,"wolbecker"
"12/25/2016 0:00",18,28,8,26,"wolkig",46,"wolbecker"
"12/25/2016 1:00",8,14,8,30,"Regen",22,"wolbecker"
"12/25/2016 2:00",5,5,8,26,"Regen",10,"wolbecker"
"12/25/2016 3:00",5,3,8,28,"Regen",8,"wolbecker"
"12/25/2016 4:00",8,2,8,28,"Regen",10,"wolbecker"
"12/25/2016 5:00",11,3,9,28,"wolkig",14,"wolbecker"
"12/25/2016 6:00",5,3,9,26,"wolkig",8,"wolbecker"
"12/25/2016 7:00",11,10,9,28,"Regen",21,"wolbecker"
"12/25/2016 8:00",11,13,8,28,"Regen",24,"wolbecker"
"12/25/2016 9:00",14,18,9,30,"Regen",32,"wolbecker"
"12/25/2016 10:00",22,25,9,32,"Regen",47,"wolbecker"
"12/25/2016 11:00",23,30,9,26,"Regen",53,"wolbecker"
"12/25/2016 12:00",27,37,9,22,"Regen",64,"wolbecker"
"12/25/2016 13:00",25,34,9,20,"Regen",59,"wolbecker"
"12/25/2016 14:00",37,26,9,24,"Regen",63,"wolbecker"
"12/25/2016 15:00",30,37,9,24,"Regen",67,"wolbecker"
"12/25/2016 16:00",23,24,10,24,"Regen",47,"wolbecker"
"12/25/2016 17:00",39,26,10,26,"Regen",65,"wolbecker"
"12/25/2016 18:00",42,21,10,24,"Regen",63,"wolbecker"
"12/25/2016 19:00",28,18,10,30,"Regen",46,"wolbecker"
"12/25/2016 20:00",26,20,11,26,"Regen",46,"wolbecker"
"12/25/2016 21:00",25,25,11,24,"wolkig",50,"wolbecker"
"12/25/2016 22:00",23,26,11,24,"Regen",49,"wolbecker"
"12/25/2016 23:00",21,17,11,26,"wolkig",38,"wolbecker"
"12/26/2016 0:00",15,18,11,24,"Regen",33,"wolbecker"
"12/26/2016 1:00",8,12,11,26,"wolkig",20,"wolbecker"
"12/26/2016 2:00",9,12,11,30,"Regen",21,"wolbecker"
"12/26/2016 3:00",4,8,11,24,"Regen",12,"wolbecker"
"12/26/2016 4:00",9,3,11,24,"Regen",12,"wolbecker"
"12/26/2016 5:00",12,5,11,26,"Regen",17,"wolbecker"
"12/26/2016 6:00",17,8,10,26,"Regen",25,"wolbecker"
"12/26/2016 7:00",8,8,10,22,"Regen",16,"wolbecker"
"12/26/2016 8:00",21,17,9,33,"Regen",38,"wolbecker"
"12/26/2016 9:00",22,15,8,24,"Regen",37,"wolbecker"
"12/26/2016 10:00",25,21,8,24,"Regen",46,"wolbecker"
"12/26/2016 11:00",35,33,8,32,"wolkig",68,"wolbecker"
"12/26/2016 12:00",44,43,8,32,"teilweise bewölkt",87,"wolbecker"
"12/26/2016 13:00",55,36,8,28,"teilweise bewölkt",91,"wolbecker"
"12/26/2016 14:00",56,49,8,35,"teilweise bewölkt",105,"wolbecker"
"12/26/2016 15:00",69,53,7,33,"teilweise bewölkt",122,"wolbecker"
"12/26/2016 16:00",69,69,6,26,"teilweise bewölkt",138,"wolbecker"
"12/26/2016 17:00",60,61,6,32,"teilweise bewölkt",121,"wolbecker"
"12/26/2016 18:00",58,60,6,26,"teilweise bewölkt",118,"wolbecker"
"12/26/2016 19:00",66,41,5,28,"teilweise bewölkt",107,"wolbecker"
"12/26/2016 20:00",54,40,5,28,"teilweise bewölkt",94,"wolbecker"
"12/26/2016 21:00",37,51,4,28,"Klarer Himmel",88,"wolbecker"
"12/26/2016 22:00",35,13,5,30,"Klarer Himmel",48,"wolbecker"
"12/26/2016 23:00",30,10,5,32,"Klarer Himmel",40,"wolbecker"
"12/27/2016 0:00",19,17,4,32,"Klarer Himmel",36,"wolbecker"
"12/27/2016 1:00",19,13,5,30,"Klarer Himmel",32,"wolbecker"
"12/27/2016 2:00",5,9,5,22,"teilweise bewölkt",14,"wolbecker"
"12/27/2016 3:00",3,16,4,20,"teilweise bewölkt",19,"wolbecker"
"12/27/2016 4:00",8,10,4,19,"teilweise bewölkt",18,"wolbecker"
"12/27/2016 5:00",21,12,4,19,"wolkig",33,"wolbecker"
"12/27/2016 6:00",78,53,4,19,"teilweise bewölkt",131,"wolbecker"
"12/27/2016 7:00",145,70,5,20,"wolkig",215,"wolbecker"
"12/27/2016 8:00",157,68,5,17,"wolkig",225,"wolbecker"
"12/27/2016 9:00",186,74,5,17,"wolkig",260,"wolbecker"
"12/27/2016 10:00",172,104,6,26,"Klarer Himmel",276,"wolbecker"
"12/27/2016 11:00",208,134,7,26,"Klarer Himmel",342,"wolbecker"
"12/27/2016 12:00",229,188,8,24,"teilweise bewölkt",417,"wolbecker"
"12/27/2016 13:00",220,188,8,22,"teilweise bewölkt",408,"wolbecker"
"12/27/2016 14:00",263,253,8,22,"wolkig",516,"wolbecker"
"12/27/2016 15:00",245,238,8,19,"wolkig",483,"wolbecker"
"12/27/2016 16:00",246,335,8,17,"wolkig",581,"wolbecker"
"12/27/2016 17:00",223,268,7,15,"teilweise bewölkt",491,"wolbecker"
"12/27/2016 18:00",170,202,6,15,"teilweise bewölkt",372,"wolbecker"
"12/27/2016 19:00",137,209,6,15,"teilweise bewölkt",346,"wolbecker"
"12/27/2016 20:00",67,106,5,11,"teilweise bewölkt",173,"wolbecker"
"12/27/2016 21:00",59,71,4,11,"teilweise bewölkt",130,"wolbecker"
"12/27/2016 22:00",76,70,6,9,"wolkig",146,"wolbecker"
"12/27/2016 23:00",56,35,6,11,"wolkig",91,"wolbecker"
"12/28/2016 0:00",29,26,5,11,"wolkig",55,"wolbecker"
"12/28/2016 1:00",29,15,5,11,"wolkig",44,"wolbecker"
"12/28/2016 2:00",16,10,3,11,"wolkig",26,"wolbecker"
"12/28/2016 3:00",5,10,2,13,"teilweise bewölkt",15,"wolbecker"
"12/28/2016 4:00",6,8,2,7,"Klarer Himmel",14,"wolbecker"
"12/28/2016 5:00",25,16,2,6,NA,41,"wolbecker"
"12/28/2016 6:00",75,66,0,0,"Nebel",141,"wolbecker"
"12/28/2016 7:00",161,86,3,11,"Nebel",247,"wolbecker"
"12/28/2016 8:00",196,96,3,9,"Nebel",292,"wolbecker"
"12/28/2016 9:00",252,94,3,9,"Nebel",346,"wolbecker"
"12/28/2016 10:00",230,104,3,9,"wolkig",334,"wolbecker"
"12/28/2016 11:00",265,155,4,6,"wolkig",420,"wolbecker"
"12/28/2016 12:00",290,245,4,7,"wolkig",535,"wolbecker"
"12/28/2016 13:00",264,237,5,7,"wolkig",501,"wolbecker"
"12/28/2016 14:00",226,247,5,6,"wolkig",473,"wolbecker"
"12/28/2016 15:00",267,316,5,7,"wolkig",583,"wolbecker"
"12/28/2016 16:00",258,329,4,4,"wolkig",587,"wolbecker"
"12/28/2016 17:00",245,291,4,6,"wolkig",536,"wolbecker"
"12/28/2016 18:00",195,234,4,6,"wolkig",429,"wolbecker"
"12/28/2016 19:00",141,191,4,2,"wolkig",332,"wolbecker"
"12/28/2016 20:00",81,134,4,0,"wolkig",215,"wolbecker"
"12/28/2016 21:00",70,91,5,4,"wolkig",161,"wolbecker"
"12/28/2016 22:00",68,78,4,4,"wolkig",146,"wolbecker"
"12/28/2016 23:00",59,54,3,4,"wolkig",113,"wolbecker"
"12/29/2016 0:00",40,36,3,4,"wolkig",76,"wolbecker"
"12/29/2016 1:00",28,35,0,2,"teilweise bewölkt",63,"wolbecker"
"12/29/2016 2:00",24,20,-1,0,"Nebel",44,"wolbecker"
"12/29/2016 3:00",12,9,-2,0,"Nebel",21,"wolbecker"
"12/29/2016 4:00",12,10,-3,0,"Nebel",22,"wolbecker"
"12/29/2016 5:00",30,23,-3,0,"Nebel",53,"wolbecker"
"12/29/2016 6:00",77,57,-3,0,"Nebel",134,"wolbecker"
"12/29/2016 7:00",149,86,-3,0,"Nebel",235,"wolbecker"
"12/29/2016 8:00",199,89,-4,2,"Nebel",288,"wolbecker"
"12/29/2016 9:00",201,96,-1,6,"Klarer Himmel",297,"wolbecker"
"12/29/2016 10:00",215,117,1,4,"Klarer Himmel",332,"wolbecker"
"12/29/2016 11:00",251,155,3,7,"Klarer Himmel",406,"wolbecker"
"12/29/2016 12:00",257,186,4,4,"Klarer Himmel",443,"wolbecker"
"12/29/2016 13:00",245,243,5,7,"Klarer Himmel",488,"wolbecker"
"12/29/2016 14:00",283,263,5,9,"Klarer Himmel",546,"wolbecker"
"12/29/2016 15:00",261,306,4,7,"Klarer Himmel",567,"wolbecker"
"12/29/2016 16:00",267,316,2,4,"Klarer Himmel",583,"wolbecker"
"12/29/2016 17:00",257,303,0,4,"Klarer Himmel",560,"wolbecker"
"12/29/2016 18:00",195,283,1,7,"Klarer Himmel",478,"wolbecker"
"12/29/2016 19:00",165,235,0,6,"Klarer Himmel",400,"wolbecker"
"12/29/2016 20:00",93,141,-2,2,"Klarer Himmel",234,"wolbecker"
"12/29/2016 21:00",73,67,-3,6,"Nebel",140,"wolbecker"
"12/29/2016 22:00",56,85,-3,4,"Nebel",141,"wolbecker"
"12/29/2016 23:00",64,53,-3,0,"Nebel",117,"wolbecker"
"12/30/2016 0:00",NA,NA,NA,NA,NA,NA,"wolbecker"
"12/30/2016 1:00",NA,NA,NA,NA,NA,NA,"wolbecker"
"12/30/2016 2:00",NA,NA,NA,NA,NA,NA,"wolbecker"
"12/30/2016 3:00",NA,NA,NA,NA,NA,NA,"wolbecker"
"12/30/2016 4:00",NA,NA,NA,NA,NA,NA,"wolbecker"
"12/30/2016 5:00",NA,NA,NA,NA,NA,NA,"wolbecker"
"12/30/2016 6:00",NA,NA,NA,NA,NA,NA,"wolbecker"
"12/30/2016 7:00",NA,NA,NA,NA,NA,NA,"wolbecker"
"12/30/2016 8:00",NA,NA,NA,NA,NA,NA,"wolbecker"
"12/30/2016 9:00",NA,NA,NA,NA,NA,NA,"wolbecker"
"12/30/2016 10:00",NA,NA,NA,NA,NA,NA,"wolbecker"
"12/30/2016 11:00",NA,NA,NA,NA,NA,NA,"wolbecker"
"12/30/2016 12:00",NA,NA,NA,NA,NA,NA,"wolbecker"
"12/30/2016 13:00",NA,NA,NA,NA,NA,NA,"wolbecker"
"12/30/2016 14:00",NA,NA,NA,NA,NA,NA,"wolbecker"
"12/30/2016 15:00",NA,NA,NA,NA,NA,NA,"wolbecker"
"12/30/2016 16:00",NA,NA,NA,NA,NA,NA,"wolbecker"
"12/30/2016 17:00",NA,NA,NA,NA,NA,NA,"wolbecker"
"12/30/2016 18:00",NA,NA,NA,NA,NA,NA,"wolbecker"
"12/30/2016 19:00",NA,NA,NA,NA,NA,NA,"wolbecker"
"12/30/2016 20:00",NA,NA,NA,NA,NA,NA,"wolbecker"
"12/30/2016 21:00",NA,NA,NA,NA,NA,NA,"wolbecker"
"12/30/2016 22:00",NA,NA,NA,NA,NA,NA,"wolbecker"
"12/30/2016 23:00",NA,NA,NA,NA,NA,NA,"wolbecker"
"12/31/2016 0:00",NA,NA,NA,NA,NA,NA,"wolbecker"
"12/31/2016 1:00",NA,NA,NA,NA,NA,NA,"wolbecker"
"12/31/2016 2:00",NA,NA,NA,NA,NA,NA,"wolbecker"
"12/31/2016 3:00",NA,NA,NA,NA,NA,NA,"wolbecker"
"12/31/2016 4:00",NA,NA,NA,NA,NA,NA,"wolbecker"
"12/31/2016 5:00",NA,NA,NA,NA,NA,NA,"wolbecker"
"12/31/2016 6:00",NA,NA,NA,NA,NA,NA,"wolbecker"
"12/31/2016 7:00",NA,NA,NA,NA,NA,NA,"wolbecker"
"12/31/2016 8:00",NA,NA,NA,NA,NA,NA,"wolbecker"
"12/31/2016 9:00",NA,NA,NA,NA,NA,NA,"wolbecker"
"12/31/2016 10:00",NA,NA,NA,NA,NA,NA,"wolbecker"
"12/31/2016 11:00",NA,NA,NA,NA,NA,NA,"wolbecker"
"12/31/2016 12:00",NA,NA,NA,NA,NA,NA,"wolbecker"
"12/31/2016 13:00",NA,NA,NA,NA,NA,NA,"wolbecker"
"12/31/2016 14:00",NA,NA,NA,NA,NA,NA,"wolbecker"
"12/31/2016 15:00",NA,NA,NA,NA,NA,NA,"wolbecker"
"12/31/2016 16:00",NA,NA,NA,NA,NA,NA,"wolbecker"
"12/31/2016 17:00",NA,NA,NA,NA,NA,NA,"wolbecker"
"12/31/2016 18:00",NA,NA,NA,NA,NA,NA,"wolbecker"
"12/31/2016 19:00",NA,NA,NA,NA,NA,NA,"wolbecker"
"12/31/2016 20:00",NA,NA,NA,NA,NA,NA,"wolbecker"
"12/31/2016 21:00",NA,NA,NA,NA,NA,NA,"wolbecker"
"12/31/2016 22:00",NA,NA,NA,NA,NA,NA,"wolbecker"
"12/31/2016 23:00",NA,NA,NA,NA,NA,NA,"wolbecker"
