"Stunden","FR.stadteinwärts","FR.stadtauswärts","Temperatur...C.","Windstärke..km.h.","noOfBikes","location","Wetter"
"1/1/2015 0:00",33,78,1,7,111,"neutor",NA
"1/1/2015 1:00",114,116,1,7,230,"neutor",NA
"1/1/2015 2:00",103,121,0,9,224,"neutor",NA
"1/1/2015 3:00",90,183,1,11,273,"neutor",NA
"1/1/2015 4:00",53,147,1,9,200,"neutor",NA
"1/1/2015 5:00",31,81,1,11,112,"neutor",NA
"1/1/2015 6:00",10,41,0,11,51,"neutor",NA
"1/1/2015 7:00",7,21,1,13,28,"neutor",NA
"1/1/2015 8:00",5,13,2,13,18,"neutor",NA
"1/1/2015 9:00",15,11,1,7,26,"neutor",NA
"1/1/2015 10:00",32,14,3,11,46,"neutor",NA
"1/1/2015 11:00",28,16,4,19,44,"neutor",NA
"1/1/2015 12:00",37,30,4,19,67,"neutor",NA
"1/1/2015 13:00",50,49,5,20,99,"neutor",NA
"1/1/2015 14:00",100,56,5,19,156,"neutor",NA
"1/1/2015 15:00",107,65,4,15,172,"neutor",NA
"1/1/2015 16:00",76,75,4,13,151,"neutor",NA
"1/1/2015 17:00",53,50,4,15,103,"neutor",NA
"1/1/2015 18:00",52,82,4,19,134,"neutor",NA
"1/1/2015 19:00",42,58,4,22,100,"neutor",NA
"1/1/2015 20:00",20,36,5,26,56,"neutor",NA
"1/1/2015 21:00",18,30,4,22,48,"neutor",NA
"1/1/2015 22:00",25,26,4,20,51,"neutor",NA
"1/1/2015 23:00",15,17,5,24,32,"neutor",NA
"1/2/2015 0:00",8,8,5,30,16,"neutor",NA
"1/2/2015 1:00",2,9,5,26,11,"neutor",NA
"1/2/2015 2:00",3,3,5,26,6,"neutor",NA
"1/2/2015 3:00",3,4,5,28,7,"neutor",NA
"1/2/2015 4:00",1,0,5,28,1,"neutor",NA
"1/2/2015 5:00",8,3,5,26,11,"neutor",NA
"1/2/2015 6:00",21,8,5,28,29,"neutor",NA
"1/2/2015 7:00",68,28,6,32,96,"neutor",NA
"1/2/2015 8:00",70,43,6,32,113,"neutor",NA
"1/2/2015 9:00",111,43,7,24,154,"neutor",NA
"1/2/2015 10:00",136,48,8,20,184,"neutor",NA
"1/2/2015 11:00",119,76,8,28,195,"neutor",NA
"1/2/2015 12:00",172,88,8,28,260,"neutor",NA
"1/2/2015 13:00",194,125,8,24,319,"neutor",NA
"1/2/2015 14:00",205,137,8,33,342,"neutor",NA
"1/2/2015 15:00",222,146,7,28,368,"neutor",NA
"1/2/2015 16:00",174,206,7,28,380,"neutor",NA
"1/2/2015 17:00",155,163,6,28,318,"neutor",NA
"1/2/2015 18:00",133,138,6,26,271,"neutor",NA
"1/2/2015 19:00",135,143,6,26,278,"neutor",NA
"1/2/2015 20:00",99,125,6,26,224,"neutor",NA
"1/2/2015 21:00",49,64,5,24,113,"neutor",NA
"1/2/2015 22:00",57,74,5,24,131,"neutor",NA
"1/2/2015 23:00",32,72,4,20,104,"neutor",NA
"1/3/2015 0:00",32,39,4,22,71,"neutor",NA
"1/3/2015 1:00",25,40,4,20,65,"neutor",NA
"1/3/2015 2:00",13,19,4,15,32,"neutor",NA
"1/3/2015 3:00",3,24,4,17,27,"neutor",NA
"1/3/2015 4:00",7,11,4,15,18,"neutor",NA
"1/3/2015 5:00",12,8,4,17,20,"neutor",NA
"1/3/2015 6:00",16,10,4,17,26,"neutor",NA
"1/3/2015 7:00",31,10,4,17,41,"neutor",NA
"1/3/2015 8:00",49,32,4,20,81,"neutor",NA
"1/3/2015 9:00",142,43,4,24,185,"neutor",NA
"1/3/2015 10:00",180,65,5,24,245,"neutor",NA
"1/3/2015 11:00",158,86,4,30,244,"neutor",NA
"1/3/2015 12:00",151,110,3,24,261,"neutor",NA
"1/3/2015 13:00",146,133,3,19,279,"neutor",NA
"1/3/2015 14:00",120,128,3,17,248,"neutor",NA
"1/3/2015 15:00",151,122,3,13,273,"neutor",NA
"1/3/2015 16:00",124,139,3,15,263,"neutor",NA
"1/3/2015 17:00",101,144,3,17,245,"neutor",NA
"1/3/2015 18:00",126,112,3,13,238,"neutor",NA
"1/3/2015 19:00",121,149,3,15,270,"neutor",NA
"1/3/2015 20:00",114,126,3,17,240,"neutor",NA
"1/3/2015 21:00",80,48,3,19,128,"neutor",NA
"1/3/2015 22:00",46,74,3,15,120,"neutor",NA
"1/3/2015 23:00",38,74,2,13,112,"neutor",NA
"1/4/2015 0:00",46,61,3,17,107,"neutor",NA
"1/4/2015 1:00",40,70,3,15,110,"neutor",NA
"1/4/2015 2:00",21,43,2,15,64,"neutor",NA
"1/4/2015 3:00",14,45,3,17,59,"neutor",NA
"1/4/2015 4:00",5,22,3,19,27,"neutor",NA
"1/4/2015 5:00",5,7,2,15,12,"neutor",NA
"1/4/2015 6:00",7,7,2,15,14,"neutor",NA
"1/4/2015 7:00",24,10,3,17,34,"neutor",NA
"1/4/2015 8:00",19,12,2,15,31,"neutor",NA
"1/4/2015 9:00",81,38,2,17,119,"neutor",NA
"1/4/2015 10:00",112,44,4,17,156,"neutor",NA
"1/4/2015 11:00",118,70,5,19,188,"neutor",NA
"1/4/2015 12:00",117,89,6,19,206,"neutor",NA
"1/4/2015 13:00",171,118,7,17,289,"neutor",NA
"1/4/2015 14:00",191,135,6,20,326,"neutor",NA
"1/4/2015 15:00",204,149,6,15,353,"neutor",NA
"1/4/2015 16:00",128,174,4,13,302,"neutor",NA
"1/4/2015 17:00",131,158,2,15,289,"neutor",NA
"1/4/2015 18:00",107,159,2,11,266,"neutor",NA
"1/4/2015 19:00",125,141,1,11,266,"neutor",NA
"1/4/2015 20:00",70,102,1,9,172,"neutor",NA
"1/4/2015 21:00",31,68,2,9,99,"neutor",NA
"1/4/2015 22:00",45,87,1,9,132,"neutor",NA
"1/4/2015 23:00",34,35,2,9,69,"neutor",NA
"1/5/2015 0:00",18,32,2,11,50,"neutor",NA
"1/5/2015 1:00",6,15,1,9,21,"neutor",NA
"1/5/2015 2:00",2,5,1,13,7,"neutor",NA
"1/5/2015 3:00",1,1,1,19,2,"neutor",NA
"1/5/2015 4:00",3,3,1,17,6,"neutor",NA
"1/5/2015 5:00",22,14,2,17,36,"neutor",NA
"1/5/2015 6:00",88,35,2,19,123,"neutor",NA
"1/5/2015 7:00",260,182,2,17,442,"neutor",NA
"1/5/2015 8:00",452,378,2,15,830,"neutor",NA
"1/5/2015 9:00",427,307,2,15,734,"neutor",NA
"1/5/2015 10:00",522,410,3,15,932,"neutor",NA
"1/5/2015 11:00",479,413,3,15,892,"neutor",NA
"1/5/2015 12:00",459,417,4,13,876,"neutor",NA
"1/5/2015 13:00",463,398,4,17,861,"neutor",NA
"1/5/2015 14:00",559,495,4,15,1054,"neutor",NA
"1/5/2015 15:00",548,474,4,17,1022,"neutor",NA
"1/5/2015 16:00",598,479,3,17,1077,"neutor",NA
"1/5/2015 17:00",742,472,2,6,1214,"neutor",NA
"1/5/2015 18:00",465,508,2,6,973,"neutor",NA
"1/5/2015 19:00",322,531,2,7,853,"neutor",NA
"1/5/2015 20:00",184,320,2,4,504,"neutor",NA
"1/5/2015 21:00",155,202,2,4,357,"neutor",NA
"1/5/2015 22:00",117,143,2,6,260,"neutor",NA
"1/5/2015 23:00",45,102,2,6,147,"neutor",NA
"1/6/2015 0:00",29,62,3,4,91,"neutor",NA
"1/6/2015 1:00",9,39,3,6,48,"neutor",NA
"1/6/2015 2:00",3,10,2,4,13,"neutor",NA
"1/6/2015 3:00",5,3,2,6,8,"neutor",NA
"1/6/2015 4:00",4,8,2,6,12,"neutor",NA
"1/6/2015 5:00",27,11,3,6,38,"neutor",NA
"1/6/2015 6:00",88,31,3,7,119,"neutor",NA
"1/6/2015 7:00",287,218,3,6,505,"neutor",NA
"1/6/2015 8:00",536,462,3,7,998,"neutor",NA
"1/6/2015 9:00",503,475,3,7,978,"neutor",NA
"1/6/2015 10:00",468,382,4,7,850,"neutor",NA
"1/6/2015 11:00",518,389,4,6,907,"neutor",NA
"1/6/2015 12:00",541,431,5,7,972,"neutor",NA
"1/6/2015 13:00",559,424,5,7,983,"neutor",NA
"1/6/2015 14:00",487,503,5,7,990,"neutor",NA
"1/6/2015 15:00",512,475,4,6,987,"neutor",NA
"1/6/2015 16:00",570,577,3,4,1147,"neutor",NA
"1/6/2015 17:00",629,569,4,9,1198,"neutor",NA
"1/6/2015 18:00",505,531,3,13,1036,"neutor",NA
"1/6/2015 19:00",411,418,3,11,829,"neutor",NA
"1/6/2015 20:00",235,309,3,9,544,"neutor",NA
"1/6/2015 21:00",154,196,4,13,350,"neutor",NA
"1/6/2015 22:00",98,236,3,11,334,"neutor",NA
"1/6/2015 23:00",60,96,4,15,156,"neutor",NA
"1/7/2015 0:00",24,54,4,15,78,"neutor",NA
"1/7/2015 1:00",13,31,4,17,44,"neutor",NA
"1/7/2015 2:00",3,4,4,15,7,"neutor",NA
"1/7/2015 3:00",4,4,4,15,8,"neutor",NA
"1/7/2015 4:00",4,3,5,15,7,"neutor",NA
"1/7/2015 5:00",28,9,4,15,37,"neutor",NA
"1/7/2015 6:00",100,33,2,9,133,"neutor",NA
"1/7/2015 7:00",517,235,3,9,752,"neutor",NA
"1/7/2015 8:00",687,507,4,9,1194,"neutor",NA
"1/7/2015 9:00",476,406,4,13,882,"neutor",NA
"1/7/2015 10:00",475,455,4,19,930,"neutor",NA
"1/7/2015 11:00",484,375,4,20,859,"neutor",NA
"1/7/2015 12:00",538,462,5,17,1000,"neutor",NA
"1/7/2015 13:00",570,459,6,15,1029,"neutor",NA
"1/7/2015 14:00",548,470,6,19,1018,"neutor",NA
"1/7/2015 15:00",549,570,6,15,1119,"neutor",NA
"1/7/2015 16:00",583,609,5,11,1192,"neutor",NA
"1/7/2015 17:00",650,633,4,13,1283,"neutor",NA
"1/7/2015 18:00",448,495,5,15,943,"neutor",NA
"1/7/2015 19:00",456,461,4,15,917,"neutor",NA
"1/7/2015 20:00",344,322,4,17,666,"neutor",NA
"1/7/2015 21:00",209,225,4,15,434,"neutor",NA
"1/7/2015 22:00",123,207,3,17,330,"neutor",NA
"1/7/2015 23:00",89,134,3,20,223,"neutor",NA
"1/8/2015 0:00",51,105,3,20,156,"neutor",NA
"1/8/2015 1:00",19,66,3,19,85,"neutor",NA
"1/8/2015 2:00",21,37,3,20,58,"neutor",NA
"1/8/2015 3:00",2,32,4,20,34,"neutor",NA
"1/8/2015 4:00",6,13,4,19,19,"neutor",NA
"1/8/2015 5:00",34,14,4,19,48,"neutor",NA
"1/8/2015 6:00",74,24,5,24,98,"neutor",NA
"1/8/2015 7:00",397,209,5,19,606,"neutor",NA
"1/8/2015 8:00",555,453,6,19,1008,"neutor",NA
"1/8/2015 9:00",382,319,6,19,701,"neutor",NA
"1/8/2015 10:00",455,356,6,17,811,"neutor",NA
"1/8/2015 11:00",357,377,7,19,734,"neutor",NA
"1/8/2015 12:00",392,445,7,20,837,"neutor",NA
"1/8/2015 13:00",371,324,7,19,695,"neutor",NA
"1/8/2015 14:00",327,361,7,11,688,"neutor",NA
"1/8/2015 15:00",349,307,8,13,656,"neutor",NA
"1/8/2015 16:00",365,299,8,17,664,"neutor",NA
"1/8/2015 17:00",376,348,6,28,724,"neutor",NA
"1/8/2015 18:00",299,294,5,15,593,"neutor",NA
"1/8/2015 19:00",281,293,5,11,574,"neutor",NA
"1/8/2015 20:00",148,188,6,24,336,"neutor",NA
"1/8/2015 21:00",110,104,6,30,214,"neutor",NA
"1/8/2015 22:00",89,127,6,30,216,"neutor",NA
"1/8/2015 23:00",31,61,6,30,92,"neutor",NA
"1/9/2015 0:00",21,69,6,24,90,"neutor",NA
"1/9/2015 1:00",12,23,6,22,35,"neutor",NA
"1/9/2015 2:00",2,16,7,24,18,"neutor",NA
"1/9/2015 3:00",5,8,7,30,13,"neutor",NA
"1/9/2015 4:00",8,6,7,30,14,"neutor",NA
"1/9/2015 5:00",27,12,7,30,39,"neutor",NA
"1/9/2015 6:00",58,30,8,39,88,"neutor",NA
"1/9/2015 7:00",301,158,8,39,459,"neutor",NA
"1/9/2015 8:00",376,344,8,44,720,"neutor",NA
"1/9/2015 9:00",338,263,8,44,601,"neutor",NA
"1/9/2015 10:00",345,261,8,41,606,"neutor",NA
"1/9/2015 11:00",363,228,9,39,591,"neutor",NA
"1/9/2015 12:00",402,286,10,39,688,"neutor",NA
"1/9/2015 13:00",358,341,11,43,699,"neutor",NA
"1/9/2015 14:00",341,345,11,39,686,"neutor",NA
"1/9/2015 15:00",336,269,11,37,605,"neutor",NA
"1/9/2015 16:00",338,285,10,43,623,"neutor",NA
"1/9/2015 17:00",340,304,9,54,644,"neutor",NA
"1/9/2015 18:00",326,242,7,28,568,"neutor",NA
"1/9/2015 19:00",337,191,7,22,528,"neutor",NA
"1/9/2015 20:00",241,179,6,11,420,"neutor",NA
"1/9/2015 21:00",150,141,6,13,291,"neutor",NA
"1/9/2015 22:00",100,166,7,15,266,"neutor",NA
"1/9/2015 23:00",60,124,11,32,184,"neutor",NA
"1/10/2015 0:00",39,167,13,39,206,"neutor",NA
"1/10/2015 1:00",32,136,13,50,168,"neutor",NA
"1/10/2015 2:00",22,67,13,37,89,"neutor",NA
"1/10/2015 3:00",15,70,12,41,85,"neutor",NA
"1/10/2015 4:00",9,36,13,37,45,"neutor",NA
"1/10/2015 5:00",25,28,13,35,53,"neutor",NA
"1/10/2015 6:00",16,7,13,35,23,"neutor",NA
"1/10/2015 7:00",58,21,13,39,79,"neutor",NA
"1/10/2015 8:00",95,29,13,37,124,"neutor",NA
"1/10/2015 9:00",182,58,12,41,240,"neutor",NA
"1/10/2015 10:00",214,81,12,39,295,"neutor",NA
"1/10/2015 11:00",184,93,12,44,277,"neutor",NA
"1/10/2015 12:00",200,135,11,41,335,"neutor",NA
"1/10/2015 13:00",178,130,11,37,308,"neutor",NA
"1/10/2015 14:00",134,139,6,59,273,"neutor",NA
"1/10/2015 15:00",83,126,9,32,209,"neutor",NA
"1/10/2015 16:00",114,131,8,35,245,"neutor",NA
"1/10/2015 17:00",125,130,8,32,255,"neutor",NA
"1/10/2015 18:00",136,147,6,24,283,"neutor",NA
"1/10/2015 19:00",162,167,6,26,329,"neutor",NA
"1/10/2015 20:00",174,169,6,32,343,"neutor",NA
"1/10/2015 21:00",130,86,5,26,216,"neutor",NA
"1/10/2015 22:00",95,84,5,22,179,"neutor",NA
"1/10/2015 23:00",81,81,4,22,162,"neutor",NA
"1/11/2015 0:00",86,111,4,22,197,"neutor",NA
"1/11/2015 1:00",72,111,4,22,183,"neutor",NA
"1/11/2015 2:00",52,71,3,24,123,"neutor",NA
"1/11/2015 3:00",38,70,3,20,108,"neutor",NA
"1/11/2015 4:00",34,30,3,22,64,"neutor",NA
"1/11/2015 5:00",27,21,3,28,48,"neutor",NA
"1/11/2015 6:00",11,13,3,28,24,"neutor",NA
"1/11/2015 7:00",24,14,3,30,38,"neutor",NA
"1/11/2015 8:00",41,10,3,33,51,"neutor",NA
"1/11/2015 9:00",105,33,3,30,138,"neutor",NA
"1/11/2015 10:00",125,45,3,30,170,"neutor",NA
"1/11/2015 11:00",106,62,4,37,168,"neutor",NA
"1/11/2015 12:00",135,97,5,39,232,"neutor",NA
"1/11/2015 13:00",179,98,5,32,277,"neutor",NA
"1/11/2015 14:00",169,136,6,35,305,"neutor",NA
"1/11/2015 15:00",178,119,6,35,297,"neutor",NA
"1/11/2015 16:00",162,166,6,32,328,"neutor",NA
"1/11/2015 17:00",157,182,6,37,339,"neutor",NA
"1/11/2015 18:00",126,191,5,41,317,"neutor",NA
"1/11/2015 19:00",122,167,5,43,289,"neutor",NA
"1/11/2015 20:00",59,144,5,37,203,"neutor",NA
"1/11/2015 21:00",44,84,5,37,128,"neutor",NA
"1/11/2015 22:00",43,105,6,35,148,"neutor",NA
"1/11/2015 23:00",29,76,6,24,105,"neutor",NA
"1/12/2015 0:00",25,21,6,24,46,"neutor",NA
"1/12/2015 1:00",14,19,6,22,33,"neutor",NA
"1/12/2015 2:00",6,3,7,26,9,"neutor",NA
"1/12/2015 3:00",2,2,7,24,4,"neutor",NA
"1/12/2015 4:00",2,2,7,24,4,"neutor",NA
"1/12/2015 5:00",29,8,7,24,37,"neutor",NA
"1/12/2015 6:00",72,24,7,26,96,"neutor",NA
"1/12/2015 7:00",351,180,7,30,531,"neutor",NA
"1/12/2015 8:00",532,411,7,32,943,"neutor",NA
"1/12/2015 9:00",378,307,7,32,685,"neutor",NA
"1/12/2015 10:00",399,368,7,30,767,"neutor",NA
"1/12/2015 11:00",378,369,7,30,747,"neutor",NA
"1/12/2015 12:00",365,389,7,33,754,"neutor",NA
"1/12/2015 13:00",447,389,7,30,836,"neutor",NA
"1/12/2015 14:00",372,410,8,30,782,"neutor",NA
"1/12/2015 15:00",509,463,9,33,972,"neutor",NA
"1/12/2015 16:00",565,421,9,33,986,"neutor",NA
"1/12/2015 17:00",553,539,9,32,1092,"neutor",NA
"1/12/2015 18:00",457,456,9,35,913,"neutor",NA
"1/12/2015 19:00",380,431,9,39,811,"neutor",NA
"1/12/2015 20:00",237,256,8,32,493,"neutor",NA
"1/12/2015 21:00",147,181,8,26,328,"neutor",NA
"1/12/2015 22:00",102,198,9,32,300,"neutor",NA
"1/12/2015 23:00",45,138,9,28,183,"neutor",NA
"1/13/2015 0:00",19,74,10,32,93,"neutor",NA
"1/13/2015 1:00",6,15,9,30,21,"neutor",NA
"1/13/2015 2:00",4,9,10,30,13,"neutor",NA
"1/13/2015 3:00",3,2,9,26,5,"neutor",NA
"1/13/2015 4:00",6,2,9,24,8,"neutor",NA
"1/13/2015 5:00",27,10,10,30,37,"neutor",NA
"1/13/2015 6:00",84,38,11,33,122,"neutor",NA
"1/13/2015 7:00",409,191,9,30,600,"neutor",NA
"1/13/2015 8:00",519,443,9,26,962,"neutor",NA
"1/13/2015 9:00",498,431,8,26,929,"neutor",NA
"1/13/2015 10:00",401,366,8,26,767,"neutor",NA
"1/13/2015 11:00",443,321,9,22,764,"neutor",NA
"1/13/2015 12:00",452,397,9,28,849,"neutor",NA
"1/13/2015 13:00",411,355,9,24,766,"neutor",NA
"1/13/2015 14:00",394,425,9,32,819,"neutor",NA
"1/13/2015 15:00",381,395,9,22,776,"neutor",NA
"1/13/2015 16:00",461,429,9,26,890,"neutor",NA
"1/13/2015 17:00",613,438,8,22,1051,"neutor",NA
"1/13/2015 18:00",495,433,8,20,928,"neutor",NA
"1/13/2015 19:00",396,447,8,20,843,"neutor",NA
"1/13/2015 20:00",216,313,8,20,529,"neutor",NA
"1/13/2015 21:00",155,161,8,28,316,"neutor",NA
"1/13/2015 22:00",122,195,7,20,317,"neutor",NA
"1/13/2015 23:00",80,101,7,20,181,"neutor",NA
"1/14/2015 0:00",24,71,7,19,95,"neutor",NA
"1/14/2015 1:00",17,20,7,17,37,"neutor",NA
"1/14/2015 2:00",3,9,6,17,12,"neutor",NA
"1/14/2015 3:00",2,3,5,28,5,"neutor",NA
"1/14/2015 4:00",5,1,5,19,6,"neutor",NA
"1/14/2015 5:00",32,8,5,26,40,"neutor",NA
"1/14/2015 6:00",98,29,5,26,127,"neutor",NA
"1/14/2015 7:00",453,204,4,24,657,"neutor",NA
"1/14/2015 8:00",652,547,4,22,1199,"neutor",NA
"1/14/2015 9:00",558,386,5,26,944,"neutor",NA
"1/14/2015 10:00",497,403,5,22,900,"neutor",NA
"1/14/2015 11:00",418,347,4,22,765,"neutor",NA
"1/14/2015 12:00",383,404,3,20,787,"neutor",NA
"1/14/2015 13:00",444,376,3,11,820,"neutor",NA
"1/14/2015 14:00",436,433,5,24,869,"neutor",NA
"1/14/2015 15:00",435,476,5,24,911,"neutor",NA
"1/14/2015 16:00",478,479,4,26,957,"neutor",NA
"1/14/2015 17:00",557,436,3,17,993,"neutor",NA
"1/14/2015 18:00",504,456,3,15,960,"neutor",NA
"1/14/2015 19:00",511,344,4,15,855,"neutor",NA
"1/14/2015 20:00",288,324,3,17,612,"neutor",NA
"1/14/2015 21:00",148,201,3,11,349,"neutor",NA
"1/14/2015 22:00",147,211,3,15,358,"neutor",NA
"1/14/2015 23:00",101,150,3,11,251,"neutor",NA
"1/15/2015 0:00",50,97,3,15,147,"neutor",NA
"1/15/2015 1:00",35,82,4,17,117,"neutor",NA
"1/15/2015 2:00",17,42,4,17,59,"neutor",NA
"1/15/2015 3:00",15,38,5,20,53,"neutor",NA
"1/15/2015 4:00",6,17,6,22,23,"neutor",NA
"1/15/2015 5:00",28,15,6,22,43,"neutor",NA
"1/15/2015 6:00",66,27,6,22,93,"neutor",NA
"1/15/2015 7:00",334,176,7,28,510,"neutor",NA
"1/15/2015 8:00",499,404,8,30,903,"neutor",NA
"1/15/2015 9:00",365,298,8,30,663,"neutor",NA
"1/15/2015 10:00",382,289,8,26,671,"neutor",NA
"1/15/2015 11:00",394,319,9,28,713,"neutor",NA
"1/15/2015 12:00",400,461,9,26,861,"neutor",NA
"1/15/2015 13:00",422,351,9,32,773,"neutor",NA
"1/15/2015 14:00",399,339,9,28,738,"neutor",NA
"1/15/2015 15:00",467,370,9,26,837,"neutor",NA
"1/15/2015 16:00",445,412,9,26,857,"neutor",NA
"1/15/2015 17:00",482,428,9,26,910,"neutor",NA
"1/15/2015 18:00",433,357,9,22,790,"neutor",NA
"1/15/2015 19:00",336,312,9,26,648,"neutor",NA
"1/15/2015 20:00",228,200,9,24,428,"neutor",NA
"1/15/2015 21:00",161,201,9,20,362,"neutor",NA
"1/15/2015 22:00",133,164,8,20,297,"neutor",NA
"1/15/2015 23:00",45,106,7,20,151,"neutor",NA
"1/16/2015 0:00",28,92,7,22,120,"neutor",NA
"1/16/2015 1:00",30,43,7,19,73,"neutor",NA
"1/16/2015 2:00",9,16,7,24,25,"neutor",NA
"1/16/2015 3:00",3,22,7,24,25,"neutor",NA
"1/16/2015 4:00",3,23,6,22,26,"neutor",NA
"1/16/2015 5:00",30,13,6,22,43,"neutor",NA
"1/16/2015 6:00",85,29,6,20,114,"neutor",NA
"1/16/2015 7:00",322,204,5,15,526,"neutor",NA
"1/16/2015 8:00",478,340,5,17,818,"neutor",NA
"1/16/2015 9:00",406,311,5,15,717,"neutor",NA
"1/16/2015 10:00",448,360,6,13,808,"neutor",NA
"1/16/2015 11:00",454,344,7,15,798,"neutor",NA
"1/16/2015 12:00",490,354,7,17,844,"neutor",NA
"1/16/2015 13:00",422,426,8,13,848,"neutor",NA
"1/16/2015 14:00",413,411,8,15,824,"neutor",NA
"1/16/2015 15:00",441,353,7,9,794,"neutor",NA
"1/16/2015 16:00",445,383,6,6,828,"neutor",NA
"1/16/2015 17:00",385,389,6,7,774,"neutor",NA
"1/16/2015 18:00",392,350,6,7,742,"neutor",NA
"1/16/2015 19:00",355,344,6,9,699,"neutor",NA
"1/16/2015 20:00",257,233,5,7,490,"neutor",NA
"1/16/2015 21:00",180,192,3,7,372,"neutor",NA
"1/16/2015 22:00",116,184,4,9,300,"neutor",NA
"1/16/2015 23:00",105,171,2,7,276,"neutor",NA
"1/17/2015 0:00",114,135,4,13,249,"neutor",NA
"1/17/2015 1:00",57,159,4,7,216,"neutor",NA
"1/17/2015 2:00",33,106,2,9,139,"neutor",NA
"1/17/2015 3:00",33,79,2,4,112,"neutor",NA
"1/17/2015 4:00",8,57,3,7,65,"neutor",NA
"1/17/2015 5:00",25,22,1,6,47,"neutor",NA
"1/17/2015 6:00",17,16,0,9,33,"neutor",NA
"1/17/2015 7:00",49,14,1,7,63,"neutor",NA
"1/17/2015 8:00",111,44,-1,4,155,"neutor",NA
"1/17/2015 9:00",234,101,1,7,335,"neutor",NA
"1/17/2015 10:00",325,130,2,7,455,"neutor",NA
"1/17/2015 11:00",330,160,4,11,490,"neutor",NA
"1/17/2015 12:00",373,196,5,17,569,"neutor",NA
"1/17/2015 13:00",354,277,5,15,631,"neutor",NA
"1/17/2015 14:00",309,347,5,15,656,"neutor",NA
"1/17/2015 15:00",263,281,5,15,544,"neutor",NA
"1/17/2015 16:00",263,285,3,9,548,"neutor",NA
"1/17/2015 17:00",200,278,2,9,478,"neutor",NA
"1/17/2015 18:00",280,235,1,6,515,"neutor",NA
"1/17/2015 19:00",207,196,1,9,403,"neutor",NA
"1/17/2015 20:00",215,233,0,9,448,"neutor",NA
"1/17/2015 21:00",138,184,1,9,322,"neutor",NA
"1/17/2015 22:00",93,103,0,9,196,"neutor",NA
"1/17/2015 23:00",93,133,0,11,226,"neutor",NA
"1/18/2015 0:00",92,131,0,9,223,"neutor",NA
"1/18/2015 1:00",69,137,1,11,206,"neutor",NA
"1/18/2015 2:00",39,122,2,13,161,"neutor",NA
"1/18/2015 3:00",23,82,1,11,105,"neutor",NA
"1/18/2015 4:00",18,31,1,13,49,"neutor",NA
"1/18/2015 5:00",11,29,1,11,40,"neutor",NA
"1/18/2015 6:00",17,9,1,13,26,"neutor",NA
"1/18/2015 7:00",18,13,1,13,31,"neutor",NA
"1/18/2015 8:00",32,19,1,11,51,"neutor",NA
"1/18/2015 9:00",110,26,0,11,136,"neutor",NA
"1/18/2015 10:00",176,47,1,13,223,"neutor",NA
"1/18/2015 11:00",116,103,1,7,219,"neutor",NA
"1/18/2015 12:00",96,134,2,11,230,"neutor",NA
"1/18/2015 13:00",111,171,3,13,282,"neutor",NA
"1/18/2015 14:00",186,167,3,11,353,"neutor",NA
"1/18/2015 15:00",186,156,3,9,342,"neutor",NA
"1/18/2015 16:00",162,165,3,9,327,"neutor",NA
"1/18/2015 17:00",271,182,2,7,453,"neutor",NA
"1/18/2015 18:00",171,164,2,6,335,"neutor",NA
"1/18/2015 19:00",146,188,2,7,334,"neutor",NA
"1/18/2015 20:00",104,160,2,7,264,"neutor",NA
"1/18/2015 21:00",61,82,2,9,143,"neutor",NA
"1/18/2015 22:00",57,117,2,9,174,"neutor",NA
"1/18/2015 23:00",39,62,1,9,101,"neutor",NA
"1/19/2015 0:00",15,25,1,7,40,"neutor",NA
"1/19/2015 1:00",9,13,1,6,22,"neutor",NA
"1/19/2015 2:00",3,9,0,6,12,"neutor",NA
"1/19/2015 3:00",5,2,-1,4,7,"neutor",NA
"1/19/2015 4:00",3,3,-1,4,6,"neutor",NA
"1/19/2015 5:00",24,11,-1,4,35,"neutor",NA
"1/19/2015 6:00",97,26,-2,2,123,"neutor",NA
"1/19/2015 7:00",386,200,-2,2,586,"neutor",NA
"1/19/2015 8:00",629,408,-2,4,1037,"neutor",NA
"1/19/2015 9:00",496,382,-1,4,878,"neutor",NA
"1/19/2015 10:00",424,441,-1,4,865,"neutor",NA
"1/19/2015 11:00",442,339,0,2,781,"neutor",NA
"1/19/2015 12:00",493,469,1,0,962,"neutor",NA
"1/19/2015 13:00",474,432,2,4,906,"neutor",NA
"1/19/2015 14:00",489,458,2,2,947,"neutor",NA
"1/19/2015 15:00",569,520,1,4,1089,"neutor",NA
"1/19/2015 16:00",601,489,1,2,1090,"neutor",NA
"1/19/2015 17:00",635,688,0,2,1323,"neutor",NA
"1/19/2015 18:00",432,538,-1,0,970,"neutor",NA
"1/19/2015 19:00",425,478,-1,2,903,"neutor",NA
"1/19/2015 20:00",253,340,-2,4,593,"neutor",NA
"1/19/2015 21:00",178,214,-2,4,392,"neutor",NA
"1/19/2015 22:00",112,190,-1,4,302,"neutor",NA
"1/19/2015 23:00",55,96,-1,2,151,"neutor",NA
"1/20/2015 0:00",30,61,-2,4,91,"neutor",NA
"1/20/2015 1:00",13,34,-1,7,47,"neutor",NA
"1/20/2015 2:00",7,6,0,7,13,"neutor",NA
"1/20/2015 3:00",6,2,-1,4,8,"neutor",NA
"1/20/2015 4:00",5,3,-1,4,8,"neutor",NA
"1/20/2015 5:00",31,11,-1,6,42,"neutor",NA
"1/20/2015 6:00",109,34,0,4,143,"neutor",NA
"1/20/2015 7:00",449,230,0,2,679,"neutor",NA
"1/20/2015 8:00",617,458,0,4,1075,"neutor",NA
"1/20/2015 9:00",533,434,0,2,967,"neutor",NA
"1/20/2015 10:00",481,401,0,6,882,"neutor",NA
"1/20/2015 11:00",470,404,1,7,874,"neutor",NA
"1/20/2015 12:00",528,459,2,9,987,"neutor",NA
"1/20/2015 13:00",535,418,2,6,953,"neutor",NA
"1/20/2015 14:00",541,543,2,7,1084,"neutor",NA
"1/20/2015 15:00",507,473,2,6,980,"neutor",NA
"1/20/2015 16:00",522,575,0,4,1097,"neutor",NA
"1/20/2015 17:00",619,557,0,6,1176,"neutor",NA
"1/20/2015 18:00",534,551,0,7,1085,"neutor",NA
"1/20/2015 19:00",442,475,-1,2,917,"neutor",NA
"1/20/2015 20:00",252,306,-2,4,558,"neutor",NA
"1/20/2015 21:00",157,246,-3,4,403,"neutor",NA
"1/20/2015 22:00",154,251,-3,2,405,"neutor",NA
"1/20/2015 23:00",67,123,-4,2,190,"neutor",NA
"1/21/2015 0:00",31,43,-4,2,74,"neutor",NA
"1/21/2015 1:00",13,22,-5,4,35,"neutor",NA
"1/21/2015 2:00",2,13,-3,4,15,"neutor",NA
"1/21/2015 3:00",5,7,-2,7,12,"neutor",NA
"1/21/2015 4:00",9,2,-2,6,11,"neutor",NA
"1/21/2015 5:00",27,3,-3,6,30,"neutor",NA
"1/21/2015 6:00",90,44,-2,6,134,"neutor",NA
"1/21/2015 7:00",462,124,-3,4,586,"neutor",NA
"1/21/2015 8:00",674,530,-3,7,1204,"neutor",NA
"1/21/2015 9:00",502,299,-2,7,801,"neutor",NA
"1/21/2015 10:00",467,518,-1,7,985,"neutor",NA
"1/21/2015 11:00",431,288,0,6,719,"neutor",NA
"1/21/2015 12:00",546,523,1,7,1069,"neutor",NA
"1/21/2015 13:00",541,402,2,9,943,"neutor",NA
"1/21/2015 14:00",498,521,2,13,1019,"neutor",NA
"1/21/2015 15:00",493,370,2,9,863,"neutor",NA
"1/21/2015 16:00",498,732,1,9,1230,"neutor",NA
"1/21/2015 17:00",601,506,0,11,1107,"neutor",NA
"1/21/2015 18:00",500,761,0,11,1261,"neutor",NA
"1/21/2015 19:00",457,426,-1,11,883,"neutor",NA
"1/21/2015 20:00",268,397,-1,11,665,"neutor",NA
"1/21/2015 21:00",139,180,-1,13,319,"neutor",NA
"1/21/2015 22:00",297,255,-2,11,552,"neutor",NA
"1/21/2015 23:00",195,205,-2,9,400,"neutor",NA
"1/22/2015 0:00",54,120,-2,17,174,"neutor",NA
"1/22/2015 1:00",30,59,-2,13,89,"neutor",NA
"1/22/2015 2:00",10,72,-2,15,82,"neutor",NA
"1/22/2015 3:00",11,25,-2,17,36,"neutor",NA
"1/22/2015 4:00",9,18,-2,15,27,"neutor",NA
"1/22/2015 5:00",29,21,-1,20,50,"neutor",NA
"1/22/2015 6:00",85,45,-1,19,130,"neutor",NA
"1/22/2015 7:00",409,232,-1,20,641,"neutor",NA
"1/22/2015 8:00",574,470,-1,19,1044,"neutor",NA
"1/22/2015 9:00",434,327,-1,17,761,"neutor",NA
"1/22/2015 10:00",474,399,0,19,873,"neutor",NA
"1/22/2015 11:00",473,357,0,17,830,"neutor",NA
"1/22/2015 12:00",412,532,0,11,944,"neutor",NA
"1/22/2015 13:00",471,402,0,9,873,"neutor",NA
"1/22/2015 14:00",509,426,0,13,935,"neutor",NA
"1/22/2015 15:00",517,480,0,15,997,"neutor",NA
"1/22/2015 16:00",536,481,0,15,1017,"neutor",NA
"1/22/2015 17:00",572,591,0,9,1163,"neutor",NA
"1/22/2015 18:00",521,495,0,11,1016,"neutor",NA
"1/22/2015 19:00",376,389,0,7,765,"neutor",NA
"1/22/2015 20:00",230,279,0,15,509,"neutor",NA
"1/22/2015 21:00",158,203,0,15,361,"neutor",NA
"1/22/2015 22:00",133,236,0,11,369,"neutor",NA
"1/22/2015 23:00",58,153,-1,11,211,"neutor",NA
"1/23/2015 0:00",40,106,-1,4,146,"neutor",NA
"1/23/2015 1:00",12,54,0,6,66,"neutor",NA
"1/23/2015 2:00",6,20,0,9,26,"neutor",NA
"1/23/2015 3:00",10,14,-1,11,24,"neutor",NA
"1/23/2015 4:00",5,4,-1,15,9,"neutor",NA
"1/23/2015 5:00",29,10,0,11,39,"neutor",NA
"1/23/2015 6:00",78,38,0,15,116,"neutor",NA
"1/23/2015 7:00",377,198,-1,13,575,"neutor",NA
"1/23/2015 8:00",513,365,-1,11,878,"neutor",NA
"1/23/2015 9:00",388,311,0,7,699,"neutor",NA
"1/23/2015 10:00",427,314,-1,7,741,"neutor",NA
"1/23/2015 11:00",393,298,0,7,691,"neutor",NA
"1/23/2015 12:00",448,319,0,7,767,"neutor",NA
"1/23/2015 13:00",410,368,0,9,778,"neutor",NA
"1/23/2015 14:00",377,414,1,4,791,"neutor",NA
"1/23/2015 15:00",370,343,0,4,713,"neutor",NA
"1/23/2015 16:00",355,345,0,4,700,"neutor",NA
"1/23/2015 17:00",329,326,0,6,655,"neutor",NA
"1/23/2015 18:00",361,302,-1,9,663,"neutor",NA
"1/23/2015 19:00",343,287,-1,11,630,"neutor",NA
"1/23/2015 20:00",221,205,-1,9,426,"neutor",NA
"1/23/2015 21:00",172,176,-1,11,348,"neutor",NA
"1/23/2015 22:00",125,210,-1,11,335,"neutor",NA
"1/23/2015 23:00",98,153,-1,13,251,"neutor",NA
"1/24/2015 0:00",82,125,-1,15,207,"neutor",NA
"1/24/2015 1:00",59,134,-1,13,193,"neutor",NA
"1/24/2015 2:00",32,118,-1,13,150,"neutor",NA
"1/24/2015 3:00",23,52,0,15,75,"neutor",NA
"1/24/2015 4:00",12,63,0,17,75,"neutor",NA
"1/24/2015 5:00",17,29,0,17,46,"neutor",NA
"1/24/2015 6:00",24,13,0,13,37,"neutor",NA
"1/24/2015 7:00",58,16,0,11,74,"neutor",NA
"1/24/2015 8:00",90,46,-1,13,136,"neutor",NA
"1/24/2015 9:00",219,55,-1,11,274,"neutor",NA
"1/24/2015 10:00",215,71,0,9,286,"neutor",NA
"1/24/2015 11:00",126,63,0,9,189,"neutor",NA
"1/24/2015 12:00",126,123,1,7,249,"neutor",NA
"1/24/2015 13:00",134,135,1,6,269,"neutor",NA
"1/24/2015 14:00",149,151,1,7,300,"neutor",NA
"1/24/2015 15:00",132,124,1,6,256,"neutor",NA
"1/24/2015 16:00",117,132,2,9,249,"neutor",NA
"1/24/2015 17:00",135,138,2,11,273,"neutor",NA
"1/24/2015 18:00",121,189,0,9,310,"neutor",NA
"1/24/2015 19:00",137,179,0,7,316,"neutor",NA
"1/24/2015 20:00",155,173,-1,9,328,"neutor",NA
"1/24/2015 21:00",108,125,0,9,233,"neutor",NA
"1/24/2015 22:00",75,93,-1,9,168,"neutor",NA
"1/24/2015 23:00",79,97,-1,7,176,"neutor",NA
"1/25/2015 0:00",76,88,-1,7,164,"neutor",NA
"1/25/2015 1:00",67,100,0,11,167,"neutor",NA
"1/25/2015 2:00",48,51,-1,7,99,"neutor",NA
"1/25/2015 3:00",23,38,-1,9,61,"neutor",NA
"1/25/2015 4:00",16,28,-1,2,44,"neutor",NA
"1/25/2015 5:00",12,23,-2,4,35,"neutor",NA
"1/25/2015 6:00",11,18,-2,2,29,"neutor",NA
"1/25/2015 7:00",14,5,-1,2,19,"neutor",NA
"1/25/2015 8:00",45,19,-1,6,64,"neutor",NA
"1/25/2015 9:00",153,49,0,6,202,"neutor",NA
"1/25/2015 10:00",139,58,2,7,197,"neutor",NA
"1/25/2015 11:00",98,63,2,6,161,"neutor",NA
"1/25/2015 12:00",108,102,3,9,210,"neutor",NA
"1/25/2015 13:00",102,105,3,7,207,"neutor",NA
"1/25/2015 14:00",133,121,3,9,254,"neutor",NA
"1/25/2015 15:00",155,137,3,7,292,"neutor",NA
"1/25/2015 16:00",136,114,3,7,250,"neutor",NA
"1/25/2015 17:00",140,121,3,7,261,"neutor",NA
"1/25/2015 18:00",118,144,2,7,262,"neutor",NA
"1/25/2015 19:00",106,175,2,9,281,"neutor",NA
"1/25/2015 20:00",82,132,2,9,214,"neutor",NA
"1/25/2015 21:00",49,80,2,7,129,"neutor",NA
"1/25/2015 22:00",41,92,2,7,133,"neutor",NA
"1/25/2015 23:00",22,47,2,7,69,"neutor",NA
"1/26/2015 0:00",10,28,3,9,38,"neutor",NA
"1/26/2015 1:00",7,24,3,11,31,"neutor",NA
"1/26/2015 2:00",3,8,3,9,11,"neutor",NA
"1/26/2015 3:00",6,1,3,11,7,"neutor",NA
"1/26/2015 4:00",4,9,3,11,13,"neutor",NA
"1/26/2015 5:00",20,11,3,11,31,"neutor",NA
"1/26/2015 6:00",65,33,3,13,98,"neutor",NA
"1/26/2015 7:00",365,153,3,13,518,"neutor",NA
"1/26/2015 8:00",480,335,3,13,815,"neutor",NA
"1/26/2015 9:00",334,256,3,13,590,"neutor",NA
"1/26/2015 10:00",375,341,3,15,716,"neutor",NA
"1/26/2015 11:00",283,216,4,15,499,"neutor",NA
"1/26/2015 12:00",295,309,4,13,604,"neutor",NA
"1/26/2015 13:00",341,345,4,15,686,"neutor",NA
"1/26/2015 14:00",367,329,4,13,696,"neutor",NA
"1/26/2015 15:00",424,422,5,15,846,"neutor",NA
"1/26/2015 16:00",434,449,5,17,883,"neutor",NA
"1/26/2015 17:00",505,425,6,17,930,"neutor",NA
"1/26/2015 18:00",430,417,6,19,847,"neutor",NA
"1/26/2015 19:00",337,365,5,17,702,"neutor",NA
"1/26/2015 20:00",182,287,5,19,469,"neutor",NA
"1/26/2015 21:00",152,185,4,17,337,"neutor",NA
"1/26/2015 22:00",82,221,4,17,303,"neutor",NA
"1/26/2015 23:00",52,83,3,19,135,"neutor",NA
"1/27/2015 0:00",22,32,4,17,54,"neutor",NA
"1/27/2015 1:00",6,23,2,15,29,"neutor",NA
"1/27/2015 2:00",6,6,3,15,12,"neutor",NA
"1/27/2015 3:00",5,4,2,17,9,"neutor",NA
"1/27/2015 4:00",3,9,3,15,12,"neutor",NA
"1/27/2015 5:00",34,8,2,13,42,"neutor",NA
"1/27/2015 6:00",81,31,2,15,112,"neutor",NA
"1/27/2015 7:00",408,222,2,13,630,"neutor",NA
"1/27/2015 8:00",540,417,2,11,957,"neutor",NA
"1/27/2015 9:00",546,317,3,11,863,"neutor",NA
"1/27/2015 10:00",469,309,4,13,778,"neutor",NA
"1/27/2015 11:00",454,348,5,11,802,"neutor",NA
"1/27/2015 12:00",474,369,6,13,843,"neutor",NA
"1/27/2015 13:00",443,412,6,15,855,"neutor",NA
"1/27/2015 14:00",476,440,6,15,916,"neutor",NA
"1/27/2015 15:00",441,491,6,13,932,"neutor",NA
"1/27/2015 16:00",454,485,5,15,939,"neutor",NA
"1/27/2015 17:00",569,480,4,6,1049,"neutor",NA
"1/27/2015 18:00",536,475,4,11,1011,"neutor",NA
"1/27/2015 19:00",397,412,3,9,809,"neutor",NA
"1/27/2015 20:00",262,320,3,9,582,"neutor",NA
"1/27/2015 21:00",148,218,3,7,366,"neutor",NA
"1/27/2015 22:00",132,234,3,7,366,"neutor",NA
"1/27/2015 23:00",78,112,4,9,190,"neutor",NA
"1/28/2015 0:00",19,57,3,9,76,"neutor",NA
"1/28/2015 1:00",15,33,4,11,48,"neutor",NA
"1/28/2015 2:00",5,12,3,11,17,"neutor",NA
"1/28/2015 3:00",4,5,3,11,9,"neutor",NA
"1/28/2015 4:00",7,9,4,15,16,"neutor",NA
"1/28/2015 5:00",29,12,4,13,41,"neutor",NA
"1/28/2015 6:00",89,34,4,19,123,"neutor",NA
"1/28/2015 7:00",431,216,4,17,647,"neutor",NA
"1/28/2015 8:00",669,402,4,17,1071,"neutor",NA
"1/28/2015 9:00",498,320,5,19,818,"neutor",NA
"1/28/2015 10:00",465,359,5,26,824,"neutor",NA
"1/28/2015 11:00",459,324,6,26,783,"neutor",NA
"1/28/2015 12:00",505,429,6,32,934,"neutor",NA
"1/28/2015 13:00",444,375,6,28,819,"neutor",NA
"1/28/2015 14:00",452,482,6,30,934,"neutor",NA
"1/28/2015 15:00",419,407,5,28,826,"neutor",NA
"1/28/2015 16:00",423,397,5,32,820,"neutor",NA
"1/28/2015 17:00",367,385,5,28,752,"neutor",NA
"1/28/2015 18:00",297,353,3,39,650,"neutor",NA
"1/28/2015 19:00",282,282,3,19,564,"neutor",NA
"1/28/2015 20:00",150,256,3,32,406,"neutor",NA
"1/28/2015 21:00",147,129,3,22,276,"neutor",NA
"1/28/2015 22:00",116,179,3,28,295,"neutor",NA
"1/28/2015 23:00",80,117,3,32,197,"neutor",NA
"1/29/2015 0:00",58,58,3,30,116,"neutor",NA
"1/29/2015 1:00",35,44,3,28,79,"neutor",NA
"1/29/2015 2:00",9,25,2,22,34,"neutor",NA
"1/29/2015 3:00",13,35,2,20,48,"neutor",NA
"1/29/2015 4:00",9,10,2,22,19,"neutor",NA
"1/29/2015 5:00",28,15,2,28,43,"neutor",NA
"1/29/2015 6:00",68,31,2,24,99,"neutor",NA
"1/29/2015 7:00",362,209,1,22,571,"neutor",NA
"1/29/2015 8:00",526,330,1,22,856,"neutor",NA
"1/29/2015 9:00",346,216,1,19,562,"neutor",NA
"1/29/2015 10:00",302,244,1,24,546,"neutor",NA
"1/29/2015 11:00",257,263,2,22,520,"neutor",NA
"1/29/2015 12:00",282,319,3,17,601,"neutor",NA
"1/29/2015 13:00",384,333,4,24,717,"neutor",NA
"1/29/2015 14:00",345,307,4,19,652,"neutor",NA
"1/29/2015 15:00",386,370,4,17,756,"neutor",NA
"1/29/2015 16:00",434,369,4,20,803,"neutor",NA
"1/29/2015 17:00",448,396,2,11,844,"neutor",NA
"1/29/2015 18:00",393,363,2,11,756,"neutor",NA
"1/29/2015 19:00",329,375,0,4,704,"neutor",NA
"1/29/2015 20:00",238,294,1,6,532,"neutor",NA
"1/29/2015 21:00",149,174,1,6,323,"neutor",NA
"1/29/2015 22:00",97,174,1,6,271,"neutor",NA
"1/29/2015 23:00",63,119,1,11,182,"neutor",NA
"1/30/2015 0:00",48,91,1,7,139,"neutor",NA
"1/30/2015 1:00",15,42,1,7,57,"neutor",NA
"1/30/2015 2:00",12,13,1,9,25,"neutor",NA
"1/30/2015 3:00",8,13,1,7,21,"neutor",NA
"1/30/2015 4:00",4,9,0,13,13,"neutor",NA
"1/30/2015 5:00",24,9,0,9,33,"neutor",NA
"1/30/2015 6:00",54,18,0,15,72,"neutor",NA
"1/30/2015 7:00",254,72,0,17,326,"neutor",NA
"1/30/2015 8:00",366,226,0,20,592,"neutor",NA
"1/30/2015 9:00",252,148,0,19,400,"neutor",NA
"1/30/2015 10:00",272,245,1,19,517,"neutor",NA
"1/30/2015 11:00",290,198,1,13,488,"neutor",NA
"1/30/2015 12:00",370,248,1,17,618,"neutor",NA
"1/30/2015 13:00",284,213,1,13,497,"neutor",NA
"1/30/2015 14:00",273,253,1,15,526,"neutor",NA
"1/30/2015 15:00",304,249,1,9,553,"neutor",NA
"1/30/2015 16:00",261,268,2,13,529,"neutor",NA
"1/30/2015 17:00",343,243,2,13,586,"neutor",NA
"1/30/2015 18:00",300,273,1,11,573,"neutor",NA
"1/30/2015 19:00",244,252,1,11,496,"neutor",NA
"1/30/2015 20:00",214,198,1,11,412,"neutor",NA
"1/30/2015 21:00",133,168,1,11,301,"neutor",NA
"1/30/2015 22:00",82,138,1,11,220,"neutor",NA
"1/30/2015 23:00",99,147,1,9,246,"neutor",NA
"1/31/2015 0:00",64,112,1,13,176,"neutor",NA
"1/31/2015 1:00",48,100,0,11,148,"neutor",NA
"1/31/2015 2:00",24,65,0,7,89,"neutor",NA
"1/31/2015 3:00",12,39,1,15,51,"neutor",NA
"1/31/2015 4:00",12,33,2,17,45,"neutor",NA
"1/31/2015 5:00",20,16,1,19,36,"neutor",NA
"1/31/2015 6:00",10,12,2,19,22,"neutor",NA
"1/31/2015 7:00",54,41,2,19,95,"neutor",NA
"1/31/2015 8:00",122,43,2,17,165,"neutor",NA
"1/31/2015 9:00",255,66,2,15,321,"neutor",NA
"1/31/2015 10:00",317,100,2,13,417,"neutor",NA
"1/31/2015 11:00",250,143,2,11,393,"neutor",NA
"1/31/2015 12:00",245,168,2,13,413,"neutor",NA
"1/31/2015 13:00",250,178,3,11,428,"neutor",NA
"1/31/2015 14:00",262,236,3,13,498,"neutor",NA
"1/31/2015 15:00",204,209,3,9,413,"neutor",NA
"1/31/2015 16:00",182,197,3,9,379,"neutor",NA
"1/31/2015 17:00",193,232,1,6,425,"neutor",NA
"1/31/2015 18:00",175,195,2,7,370,"neutor",NA
"1/31/2015 19:00",208,199,1,6,407,"neutor",NA
"1/31/2015 20:00",185,223,2,9,408,"neutor",NA
"1/31/2015 21:00",132,100,1,9,232,"neutor",NA
"1/31/2015 22:00",75,132,0,6,207,"neutor",NA
"1/31/2015 23:00",64,148,1,7,212,"neutor",NA
"2/1/2015 0:00",78,116,1,7,194,"neutor",NA
"2/1/2015 1:00",43,108,1,7,151,"neutor",NA
"2/1/2015 2:00",43,80,1,7,123,"neutor",NA
"2/1/2015 3:00",27,61,1,11,88,"neutor",NA
"2/1/2015 4:00",12,44,1,7,56,"neutor",NA
"2/1/2015 5:00",22,25,1,11,47,"neutor",NA
"2/1/2015 6:00",14,10,1,7,24,"neutor",NA
"2/1/2015 7:00",16,8,1,7,24,"neutor",NA
"2/1/2015 8:00",63,29,1,7,92,"neutor",NA
"2/1/2015 9:00",155,27,2,11,182,"neutor",NA
"2/1/2015 10:00",182,57,2,9,239,"neutor",NA
"2/1/2015 11:00",132,81,2,9,213,"neutor",NA
"2/1/2015 12:00",147,120,2,7,267,"neutor",NA
"2/1/2015 13:00",145,137,2,9,282,"neutor",NA
"2/1/2015 14:00",145,114,2,6,259,"neutor",NA
"2/1/2015 15:00",150,118,2,7,268,"neutor",NA
"2/1/2015 16:00",149,192,2,9,341,"neutor",NA
"2/1/2015 17:00",168,171,2,9,339,"neutor",NA
"2/1/2015 18:00",109,184,2,9,293,"neutor",NA
"2/1/2015 19:00",118,210,1,11,328,"neutor",NA
"2/1/2015 20:00",98,156,1,9,254,"neutor",NA
"2/1/2015 21:00",64,95,1,13,159,"neutor",NA
"2/1/2015 22:00",69,83,1,13,152,"neutor",NA
"2/1/2015 23:00",53,61,1,15,114,"neutor",NA
"2/2/2015 0:00",13,44,1,11,57,"neutor",NA
"2/2/2015 1:00",11,12,1,7,23,"neutor",NA
"2/2/2015 2:00",11,13,0,7,24,"neutor",NA
"2/2/2015 3:00",16,6,1,11,22,"neutor",NA
"2/2/2015 4:00",41,38,1,15,79,"neutor",NA
"2/2/2015 5:00",25,15,1,11,40,"neutor",NA
"2/2/2015 6:00",80,31,1,15,111,"neutor",NA
"2/2/2015 7:00",367,220,1,17,587,"neutor",NA
"2/2/2015 8:00",460,285,1,15,745,"neutor",NA
"2/2/2015 9:00",416,281,1,19,697,"neutor",NA
"2/2/2015 10:00",398,272,2,19,670,"neutor",NA
"2/2/2015 11:00",301,327,2,19,628,"neutor",NA
"2/2/2015 12:00",382,304,2,19,686,"neutor",NA
"2/2/2015 13:00",383,382,2,17,765,"neutor",NA
"2/2/2015 14:00",336,315,2,19,651,"neutor",NA
"2/2/2015 15:00",517,357,3,17,874,"neutor",NA
"2/2/2015 16:00",507,422,2,15,929,"neutor",NA
"2/2/2015 17:00",486,592,1,15,1078,"neutor",NA
"2/2/2015 18:00",343,433,2,15,776,"neutor",NA
"2/2/2015 19:00",338,376,2,19,714,"neutor",NA
"2/2/2015 20:00",192,221,1,13,413,"neutor",NA
"2/2/2015 21:00",151,203,1,13,354,"neutor",NA
"2/2/2015 22:00",100,164,1,17,264,"neutor",NA
"2/2/2015 23:00",48,96,1,15,144,"neutor",NA
"2/3/2015 0:00",29,65,1,17,94,"neutor",NA
"2/3/2015 1:00",9,23,1,17,32,"neutor",NA
"2/3/2015 2:00",10,11,1,15,21,"neutor",NA
"2/3/2015 3:00",7,4,1,15,11,"neutor",NA
"2/3/2015 4:00",9,4,1,17,13,"neutor",NA
"2/3/2015 5:00",24,11,1,17,35,"neutor",NA
"2/3/2015 6:00",77,41,1,17,118,"neutor",NA
"2/3/2015 7:00",450,197,1,19,647,"neutor",NA
"2/3/2015 8:00",496,298,1,19,794,"neutor",NA
"2/3/2015 9:00",517,321,1,11,838,"neutor",NA
"2/3/2015 10:00",366,238,2,15,604,"neutor",NA
"2/3/2015 11:00",315,310,2,11,625,"neutor",NA
"2/3/2015 12:00",353,304,2,9,657,"neutor",NA
"2/3/2015 13:00",430,296,3,11,726,"neutor",NA
"2/3/2015 14:00",419,379,3,11,798,"neutor",NA
"2/3/2015 15:00",382,386,3,15,768,"neutor",NA
"2/3/2015 16:00",387,433,3,13,820,"neutor",NA
"2/3/2015 17:00",572,490,0,11,1062,"neutor",NA
"2/3/2015 18:00",371,446,1,7,817,"neutor",NA
"2/3/2015 19:00",322,392,0,7,714,"neutor",NA
"2/3/2015 20:00",204,280,0,13,484,"neutor",NA
"2/3/2015 21:00",124,223,0,9,347,"neutor",NA
"2/3/2015 22:00",111,191,0,9,302,"neutor",NA
"2/3/2015 23:00",65,98,-1,9,163,"neutor",NA
"2/4/2015 0:00",15,75,-1,6,90,"neutor",NA
"2/4/2015 1:00",13,43,-3,4,56,"neutor",NA
"2/4/2015 2:00",2,13,-3,6,15,"neutor",NA
"2/4/2015 3:00",8,8,-4,6,16,"neutor",NA
"2/4/2015 4:00",3,8,-4,2,11,"neutor",NA
"2/4/2015 5:00",23,8,-4,2,31,"neutor",NA
"2/4/2015 6:00",79,26,-5,4,105,"neutor",NA
"2/4/2015 7:00",362,202,-5,2,564,"neutor",NA
"2/4/2015 8:00",468,314,-4,2,782,"neutor",NA
"2/4/2015 9:00",438,300,-2,2,738,"neutor",NA
"2/4/2015 10:00",348,267,-1,4,615,"neutor",NA
"2/4/2015 11:00",313,295,2,2,608,"neutor",NA
"2/4/2015 12:00",435,276,2,7,711,"neutor",NA
"2/4/2015 13:00",430,290,3,13,720,"neutor",NA
"2/4/2015 14:00",412,331,3,11,743,"neutor",NA
"2/4/2015 15:00",427,374,2,9,801,"neutor",NA
"2/4/2015 16:00",451,388,1,7,839,"neutor",NA
"2/4/2015 17:00",495,446,-1,7,941,"neutor",NA
"2/4/2015 18:00",406,460,-1,4,866,"neutor",NA
"2/4/2015 19:00",443,429,-2,4,872,"neutor",NA
"2/4/2015 20:00",224,327,-2,4,551,"neutor",NA
"2/4/2015 21:00",176,304,-2,6,480,"neutor",NA
"2/4/2015 22:00",193,259,-2,7,452,"neutor",NA
"2/4/2015 23:00",154,175,-3,6,329,"neutor",NA
"2/5/2015 0:00",108,109,-2,6,217,"neutor",NA
"2/5/2015 1:00",93,66,-2,4,159,"neutor",NA
"2/5/2015 2:00",60,54,-3,6,114,"neutor",NA
"2/5/2015 3:00",50,59,-3,4,109,"neutor",NA
"2/5/2015 4:00",57,18,-2,2,75,"neutor",NA
"2/5/2015 5:00",44,12,-2,6,56,"neutor",NA
"2/5/2015 6:00",88,42,-2,4,130,"neutor",NA
"2/5/2015 7:00",394,182,-2,4,576,"neutor",NA
"2/5/2015 8:00",493,281,-1,4,774,"neutor",NA
"2/5/2015 9:00",424,250,-1,9,674,"neutor",NA
"2/5/2015 10:00",333,293,-1,17,626,"neutor",NA
"2/5/2015 11:00",373,316,0,13,689,"neutor",NA
"2/5/2015 12:00",353,304,0,15,657,"neutor",NA
"2/5/2015 13:00",400,353,0,17,753,"neutor",NA
"2/5/2015 14:00",387,401,0,15,788,"neutor",NA
"2/5/2015 15:00",437,373,0,17,810,"neutor",NA
"2/5/2015 16:00",497,454,0,19,951,"neutor",NA
"2/5/2015 17:00",520,446,0,15,966,"neutor",NA
"2/5/2015 18:00",392,419,0,17,811,"neutor",NA
"2/5/2015 19:00",289,355,0,19,644,"neutor",NA
"2/5/2015 20:00",215,278,-1,15,493,"neutor",NA
"2/5/2015 21:00",185,213,-1,15,398,"neutor",NA
"2/5/2015 22:00",131,163,-2,17,294,"neutor",NA
"2/5/2015 23:00",77,115,-2,17,192,"neutor",NA
"2/6/2015 0:00",64,87,-3,13,151,"neutor",NA
"2/6/2015 1:00",15,37,-4,11,52,"neutor",NA
"2/6/2015 2:00",6,50,-3,15,56,"neutor",NA
"2/6/2015 3:00",8,46,-3,17,54,"neutor",NA
"2/6/2015 4:00",6,29,-3,20,35,"neutor",NA
"2/6/2015 5:00",21,23,-3,19,44,"neutor",NA
"2/6/2015 6:00",67,29,-3,7,96,"neutor",NA
"2/6/2015 7:00",344,199,-3,13,543,"neutor",NA
"2/6/2015 8:00",477,255,-3,17,732,"neutor",NA
"2/6/2015 9:00",355,217,-2,15,572,"neutor",NA
"2/6/2015 10:00",370,223,-1,20,593,"neutor",NA
"2/6/2015 11:00",271,273,0,22,544,"neutor",NA
"2/6/2015 12:00",321,281,0,26,602,"neutor",NA
"2/6/2015 13:00",419,327,1,22,746,"neutor",NA
"2/6/2015 14:00",372,353,1,26,725,"neutor",NA
"2/6/2015 15:00",405,338,2,20,743,"neutor",NA
"2/6/2015 16:00",352,396,1,20,748,"neutor",NA
"2/6/2015 17:00",374,422,0,20,796,"neutor",NA
"2/6/2015 18:00",312,391,0,15,703,"neutor",NA
"2/6/2015 19:00",347,321,-1,13,668,"neutor",NA
"2/6/2015 20:00",247,372,-2,9,619,"neutor",NA
"2/6/2015 21:00",191,259,-2,9,450,"neutor",NA
"2/6/2015 22:00",159,174,-2,2,333,"neutor",NA
"2/6/2015 23:00",229,183,-4,7,412,"neutor",NA
"2/7/2015 0:00",142,130,-4,6,272,"neutor",NA
"2/7/2015 1:00",85,90,-4,2,175,"neutor",NA
"2/7/2015 2:00",43,94,-4,6,137,"neutor",NA
"2/7/2015 3:00",49,79,-4,4,128,"neutor",NA
"2/7/2015 4:00",39,49,-5,6,88,"neutor",NA
"2/7/2015 5:00",21,43,-6,2,64,"neutor",NA
"2/7/2015 6:00",9,22,-7,4,31,"neutor",NA
"2/7/2015 7:00",57,22,-6,4,79,"neutor",NA
"2/7/2015 8:00",182,48,-5,2,230,"neutor",NA
"2/7/2015 9:00",270,94,-2,6,364,"neutor",NA
"2/7/2015 10:00",309,159,-1,6,468,"neutor",NA
"2/7/2015 11:00",259,164,1,6,423,"neutor",NA
"2/7/2015 12:00",331,178,1,9,509,"neutor",NA
"2/7/2015 13:00",310,227,2,17,537,"neutor",NA
"2/7/2015 14:00",205,255,2,13,460,"neutor",NA
"2/7/2015 15:00",186,256,2,13,442,"neutor",NA
"2/7/2015 16:00",195,271,2,11,466,"neutor",NA
"2/7/2015 17:00",156,279,3,11,435,"neutor",NA
"2/7/2015 18:00",211,226,3,11,437,"neutor",NA
"2/7/2015 19:00",180,221,4,15,401,"neutor",NA
"2/7/2015 20:00",168,181,4,13,349,"neutor",NA
"2/7/2015 21:00",116,143,4,15,259,"neutor",NA
"2/7/2015 22:00",95,92,4,19,187,"neutor",NA
"2/7/2015 23:00",101,110,4,19,211,"neutor",NA
"2/8/2015 0:00",79,86,4,15,165,"neutor",NA
"2/8/2015 1:00",60,89,4,17,149,"neutor",NA
"2/8/2015 2:00",27,75,3,22,102,"neutor",NA
"2/8/2015 3:00",26,46,4,22,72,"neutor",NA
"2/8/2015 4:00",15,34,4,22,49,"neutor",NA
"2/8/2015 5:00",15,16,3,20,31,"neutor",NA
"2/8/2015 6:00",9,11,3,20,20,"neutor",NA
"2/8/2015 7:00",14,13,2,20,27,"neutor",NA
"2/8/2015 8:00",61,11,3,17,72,"neutor",NA
"2/8/2015 9:00",200,43,3,15,243,"neutor",NA
"2/8/2015 10:00",176,90,4,19,266,"neutor",NA
"2/8/2015 11:00",138,95,4,20,233,"neutor",NA
"2/8/2015 12:00",153,181,4,19,334,"neutor",NA
"2/8/2015 13:00",147,177,4,13,324,"neutor",NA
"2/8/2015 14:00",230,210,5,17,440,"neutor",NA
"2/8/2015 15:00",236,179,4,13,415,"neutor",NA
"2/8/2015 16:00",196,212,4,15,408,"neutor",NA
"2/8/2015 17:00",251,190,3,9,441,"neutor",NA
"2/8/2015 18:00",228,173,2,9,401,"neutor",NA
"2/8/2015 19:00",162,204,1,7,366,"neutor",NA
"2/8/2015 20:00",91,175,2,9,266,"neutor",NA
"2/8/2015 21:00",54,90,3,11,144,"neutor",NA
"2/8/2015 22:00",44,112,2,13,156,"neutor",NA
"2/8/2015 23:00",45,48,3,9,93,"neutor",NA
"2/9/2015 0:00",28,20,4,13,48,"neutor",NA
"2/9/2015 1:00",11,13,4,13,24,"neutor",NA
"2/9/2015 2:00",3,8,4,15,11,"neutor",NA
"2/9/2015 3:00",9,3,4,17,12,"neutor",NA
"2/9/2015 4:00",6,6,4,19,12,"neutor",NA
"2/9/2015 5:00",33,11,4,15,44,"neutor",NA
"2/9/2015 6:00",80,28,4,17,108,"neutor",NA
"2/9/2015 7:00",385,150,5,15,535,"neutor",NA
"2/9/2015 8:00",535,273,5,15,808,"neutor",NA
"2/9/2015 9:00",330,227,5,17,557,"neutor",NA
"2/9/2015 10:00",241,210,6,19,451,"neutor",NA
"2/9/2015 11:00",280,209,6,20,489,"neutor",NA
"2/9/2015 12:00",277,280,6,19,557,"neutor",NA
"2/9/2015 13:00",348,285,6,15,633,"neutor",NA
"2/9/2015 14:00",305,275,6,19,580,"neutor",NA
"2/9/2015 15:00",319,304,6,15,623,"neutor",NA
"2/9/2015 16:00",326,371,6,15,697,"neutor",NA
"2/9/2015 17:00",393,373,6,13,766,"neutor",NA
"2/9/2015 18:00",340,352,6,15,692,"neutor",NA
"2/9/2015 19:00",254,296,6,13,550,"neutor",NA
"2/9/2015 20:00",164,212,6,11,376,"neutor",NA
"2/9/2015 21:00",81,173,6,13,254,"neutor",NA
"2/9/2015 22:00",70,126,6,11,196,"neutor",NA
"2/9/2015 23:00",45,114,6,11,159,"neutor",NA
"2/10/2015 0:00",28,71,5,11,99,"neutor",NA
"2/10/2015 1:00",10,28,5,13,38,"neutor",NA
"2/10/2015 2:00",10,9,5,11,19,"neutor",NA
"2/10/2015 3:00",5,2,5,9,7,"neutor",NA
"2/10/2015 4:00",2,6,5,9,8,"neutor",NA
"2/10/2015 5:00",25,14,5,9,39,"neutor",NA
"2/10/2015 6:00",81,34,5,11,115,"neutor",NA
"2/10/2015 7:00",413,201,5,9,614,"neutor",NA
"2/10/2015 8:00",509,243,5,6,752,"neutor",NA
"2/10/2015 9:00",403,265,5,9,668,"neutor",NA
"2/10/2015 10:00",262,201,6,9,463,"neutor",NA
"2/10/2015 11:00",255,257,6,11,512,"neutor",NA
"2/10/2015 12:00",299,249,6,9,548,"neutor",NA
"2/10/2015 13:00",314,296,6,7,610,"neutor",NA
"2/10/2015 14:00",311,300,6,6,611,"neutor",NA
"2/10/2015 15:00",329,326,6,6,655,"neutor",NA
"2/10/2015 16:00",363,343,6,11,706,"neutor",NA
"2/10/2015 17:00",499,431,6,6,930,"neutor",NA
"2/10/2015 18:00",368,442,5,7,810,"neutor",NA
"2/10/2015 19:00",260,333,5,4,593,"neutor",NA
"2/10/2015 20:00",214,279,5,6,493,"neutor",NA
"2/10/2015 21:00",94,197,5,7,291,"neutor",NA
"2/10/2015 22:00",108,158,5,2,266,"neutor",NA
"2/10/2015 23:00",60,120,4,2,180,"neutor",NA
"2/11/2015 0:00",25,72,4,2,97,"neutor",NA
"2/11/2015 1:00",12,53,5,6,65,"neutor",NA
"2/11/2015 2:00",11,23,5,4,34,"neutor",NA
"2/11/2015 3:00",5,12,5,4,17,"neutor",NA
"2/11/2015 4:00",7,9,4,7,16,"neutor",NA
"2/11/2015 5:00",31,18,4,7,49,"neutor",NA
"2/11/2015 6:00",79,28,4,6,107,"neutor",NA
"2/11/2015 7:00",433,184,4,9,617,"neutor",NA
"2/11/2015 8:00",553,262,4,13,815,"neutor",NA
"2/11/2015 9:00",416,224,4,7,640,"neutor",NA
"2/11/2015 10:00",341,220,4,7,561,"neutor",NA
"2/11/2015 11:00",312,230,4,9,542,"neutor",NA
"2/11/2015 12:00",317,304,4,9,621,"neutor",NA
"2/11/2015 13:00",360,331,4,7,691,"neutor",NA
"2/11/2015 14:00",317,331,4,6,648,"neutor",NA
"2/11/2015 15:00",322,287,4,9,609,"neutor",NA
"2/11/2015 16:00",369,346,4,6,715,"neutor",NA
"2/11/2015 17:00",435,434,4,4,869,"neutor",NA
"2/11/2015 18:00",366,445,2,4,811,"neutor",NA
"2/11/2015 19:00",330,353,0,2,683,"neutor",NA
"2/11/2015 20:00",202,249,-1,4,451,"neutor",NA
"2/11/2015 21:00",121,162,0,4,283,"neutor",NA
"2/11/2015 22:00",100,187,-2,4,287,"neutor",NA
"2/11/2015 23:00",89,138,-2,4,227,"neutor",NA
"2/12/2015 0:00",56,79,-3,2,135,"neutor",NA
"2/12/2015 1:00",31,62,-3,2,93,"neutor",NA
"2/12/2015 2:00",19,53,-3,2,72,"neutor",NA
"2/12/2015 3:00",18,29,-3,2,47,"neutor",NA
"2/12/2015 4:00",12,23,-2,2,35,"neutor",NA
"2/12/2015 5:00",33,23,-1,2,56,"neutor",NA
"2/12/2015 6:00",78,34,-1,6,112,"neutor",NA
"2/12/2015 7:00",390,171,-1,6,561,"neutor",NA
"2/12/2015 8:00",458,263,-1,6,721,"neutor",NA
"2/12/2015 9:00",365,230,-1,6,595,"neutor",NA
"2/12/2015 10:00",320,159,0,6,479,"neutor",NA
"2/12/2015 11:00",284,206,0,4,490,"neutor",NA
"2/12/2015 12:00",281,235,1,7,516,"neutor",NA
"2/12/2015 13:00",355,281,2,7,636,"neutor",NA
"2/12/2015 14:00",345,290,2,6,635,"neutor",NA
"2/12/2015 15:00",325,308,2,6,633,"neutor",NA
"2/12/2015 16:00",422,370,2,6,792,"neutor",NA
"2/12/2015 17:00",432,332,2,6,764,"neutor",NA
"2/12/2015 18:00",307,368,2,4,675,"neutor",NA
"2/12/2015 19:00",246,279,2,6,525,"neutor",NA
"2/12/2015 20:00",230,217,1,6,447,"neutor",NA
"2/12/2015 21:00",150,180,1,7,330,"neutor",NA
"2/12/2015 22:00",100,177,0,6,277,"neutor",NA
"2/12/2015 23:00",72,126,0,7,198,"neutor",NA
"2/13/2015 0:00",55,116,-1,7,171,"neutor",NA
"2/13/2015 1:00",35,99,-1,7,134,"neutor",NA
"2/13/2015 2:00",13,70,-1,6,83,"neutor",NA
"2/13/2015 3:00",6,46,-1,6,52,"neutor",NA
"2/13/2015 4:00",3,18,-2,6,21,"neutor",NA
"2/13/2015 5:00",28,17,-2,6,45,"neutor",NA
"2/13/2015 6:00",57,33,-2,6,90,"neutor",NA
"2/13/2015 7:00",312,166,-2,6,478,"neutor",NA
"2/13/2015 8:00",430,234,-1,7,664,"neutor",NA
"2/13/2015 9:00",332,184,0,6,516,"neutor",NA
"2/13/2015 10:00",310,196,2,7,506,"neutor",NA
"2/13/2015 11:00",255,255,4,7,510,"neutor",NA
"2/13/2015 12:00",329,264,6,7,593,"neutor",NA
"2/13/2015 13:00",380,324,8,9,704,"neutor",NA
"2/13/2015 14:00",373,348,9,7,721,"neutor",NA
"2/13/2015 15:00",403,274,9,11,677,"neutor",NA
"2/13/2015 16:00",401,321,8,11,722,"neutor",NA
"2/13/2015 17:00",328,363,6,9,691,"neutor",NA
"2/13/2015 18:00",271,278,5,7,549,"neutor",NA
"2/13/2015 19:00",245,266,4,11,511,"neutor",NA
"2/13/2015 20:00",217,252,3,7,469,"neutor",NA
"2/13/2015 21:00",124,140,2,11,264,"neutor",NA
"2/13/2015 22:00",98,149,2,7,247,"neutor",NA
"2/13/2015 23:00",82,118,2,11,200,"neutor",NA
"2/14/2015 0:00",98,107,2,9,205,"neutor",NA
"2/14/2015 1:00",94,116,2,9,210,"neutor",NA
"2/14/2015 2:00",31,57,2,9,88,"neutor",NA
"2/14/2015 3:00",23,51,3,7,74,"neutor",NA
"2/14/2015 4:00",25,55,3,11,80,"neutor",NA
"2/14/2015 5:00",28,52,3,9,80,"neutor",NA
"2/14/2015 6:00",23,13,2,9,36,"neutor",NA
"2/14/2015 7:00",53,37,2,9,90,"neutor",NA
"2/14/2015 8:00",174,50,3,11,224,"neutor",NA
"2/14/2015 9:00",252,64,4,13,316,"neutor",NA
"2/14/2015 10:00",308,92,6,9,400,"neutor",NA
"2/14/2015 11:00",259,165,8,11,424,"neutor",NA
"2/14/2015 12:00",269,187,9,11,456,"neutor",NA
"2/14/2015 13:00",270,215,10,9,485,"neutor",NA
"2/14/2015 14:00",220,252,11,13,472,"neutor",NA
"2/14/2015 15:00",230,201,10,15,431,"neutor",NA
"2/14/2015 16:00",187,209,10,13,396,"neutor",NA
"2/14/2015 17:00",203,220,8,11,423,"neutor",NA
"2/14/2015 18:00",196,211,7,13,407,"neutor",NA
"2/14/2015 19:00",151,191,6,7,342,"neutor",NA
"2/14/2015 20:00",127,182,6,6,309,"neutor",NA
"2/14/2015 21:00",116,114,5,6,230,"neutor",NA
"2/14/2015 22:00",87,113,3,2,200,"neutor",NA
"2/14/2015 23:00",59,81,3,6,140,"neutor",NA
"2/15/2015 0:00",64,87,2,2,151,"neutor",NA
"2/15/2015 1:00",58,64,1,7,122,"neutor",NA
"2/15/2015 2:00",55,76,1,9,131,"neutor",NA
"2/15/2015 3:00",43,36,1,9,79,"neutor",NA
"2/15/2015 4:00",23,27,1,13,50,"neutor",NA
"2/15/2015 5:00",12,29,0,15,41,"neutor",NA
"2/15/2015 6:00",8,15,1,11,23,"neutor",NA
"2/15/2015 7:00",22,6,0,13,28,"neutor",NA
"2/15/2015 8:00",37,19,0,19,56,"neutor",NA
"2/15/2015 9:00",157,51,0,22,208,"neutor",NA
"2/15/2015 10:00",185,72,1,20,257,"neutor",NA
"2/15/2015 11:00",133,79,2,19,212,"neutor",NA
"2/15/2015 12:00",153,107,3,20,260,"neutor",NA
"2/15/2015 13:00",169,137,3,19,306,"neutor",NA
"2/15/2015 14:00",228,155,3,17,383,"neutor",NA
"2/15/2015 15:00",183,163,3,19,346,"neutor",NA
"2/15/2015 16:00",150,169,3,15,319,"neutor",NA
"2/15/2015 17:00",172,193,2,15,365,"neutor",NA
"2/15/2015 18:00",122,168,1,13,290,"neutor",NA
"2/15/2015 19:00",125,161,1,11,286,"neutor",NA
"2/15/2015 20:00",67,140,2,15,207,"neutor",NA
"2/15/2015 21:00",49,75,1,11,124,"neutor",NA
"2/15/2015 22:00",44,74,1,9,118,"neutor",NA
"2/15/2015 23:00",40,46,1,11,86,"neutor",NA
"2/16/2015 0:00",14,32,2,11,46,"neutor",NA
"2/16/2015 1:00",18,20,1,6,38,"neutor",NA
"2/16/2015 2:00",3,14,1,6,17,"neutor",NA
"2/16/2015 3:00",6,2,-1,6,8,"neutor",NA
"2/16/2015 4:00",3,3,0,6,6,"neutor",NA
"2/16/2015 5:00",24,11,0,6,35,"neutor",NA
"2/16/2015 6:00",49,16,-1,4,65,"neutor",NA
"2/16/2015 7:00",126,56,-1,6,182,"neutor",NA
"2/16/2015 8:00",130,120,0,6,250,"neutor",NA
"2/16/2015 9:00",190,92,1,6,282,"neutor",NA
"2/16/2015 10:00",171,111,3,7,282,"neutor",NA
"2/16/2015 11:00",272,160,4,7,432,"neutor",NA
"2/16/2015 12:00",485,139,6,7,624,"neutor",NA
"2/16/2015 13:00",349,218,7,6,567,"neutor",NA
"2/16/2015 14:00",307,406,8,7,713,"neutor",NA
"2/16/2015 15:00",251,279,8,9,530,"neutor",NA
"2/16/2015 16:00",205,320,7,6,525,"neutor",NA
"2/16/2015 17:00",163,267,5,2,430,"neutor",NA
"2/16/2015 18:00",158,259,2,2,417,"neutor",NA
"2/16/2015 19:00",111,182,0,2,293,"neutor",NA
"2/16/2015 20:00",101,132,-1,4,233,"neutor",NA
"2/16/2015 21:00",48,88,0,4,136,"neutor",NA
"2/16/2015 22:00",57,99,-2,2,156,"neutor",NA
"2/16/2015 23:00",27,80,0,4,107,"neutor",NA
"2/17/2015 0:00",25,38,-2,6,63,"neutor",NA
"2/17/2015 1:00",7,20,-3,6,27,"neutor",NA
"2/17/2015 2:00",6,9,-3,4,15,"neutor",NA
"2/17/2015 3:00",4,4,-3,4,8,"neutor",NA
"2/17/2015 4:00",3,3,-3,2,6,"neutor",NA
"2/17/2015 5:00",35,20,0,4,55,"neutor",NA
"2/17/2015 6:00",94,36,0,2,130,"neutor",NA
"2/17/2015 7:00",264,154,0,2,418,"neutor",NA
"2/17/2015 8:00",484,214,1,6,698,"neutor",NA
"2/17/2015 9:00",326,186,1,9,512,"neutor",NA
"2/17/2015 10:00",222,180,1,11,402,"neutor",NA
"2/17/2015 11:00",286,203,2,9,489,"neutor",NA
"2/17/2015 12:00",288,223,3,6,511,"neutor",NA
"2/17/2015 13:00",263,246,3,6,509,"neutor",NA
"2/17/2015 14:00",279,242,3,6,521,"neutor",NA
"2/17/2015 15:00",283,266,4,6,549,"neutor",NA
"2/17/2015 16:00",341,332,4,6,673,"neutor",NA
"2/17/2015 17:00",345,459,4,6,804,"neutor",NA
"2/17/2015 18:00",307,351,4,6,658,"neutor",NA
"2/17/2015 19:00",263,269,4,2,532,"neutor",NA
"2/17/2015 20:00",186,195,3,4,381,"neutor",NA
"2/17/2015 21:00",102,138,2,2,240,"neutor",NA
"2/17/2015 22:00",91,175,-1,2,266,"neutor",NA
"2/17/2015 23:00",46,94,-1,2,140,"neutor",NA
"2/18/2015 0:00",18,43,-1,4,61,"neutor",NA
"2/18/2015 1:00",4,30,-1,4,34,"neutor",NA
"2/18/2015 2:00",2,8,-1,0,10,"neutor",NA
"2/18/2015 3:00",6,1,-1,7,7,"neutor",NA
"2/18/2015 4:00",2,4,-1,6,6,"neutor",NA
"2/18/2015 5:00",30,13,0,6,43,"neutor",NA
"2/18/2015 6:00",106,37,0,7,143,"neutor",NA
"2/18/2015 7:00",403,164,0,9,567,"neutor",NA
"2/18/2015 8:00",521,260,0,7,781,"neutor",NA
"2/18/2015 9:00",333,202,1,7,535,"neutor",NA
"2/18/2015 10:00",344,221,1,7,565,"neutor",NA
"2/18/2015 11:00",260,210,2,9,470,"neutor",NA
"2/18/2015 12:00",320,275,3,11,595,"neutor",NA
"2/18/2015 13:00",286,306,5,13,592,"neutor",NA
"2/18/2015 14:00",339,292,5,13,631,"neutor",NA
"2/18/2015 15:00",294,327,4,13,621,"neutor",NA
"2/18/2015 16:00",347,342,4,11,689,"neutor",NA
"2/18/2015 17:00",434,407,3,6,841,"neutor",NA
"2/18/2015 18:00",398,398,1,6,796,"neutor",NA
"2/18/2015 19:00",323,315,1,6,638,"neutor",NA
"2/18/2015 20:00",164,268,1,9,432,"neutor",NA
"2/18/2015 21:00",130,146,1,6,276,"neutor",NA
"2/18/2015 22:00",112,206,0,7,318,"neutor",NA
"2/18/2015 23:00",79,139,0,7,218,"neutor",NA
"2/19/2015 0:00",43,66,1,9,109,"neutor",NA
"2/19/2015 1:00",21,47,2,11,68,"neutor",NA
"2/19/2015 2:00",12,23,1,7,35,"neutor",NA
"2/19/2015 3:00",6,21,0,6,27,"neutor",NA
"2/19/2015 4:00",7,18,-1,7,25,"neutor",NA
"2/19/2015 5:00",33,28,1,13,61,"neutor",NA
"2/19/2015 6:00",102,32,1,9,134,"neutor",NA
"2/19/2015 7:00",405,174,1,11,579,"neutor",NA
"2/19/2015 8:00",488,279,2,17,767,"neutor",NA
"2/19/2015 9:00",376,224,2,17,600,"neutor",NA
"2/19/2015 10:00",281,211,3,19,492,"neutor",NA
"2/19/2015 11:00",261,195,3,13,456,"neutor",NA
"2/19/2015 12:00",292,245,3,19,537,"neutor",NA
"2/19/2015 13:00",315,289,3,20,604,"neutor",NA
"2/19/2015 14:00",308,292,3,17,600,"neutor",NA
"2/19/2015 15:00",322,291,4,15,613,"neutor",NA
"2/19/2015 16:00",357,340,4,15,697,"neutor",NA
"2/19/2015 17:00",417,442,3,11,859,"neutor",NA
"2/19/2015 18:00",374,394,3,13,768,"neutor",NA
"2/19/2015 19:00",284,310,2,15,594,"neutor",NA
"2/19/2015 20:00",188,223,1,15,411,"neutor",NA
"2/19/2015 21:00",96,143,2,15,239,"neutor",NA
"2/19/2015 22:00",92,176,2,19,268,"neutor",NA
"2/19/2015 23:00",60,111,2,19,171,"neutor",NA
"2/20/2015 0:00",26,73,2,19,99,"neutor",NA
"2/20/2015 1:00",14,41,2,19,55,"neutor",NA
"2/20/2015 2:00",7,18,2,15,25,"neutor",NA
"2/20/2015 3:00",8,4,2,17,12,"neutor",NA
"2/20/2015 4:00",3,8,3,17,11,"neutor",NA
"2/20/2015 5:00",23,10,3,19,33,"neutor",NA
"2/20/2015 6:00",96,30,3,19,126,"neutor",NA
"2/20/2015 7:00",355,160,4,17,515,"neutor",NA
"2/20/2015 8:00",410,227,5,20,637,"neutor",NA
"2/20/2015 9:00",305,187,5,20,492,"neutor",NA
"2/20/2015 10:00",273,159,6,20,432,"neutor",NA
"2/20/2015 11:00",230,211,6,20,441,"neutor",NA
"2/20/2015 12:00",269,231,7,20,500,"neutor",NA
"2/20/2015 13:00",271,285,7,22,556,"neutor",NA
"2/20/2015 14:00",242,305,6,17,547,"neutor",NA
"2/20/2015 15:00",282,263,6,13,545,"neutor",NA
"2/20/2015 16:00",260,254,6,13,514,"neutor",NA
"2/20/2015 17:00",199,240,6,11,439,"neutor",NA
"2/20/2015 18:00",194,277,6,11,471,"neutor",NA
"2/20/2015 19:00",187,165,6,11,352,"neutor",NA
"2/20/2015 20:00",187,127,6,11,314,"neutor",NA
"2/20/2015 21:00",96,110,6,11,206,"neutor",NA
"2/20/2015 22:00",67,115,6,11,182,"neutor",NA
"2/20/2015 23:00",64,110,6,13,174,"neutor",NA
"2/21/2015 0:00",34,88,6,15,122,"neutor",NA
"2/21/2015 1:00",39,83,6,13,122,"neutor",NA
"2/21/2015 2:00",20,54,6,11,74,"neutor",NA
"2/21/2015 3:00",20,46,6,13,66,"neutor",NA
"2/21/2015 4:00",7,20,6,13,27,"neutor",NA
"2/21/2015 5:00",12,22,6,17,34,"neutor",NA
"2/21/2015 6:00",21,14,6,19,35,"neutor",NA
"2/21/2015 7:00",41,14,3,26,55,"neutor",NA
"2/21/2015 8:00",84,30,2,22,114,"neutor",NA
"2/21/2015 9:00",221,76,3,17,297,"neutor",NA
"2/21/2015 10:00",263,97,4,19,360,"neutor",NA
"2/21/2015 11:00",253,97,5,19,350,"neutor",NA
"2/21/2015 12:00",295,133,5,22,428,"neutor",NA
"2/21/2015 13:00",190,198,4,11,388,"neutor",NA
"2/21/2015 14:00",219,176,5,19,395,"neutor",NA
"2/21/2015 15:00",146,153,3,24,299,"neutor",NA
"2/21/2015 16:00",124,205,4,17,329,"neutor",NA
"2/21/2015 17:00",137,202,4,13,339,"neutor",NA
"2/21/2015 18:00",181,186,3,7,367,"neutor",NA
"2/21/2015 19:00",163,137,3,13,300,"neutor",NA
"2/21/2015 20:00",156,169,1,9,325,"neutor",NA
"2/21/2015 21:00",104,106,0,6,210,"neutor",NA
"2/21/2015 22:00",87,80,0,6,167,"neutor",NA
"2/21/2015 23:00",70,104,-1,4,174,"neutor",NA
"2/22/2015 0:00",80,84,-1,4,164,"neutor",NA
"2/22/2015 1:00",47,86,-2,4,133,"neutor",NA
"2/22/2015 2:00",29,66,-2,4,95,"neutor",NA
"2/22/2015 3:00",19,70,-3,4,89,"neutor",NA
"2/22/2015 4:00",11,18,0,6,29,"neutor",NA
"2/22/2015 5:00",11,21,0,9,32,"neutor",NA
"2/22/2015 6:00",11,13,1,6,24,"neutor",NA
"2/22/2015 7:00",13,10,0,7,23,"neutor",NA
"2/22/2015 8:00",43,21,1,11,64,"neutor",NA
"2/22/2015 9:00",120,58,1,9,178,"neutor",NA
"2/22/2015 10:00",160,68,3,9,228,"neutor",NA
"2/22/2015 11:00",109,85,4,11,194,"neutor",NA
"2/22/2015 12:00",145,115,5,15,260,"neutor",NA
"2/22/2015 13:00",182,137,6,15,319,"neutor",NA
"2/22/2015 14:00",189,128,5,17,317,"neutor",NA
"2/22/2015 15:00",220,147,5,15,367,"neutor",NA
"2/22/2015 16:00",210,174,5,13,384,"neutor",NA
"2/22/2015 17:00",160,160,4,7,320,"neutor",NA
"2/22/2015 18:00",131,149,2,7,280,"neutor",NA
"2/22/2015 19:00",132,168,2,9,300,"neutor",NA
"2/22/2015 20:00",53,115,3,15,168,"neutor",NA
"2/22/2015 21:00",33,53,3,20,86,"neutor",NA
"2/22/2015 22:00",43,91,3,17,134,"neutor",NA
"2/22/2015 23:00",29,42,4,20,71,"neutor",NA
"2/23/2015 0:00",19,26,4,22,45,"neutor",NA
"2/23/2015 1:00",7,11,4,28,18,"neutor",NA
"2/23/2015 2:00",5,7,3,30,12,"neutor",NA
"2/23/2015 3:00",2,6,2,26,8,"neutor",NA
"2/23/2015 4:00",0,3,2,20,3,"neutor",NA
"2/23/2015 5:00",26,9,2,22,35,"neutor",NA
"2/23/2015 6:00",83,28,3,20,111,"neutor",NA
"2/23/2015 7:00",331,137,3,20,468,"neutor",NA
"2/23/2015 8:00",403,218,3,22,621,"neutor",NA
"2/23/2015 9:00",276,176,3,19,452,"neutor",NA
"2/23/2015 10:00",216,130,3,15,346,"neutor",NA
"2/23/2015 11:00",182,187,3,15,369,"neutor",NA
"2/23/2015 12:00",256,202,4,13,458,"neutor",NA
"2/23/2015 13:00",273,266,5,17,539,"neutor",NA
"2/23/2015 14:00",249,248,6,22,497,"neutor",NA
"2/23/2015 15:00",250,279,7,17,529,"neutor",NA
"2/23/2015 16:00",338,307,6,13,645,"neutor",NA
"2/23/2015 17:00",392,421,6,9,813,"neutor",NA
"2/23/2015 18:00",325,367,3,6,692,"neutor",NA
"2/23/2015 19:00",260,260,5,13,520,"neutor",NA
"2/23/2015 20:00",166,190,4,19,356,"neutor",NA
"2/23/2015 21:00",114,156,4,13,270,"neutor",NA
"2/23/2015 22:00",80,131,3,11,211,"neutor",NA
"2/23/2015 23:00",61,74,4,13,135,"neutor",NA
"2/24/2015 0:00",19,50,4,17,69,"neutor",NA
"2/24/2015 1:00",9,49,4,17,58,"neutor",NA
"2/24/2015 2:00",16,17,4,15,33,"neutor",NA
"2/24/2015 3:00",3,15,3,15,18,"neutor",NA
"2/24/2015 4:00",4,6,3,17,10,"neutor",NA
"2/24/2015 5:00",27,12,3,19,39,"neutor",NA
"2/24/2015 6:00",90,38,3,20,128,"neutor",NA
"2/24/2015 7:00",369,173,3,22,542,"neutor",NA
"2/24/2015 8:00",502,248,4,22,750,"neutor",NA
"2/24/2015 9:00",328,171,4,22,499,"neutor",NA
"2/24/2015 10:00",266,232,5,24,498,"neutor",NA
"2/24/2015 11:00",215,192,6,24,407,"neutor",NA
"2/24/2015 12:00",252,242,6,19,494,"neutor",NA
"2/24/2015 13:00",270,303,7,19,573,"neutor",NA
"2/24/2015 14:00",269,274,6,19,543,"neutor",NA
"2/24/2015 15:00",265,291,7,20,556,"neutor",NA
"2/24/2015 16:00",327,334,5,17,661,"neutor",NA
"2/24/2015 17:00",372,406,6,11,778,"neutor",NA
"2/24/2015 18:00",358,408,5,13,766,"neutor",NA
"2/24/2015 19:00",318,281,5,15,599,"neutor",NA
"2/24/2015 20:00",216,232,4,15,448,"neutor",NA
"2/24/2015 21:00",134,130,4,9,264,"neutor",NA
"2/24/2015 22:00",110,208,4,9,318,"neutor",NA
"2/24/2015 23:00",57,120,3,4,177,"neutor",NA
"2/25/2015 0:00",38,47,4,13,85,"neutor",NA
"2/25/2015 1:00",16,50,3,7,66,"neutor",NA
"2/25/2015 2:00",5,15,3,15,20,"neutor",NA
"2/25/2015 3:00",7,9,3,13,16,"neutor",NA
"2/25/2015 4:00",7,15,2,9,22,"neutor",NA
"2/25/2015 5:00",29,12,2,9,41,"neutor",NA
"2/25/2015 6:00",90,27,1,9,117,"neutor",NA
"2/25/2015 7:00",386,172,1,7,558,"neutor",NA
"2/25/2015 8:00",451,252,2,11,703,"neutor",NA
"2/25/2015 9:00",400,238,4,15,638,"neutor",NA
"2/25/2015 10:00",292,192,5,15,484,"neutor",NA
"2/25/2015 11:00",291,198,6,13,489,"neutor",NA
"2/25/2015 12:00",314,243,6,17,557,"neutor",NA
"2/25/2015 13:00",286,304,7,13,590,"neutor",NA
"2/25/2015 14:00",293,289,8,13,582,"neutor",NA
"2/25/2015 15:00",310,313,8,13,623,"neutor",NA
"2/25/2015 16:00",319,333,8,15,652,"neutor",NA
"2/25/2015 17:00",426,399,6,19,825,"neutor",NA
"2/25/2015 18:00",359,379,6,13,738,"neutor",NA
"2/25/2015 19:00",322,299,5,7,621,"neutor",NA
"2/25/2015 20:00",227,239,5,6,466,"neutor",NA
"2/25/2015 21:00",157,139,5,9,296,"neutor",NA
"2/25/2015 22:00",124,180,5,9,304,"neutor",NA
"2/25/2015 23:00",114,106,5,7,220,"neutor",NA
"2/26/2015 0:00",57,92,5,6,149,"neutor",NA
"2/26/2015 1:00",17,70,5,6,87,"neutor",NA
"2/26/2015 2:00",7,53,5,7,60,"neutor",NA
"2/26/2015 3:00",22,52,5,6,74,"neutor",NA
"2/26/2015 4:00",12,55,4,4,67,"neutor",NA
"2/26/2015 5:00",29,29,4,7,58,"neutor",NA
"2/26/2015 6:00",109,45,4,9,154,"neutor",NA
"2/26/2015 7:00",406,182,3,9,588,"neutor",NA
"2/26/2015 8:00",468,259,4,11,727,"neutor",NA
"2/26/2015 9:00",357,230,5,13,587,"neutor",NA
"2/26/2015 10:00",260,187,7,13,447,"neutor",NA
"2/26/2015 11:00",246,196,8,15,442,"neutor",NA
"2/26/2015 12:00",273,221,9,19,494,"neutor",NA
"2/26/2015 13:00",293,265,9,22,558,"neutor",NA
"2/26/2015 14:00",330,301,9,19,631,"neutor",NA
"2/26/2015 15:00",372,342,9,20,714,"neutor",NA
"2/26/2015 16:00",359,380,9,17,739,"neutor",NA
"2/26/2015 17:00",375,452,9,15,827,"neutor",NA
"2/26/2015 18:00",347,401,8,19,748,"neutor",NA
"2/26/2015 19:00",283,318,8,15,601,"neutor",NA
"2/26/2015 20:00",194,216,8,17,410,"neutor",NA
"2/26/2015 21:00",104,153,6,15,257,"neutor",NA
"2/26/2015 22:00",99,164,6,13,263,"neutor",NA
"2/26/2015 23:00",114,111,6,11,225,"neutor",NA
"2/27/2015 0:00",46,55,6,9,101,"neutor",NA
"2/27/2015 1:00",25,26,6,6,51,"neutor",NA
"2/27/2015 2:00",7,43,6,4,50,"neutor",NA
"2/27/2015 3:00",9,29,6,4,38,"neutor",NA
"2/27/2015 4:00",8,36,6,4,44,"neutor",NA
"2/27/2015 5:00",19,25,5,13,44,"neutor",NA
"2/27/2015 6:00",73,26,5,20,99,"neutor",NA
"2/27/2015 7:00",284,126,4,15,410,"neutor",NA
"2/27/2015 8:00",337,186,5,13,523,"neutor",NA
"2/27/2015 9:00",286,168,5,17,454,"neutor",NA
"2/27/2015 10:00",246,144,6,13,390,"neutor",NA
"2/27/2015 11:00",240,161,6,17,401,"neutor",NA
"2/27/2015 12:00",294,209,6,15,503,"neutor",NA
"2/27/2015 13:00",277,286,7,15,563,"neutor",NA
"2/27/2015 14:00",301,256,7,20,557,"neutor",NA
"2/27/2015 15:00",295,247,7,13,542,"neutor",NA
"2/27/2015 16:00",288,266,7,13,554,"neutor",NA
"2/27/2015 17:00",273,229,5,9,502,"neutor",NA
"2/27/2015 18:00",252,259,4,4,511,"neutor",NA
"2/27/2015 19:00",241,219,2,6,460,"neutor",NA
"2/27/2015 20:00",211,165,3,7,376,"neutor",NA
"2/27/2015 21:00",137,135,2,7,272,"neutor",NA
"2/27/2015 22:00",93,158,1,6,251,"neutor",NA
"2/27/2015 23:00",89,118,0,4,207,"neutor",NA
"2/28/2015 0:00",74,98,0,6,172,"neutor",NA
"2/28/2015 1:00",41,76,0,2,117,"neutor",NA
"2/28/2015 2:00",30,86,-1,4,116,"neutor",NA
"2/28/2015 3:00",19,66,-2,4,85,"neutor",NA
"2/28/2015 4:00",6,39,-2,7,45,"neutor",NA
"2/28/2015 5:00",21,14,-2,6,35,"neutor",NA
"2/28/2015 6:00",33,16,-1,7,49,"neutor",NA
"2/28/2015 7:00",49,12,-1,9,61,"neutor",NA
"2/28/2015 8:00",110,53,1,11,163,"neutor",NA
"2/28/2015 9:00",207,80,3,13,287,"neutor",NA
"2/28/2015 10:00",291,91,4,15,382,"neutor",NA
"2/28/2015 11:00",268,141,6,20,409,"neutor",NA
"2/28/2015 12:00",299,179,6,20,478,"neutor",NA
"2/28/2015 13:00",284,191,7,22,475,"neutor",NA
"2/28/2015 14:00",253,215,8,17,468,"neutor",NA
"2/28/2015 15:00",240,238,8,17,478,"neutor",NA
"2/28/2015 16:00",191,183,8,20,374,"neutor",NA
"2/28/2015 17:00",178,248,7,15,426,"neutor",NA
"2/28/2015 18:00",155,248,6,15,403,"neutor",NA
"2/28/2015 19:00",183,175,5,17,358,"neutor",NA
"2/28/2015 20:00",140,144,5,17,284,"neutor",NA
"2/28/2015 21:00",144,92,5,15,236,"neutor",NA
"2/28/2015 22:00",89,93,6,17,182,"neutor",NA
"2/28/2015 23:00",70,88,6,17,158,"neutor",NA
"3/1/2015 0:00",58,96,6,17,154,"neutor",NA
"3/1/2015 1:00",72,81,6,20,153,"neutor",NA
"3/1/2015 2:00",41,65,6,20,106,"neutor",NA
"3/1/2015 3:00",13,65,5,19,78,"neutor",NA
"3/1/2015 4:00",5,43,5,19,48,"neutor",NA
"3/1/2015 5:00",10,20,5,22,30,"neutor",NA
"3/1/2015 6:00",12,17,5,22,29,"neutor",NA
"3/1/2015 7:00",20,11,6,20,31,"neutor",NA
"3/1/2015 8:00",37,15,7,20,52,"neutor",NA
"3/1/2015 9:00",69,34,7,22,103,"neutor",NA
"3/1/2015 10:00",98,50,9,24,148,"neutor",NA
"3/1/2015 11:00",92,65,9,32,157,"neutor",NA
"3/1/2015 12:00",100,86,9,30,186,"neutor",NA
"3/1/2015 13:00",97,74,9,32,171,"neutor",NA
"3/1/2015 14:00",105,63,10,37,168,"neutor",NA
"3/1/2015 15:00",108,82,10,28,190,"neutor",NA
"3/1/2015 16:00",135,81,10,26,216,"neutor",NA
"3/1/2015 17:00",114,124,9,20,238,"neutor",NA
"3/1/2015 18:00",105,110,8,13,215,"neutor",NA
"3/1/2015 19:00",105,134,8,13,239,"neutor",NA
"3/1/2015 20:00",57,117,7,11,174,"neutor",NA
"3/1/2015 21:00",36,73,7,15,109,"neutor",NA
"3/1/2015 22:00",62,62,7,13,124,"neutor",NA
"3/1/2015 23:00",15,40,7,20,55,"neutor",NA
"3/2/2015 0:00",15,17,6,15,32,"neutor",NA
"3/2/2015 1:00",3,8,6,33,11,"neutor",NA
"3/2/2015 2:00",4,10,6,28,14,"neutor",NA
"3/2/2015 3:00",4,3,6,28,7,"neutor",NA
"3/2/2015 4:00",3,5,5,32,8,"neutor",NA
"3/2/2015 5:00",24,12,5,30,36,"neutor",NA
"3/2/2015 6:00",91,27,4,30,118,"neutor",NA
"3/2/2015 7:00",375,170,4,24,545,"neutor",NA
"3/2/2015 8:00",383,248,4,28,631,"neutor",NA
"3/2/2015 9:00",281,197,5,32,478,"neutor",NA
"3/2/2015 10:00",241,164,6,37,405,"neutor",NA
"3/2/2015 11:00",260,194,7,35,454,"neutor",NA
"3/2/2015 12:00",294,199,8,35,493,"neutor",NA
"3/2/2015 13:00",275,245,8,28,520,"neutor",NA
"3/2/2015 14:00",239,263,9,37,502,"neutor",NA
"3/2/2015 15:00",262,308,8,30,570,"neutor",NA
"3/2/2015 16:00",302,306,5,41,608,"neutor",NA
"3/2/2015 17:00",277,355,3,19,632,"neutor",NA
"3/2/2015 18:00",288,364,3,19,652,"neutor",NA
"3/2/2015 19:00",205,239,3,17,444,"neutor",NA
"3/2/2015 20:00",151,145,2,20,296,"neutor",NA
"3/2/2015 21:00",76,138,2,15,214,"neutor",NA
"3/2/2015 22:00",52,94,3,26,146,"neutor",NA
"3/2/2015 23:00",37,50,3,28,87,"neutor",NA
"3/3/2015 0:00",25,24,3,24,49,"neutor",NA
"3/3/2015 1:00",6,23,3,19,29,"neutor",NA
"3/3/2015 2:00",10,4,3,20,14,"neutor",NA
"3/3/2015 3:00",1,2,3,20,3,"neutor",NA
"3/3/2015 4:00",6,7,2,17,13,"neutor",NA
"3/3/2015 5:00",25,12,2,17,37,"neutor",NA
"3/3/2015 6:00",94,35,3,17,129,"neutor",NA
"3/3/2015 7:00",393,178,3,15,571,"neutor",NA
"3/3/2015 8:00",406,266,3,19,672,"neutor",NA
"3/3/2015 9:00",333,208,5,20,541,"neutor",NA
"3/3/2015 10:00",227,151,5,20,378,"neutor",NA
"3/3/2015 11:00",222,172,6,19,394,"neutor",NA
"3/3/2015 12:00",219,200,5,26,419,"neutor",NA
"3/3/2015 13:00",244,222,5,19,466,"neutor",NA
"3/3/2015 14:00",171,230,4,26,401,"neutor",NA
"3/3/2015 15:00",191,230,5,15,421,"neutor",NA
"3/3/2015 16:00",281,255,6,20,536,"neutor",NA
"3/3/2015 17:00",289,311,6,19,600,"neutor",NA
"3/3/2015 18:00",284,322,4,19,606,"neutor",NA
"3/3/2015 19:00",258,212,3,13,470,"neutor",NA
"3/3/2015 20:00",174,203,2,9,377,"neutor",NA
"3/3/2015 21:00",87,110,2,7,197,"neutor",NA
"3/3/2015 22:00",108,169,3,7,277,"neutor",NA
"3/3/2015 23:00",46,69,3,7,115,"neutor",NA
"3/4/2015 0:00",8,49,1,9,57,"neutor",NA
"3/4/2015 1:00",11,20,1,11,31,"neutor",NA
"3/4/2015 2:00",8,14,1,9,22,"neutor",NA
"3/4/2015 3:00",4,5,2,11,9,"neutor",NA
"3/4/2015 4:00",5,6,2,15,11,"neutor",NA
"3/4/2015 5:00",25,13,2,17,38,"neutor",NA
"3/4/2015 6:00",104,39,2,22,143,"neutor",NA
"3/4/2015 7:00",388,181,2,19,569,"neutor",NA
"3/4/2015 8:00",391,242,3,19,633,"neutor",NA
"3/4/2015 9:00",335,188,4,20,523,"neutor",NA
"3/4/2015 10:00",258,157,4,26,415,"neutor",NA
"3/4/2015 11:00",257,181,5,24,438,"neutor",NA
"3/4/2015 12:00",260,221,6,20,481,"neutor",NA
"3/4/2015 13:00",240,232,6,33,472,"neutor",NA
"3/4/2015 14:00",246,246,6,26,492,"neutor",NA
"3/4/2015 15:00",235,297,6,20,532,"neutor",NA
"3/4/2015 16:00",302,325,6,33,627,"neutor",NA
"3/4/2015 17:00",335,343,4,28,678,"neutor",NA
"3/4/2015 18:00",327,370,4,24,697,"neutor",NA
"3/4/2015 19:00",308,292,4,22,600,"neutor",NA
"3/4/2015 20:00",136,207,5,19,343,"neutor",NA
"3/4/2015 21:00",116,138,5,20,254,"neutor",NA
"3/4/2015 22:00",128,145,5,17,273,"neutor",NA
"3/4/2015 23:00",88,95,4,17,183,"neutor",NA
"3/5/2015 0:00",30,45,4,15,75,"neutor",NA
"3/5/2015 1:00",23,43,4,9,66,"neutor",NA
"3/5/2015 2:00",11,29,3,11,40,"neutor",NA
"3/5/2015 3:00",9,22,2,9,31,"neutor",NA
"3/5/2015 4:00",9,17,1,11,26,"neutor",NA
"3/5/2015 5:00",36,25,2,9,61,"neutor",NA
"3/5/2015 6:00",103,39,3,9,142,"neutor",NA
"3/5/2015 7:00",389,174,3,9,563,"neutor",NA
"3/5/2015 8:00",405,216,4,13,621,"neutor",NA
"3/5/2015 9:00",313,216,4,11,529,"neutor",NA
"3/5/2015 10:00",276,176,5,13,452,"neutor",NA
"3/5/2015 11:00",232,163,5,11,395,"neutor",NA
"3/5/2015 12:00",285,209,8,13,494,"neutor",NA
"3/5/2015 13:00",299,258,9,17,557,"neutor",NA
"3/5/2015 14:00",289,284,8,19,573,"neutor",NA
"3/5/2015 15:00",332,302,8,17,634,"neutor",NA
"3/5/2015 16:00",369,334,8,11,703,"neutor",NA
"3/5/2015 17:00",390,400,7,11,790,"neutor",NA
"3/5/2015 18:00",326,375,6,9,701,"neutor",NA
"3/5/2015 19:00",260,298,5,6,558,"neutor",NA
"3/5/2015 20:00",210,195,3,4,405,"neutor",NA
"3/5/2015 21:00",129,142,2,2,271,"neutor",NA
"3/5/2015 22:00",104,142,2,6,246,"neutor",NA
"3/5/2015 23:00",55,135,2,6,190,"neutor",NA
"3/6/2015 0:00",16,51,1,4,67,"neutor",NA
"3/6/2015 1:00",12,36,4,7,48,"neutor",NA
"3/6/2015 2:00",6,18,4,4,24,"neutor",NA
"3/6/2015 3:00",6,8,4,4,14,"neutor",NA
"3/6/2015 4:00",5,9,5,6,14,"neutor",NA
"3/6/2015 5:00",26,11,5,7,37,"neutor",NA
"3/6/2015 6:00",107,40,5,7,147,"neutor",NA
"3/6/2015 7:00",368,166,4,6,534,"neutor",NA
"3/6/2015 8:00",386,209,5,7,595,"neutor",NA
"3/6/2015 9:00",334,186,5,7,520,"neutor",NA
"3/6/2015 10:00",254,176,5,9,430,"neutor",NA
"3/6/2015 11:00",238,180,6,9,418,"neutor",NA
"3/6/2015 12:00",265,236,7,11,501,"neutor",NA
"3/6/2015 13:00",290,281,7,15,571,"neutor",NA
"3/6/2015 14:00",305,277,8,17,582,"neutor",NA
"3/6/2015 15:00",310,286,8,13,596,"neutor",NA
"3/6/2015 16:00",300,266,8,9,566,"neutor",NA
"3/6/2015 17:00",334,284,8,13,618,"neutor",NA
"3/6/2015 18:00",293,302,7,7,595,"neutor",NA
"3/6/2015 19:00",286,224,7,7,510,"neutor",NA
"3/6/2015 20:00",212,140,7,9,352,"neutor",NA
"3/6/2015 21:00",163,172,5,7,335,"neutor",NA
"3/6/2015 22:00",90,106,3,6,196,"neutor",NA
"3/6/2015 23:00",63,159,4,7,222,"neutor",NA
"3/7/2015 0:00",58,97,3,7,155,"neutor",NA
"3/7/2015 1:00",29,99,3,7,128,"neutor",NA
"3/7/2015 2:00",22,76,3,9,98,"neutor",NA
"3/7/2015 3:00",28,63,3,11,91,"neutor",NA
"3/7/2015 4:00",12,43,3,11,55,"neutor",NA
"3/7/2015 5:00",14,26,3,9,40,"neutor",NA
"3/7/2015 6:00",24,22,3,9,46,"neutor",NA
"3/7/2015 7:00",58,20,4,11,78,"neutor",NA
"3/7/2015 8:00",108,30,5,13,138,"neutor",NA
"3/7/2015 9:00",205,79,6,11,284,"neutor",NA
"3/7/2015 10:00",303,91,8,17,394,"neutor",NA
"3/7/2015 11:00",261,125,9,17,386,"neutor",NA
"3/7/2015 12:00",367,200,12,17,567,"neutor",NA
"3/7/2015 13:00",325,195,13,19,520,"neutor",NA
"3/7/2015 14:00",305,291,14,19,596,"neutor",NA
"3/7/2015 15:00",218,228,14,15,446,"neutor",NA
"3/7/2015 16:00",225,249,15,17,474,"neutor",NA
"3/7/2015 17:00",183,260,14,13,443,"neutor",NA
"3/7/2015 18:00",212,269,12,11,481,"neutor",NA
"3/7/2015 19:00",209,176,10,9,385,"neutor",NA
"3/7/2015 20:00",167,162,10,11,329,"neutor",NA
"3/7/2015 21:00",145,98,9,9,243,"neutor",NA
"3/7/2015 22:00",81,94,9,13,175,"neutor",NA
"3/7/2015 23:00",111,155,8,13,266,"neutor",NA
"3/8/2015 0:00",68,101,7,6,169,"neutor",NA
"3/8/2015 1:00",59,102,5,7,161,"neutor",NA
"3/8/2015 2:00",33,71,3,7,104,"neutor",NA
"3/8/2015 3:00",18,77,2,6,95,"neutor",NA
"3/8/2015 4:00",14,39,2,7,53,"neutor",NA
"3/8/2015 5:00",16,22,1,6,38,"neutor",NA
"3/8/2015 6:00",23,13,3,7,36,"neutor",NA
"3/8/2015 7:00",29,14,2,6,43,"neutor",NA
"3/8/2015 8:00",40,18,6,9,58,"neutor",NA
"3/8/2015 9:00",129,41,10,13,170,"neutor",NA
"3/8/2015 10:00",207,122,12,11,329,"neutor",NA
"3/8/2015 11:00",206,126,14,13,332,"neutor",NA
"3/8/2015 12:00",247,177,16,13,424,"neutor",NA
"3/8/2015 13:00",306,190,17,19,496,"neutor",NA
"3/8/2015 14:00",416,243,18,19,659,"neutor",NA
"3/8/2015 15:00",382,279,18,17,661,"neutor",NA
"3/8/2015 16:00",261,312,17,11,573,"neutor",NA
"3/8/2015 17:00",253,289,16,9,542,"neutor",NA
"3/8/2015 18:00",196,299,12,7,495,"neutor",NA
"3/8/2015 19:00",129,189,10,4,318,"neutor",NA
"3/8/2015 20:00",71,145,8,2,216,"neutor",NA
"3/8/2015 21:00",48,81,9,13,129,"neutor",NA
"3/8/2015 22:00",52,93,7,7,145,"neutor",NA
"3/8/2015 23:00",18,42,6,6,60,"neutor",NA
"3/9/2015 0:00",12,24,5,2,36,"neutor",NA
"3/9/2015 1:00",5,15,6,4,20,"neutor",NA
"3/9/2015 2:00",2,4,6,2,6,"neutor",NA
"3/9/2015 3:00",5,2,6,4,7,"neutor",NA
"3/9/2015 4:00",4,6,7,4,10,"neutor",NA
"3/9/2015 5:00",32,11,7,4,43,"neutor",NA
"3/9/2015 6:00",103,35,7,6,138,"neutor",NA
"3/9/2015 7:00",436,180,7,7,616,"neutor",NA
"3/9/2015 8:00",408,274,8,6,682,"neutor",NA
"3/9/2015 9:00",330,187,9,4,517,"neutor",NA
"3/9/2015 10:00",267,174,10,6,441,"neutor",NA
"3/9/2015 11:00",234,182,11,9,416,"neutor",NA
"3/9/2015 12:00",308,227,10,6,535,"neutor",NA
"3/9/2015 13:00",270,269,11,7,539,"neutor",NA
"3/9/2015 14:00",279,265,11,6,544,"neutor",NA
"3/9/2015 15:00",360,302,12,6,662,"neutor",NA
"3/9/2015 16:00",373,401,11,4,774,"neutor",NA
"3/9/2015 17:00",451,489,10,6,940,"neutor",NA
"3/9/2015 18:00",377,434,8,4,811,"neutor",NA
"3/9/2015 19:00",309,324,6,2,633,"neutor",NA
"3/9/2015 20:00",181,199,4,4,380,"neutor",NA
"3/9/2015 21:00",126,148,4,4,274,"neutor",NA
"3/9/2015 22:00",72,159,4,2,231,"neutor",NA
"3/9/2015 23:00",52,95,6,6,147,"neutor",NA
"3/10/2015 0:00",17,77,5,4,94,"neutor",NA
"3/10/2015 1:00",4,30,5,4,34,"neutor",NA
"3/10/2015 2:00",3,8,5,4,11,"neutor",NA
"3/10/2015 3:00",1,0,7,6,1,"neutor",NA
"3/10/2015 4:00",3,6,7,6,9,"neutor",NA
"3/10/2015 5:00",24,10,8,7,34,"neutor",NA
"3/10/2015 6:00",93,36,8,9,129,"neutor",NA
"3/10/2015 7:00",434,148,8,11,582,"neutor",NA
"3/10/2015 8:00",431,269,8,9,700,"neutor",NA
"3/10/2015 9:00",328,199,9,9,527,"neutor",NA
"3/10/2015 10:00",259,176,10,13,435,"neutor",NA
"3/10/2015 11:00",263,154,11,15,417,"neutor",NA
"3/10/2015 12:00",301,256,11,13,557,"neutor",NA
"3/10/2015 13:00",323,271,12,15,594,"neutor",NA
"3/10/2015 14:00",300,318,12,19,618,"neutor",NA
"3/10/2015 15:00",350,284,12,13,634,"neutor",NA
"3/10/2015 16:00",378,400,11,15,778,"neutor",NA
"3/10/2015 17:00",386,513,10,7,899,"neutor",NA
"3/10/2015 18:00",355,481,8,7,836,"neutor",NA
"3/10/2015 19:00",338,366,6,9,704,"neutor",NA
"3/10/2015 20:00",225,264,6,11,489,"neutor",NA
"3/10/2015 21:00",133,156,4,9,289,"neutor",NA
"3/10/2015 22:00",130,218,3,7,348,"neutor",NA
"3/10/2015 23:00",46,124,2,4,170,"neutor",NA
"3/11/2015 0:00",34,54,0,6,88,"neutor",NA
"3/11/2015 1:00",19,32,0,6,51,"neutor",NA
"3/11/2015 2:00",17,14,-1,6,31,"neutor",NA
"3/11/2015 3:00",10,2,1,4,12,"neutor",NA
"3/11/2015 4:00",6,10,2,6,16,"neutor",NA
"3/11/2015 5:00",42,11,1,6,53,"neutor",NA
"3/11/2015 6:00",134,33,1,6,167,"neutor",NA
"3/11/2015 7:00",454,189,1,2,643,"neutor",NA
"3/11/2015 8:00",501,280,2,6,781,"neutor",NA
"3/11/2015 9:00",402,235,2,2,637,"neutor",NA
"3/11/2015 10:00",304,202,3,4,506,"neutor",NA
"3/11/2015 11:00",317,185,4,6,502,"neutor",NA
"3/11/2015 12:00",316,251,6,6,567,"neutor",NA
"3/11/2015 13:00",325,304,8,7,629,"neutor",NA
"3/11/2015 14:00",350,311,8,7,661,"neutor",NA
"3/11/2015 15:00",362,391,9,7,753,"neutor",NA
"3/11/2015 16:00",438,400,9,4,838,"neutor",NA
"3/11/2015 17:00",493,487,8,6,980,"neutor",NA
"3/11/2015 18:00",395,459,5,6,854,"neutor",NA
"3/11/2015 19:00",358,374,3,4,732,"neutor",NA
"3/11/2015 20:00",249,280,2,2,529,"neutor",NA
"3/11/2015 21:00",140,163,1,2,303,"neutor",NA
"3/11/2015 22:00",131,192,0,6,323,"neutor",NA
"3/11/2015 23:00",95,123,-1,4,218,"neutor",NA
"3/12/2015 0:00",73,85,0,7,158,"neutor",NA
"3/12/2015 1:00",31,65,0,2,96,"neutor",NA
"3/12/2015 2:00",12,40,0,2,52,"neutor",NA
"3/12/2015 3:00",8,23,-1,2,31,"neutor",NA
"3/12/2015 4:00",7,33,-2,2,40,"neutor",NA
"3/12/2015 5:00",35,31,-3,2,66,"neutor",NA
"3/12/2015 6:00",104,37,-3,4,141,"neutor",NA
"3/12/2015 7:00",443,175,-2,2,618,"neutor",NA
"3/12/2015 8:00",452,287,2,4,739,"neutor",NA
"3/12/2015 9:00",385,245,6,4,630,"neutor",NA
"3/12/2015 10:00",271,185,8,7,456,"neutor",NA
"3/12/2015 11:00",317,203,10,4,520,"neutor",NA
"3/12/2015 12:00",312,265,11,9,577,"neutor",NA
"3/12/2015 13:00",352,317,11,19,669,"neutor",NA
"3/12/2015 14:00",339,339,11,19,678,"neutor",NA
"3/12/2015 15:00",407,382,11,15,789,"neutor",NA
"3/12/2015 16:00",430,385,10,15,815,"neutor",NA
"3/12/2015 17:00",455,516,8,20,971,"neutor",NA
"3/12/2015 18:00",377,454,7,17,831,"neutor",NA
"3/12/2015 19:00",309,325,6,13,634,"neutor",NA
"3/12/2015 20:00",194,234,5,11,428,"neutor",NA
"3/12/2015 21:00",150,173,4,15,323,"neutor",NA
"3/12/2015 22:00",115,185,3,11,300,"neutor",NA
"3/12/2015 23:00",61,103,3,13,164,"neutor",NA
"3/13/2015 0:00",32,76,3,13,108,"neutor",NA
"3/13/2015 1:00",15,43,2,11,58,"neutor",NA
"3/13/2015 2:00",9,23,2,11,32,"neutor",NA
"3/13/2015 3:00",2,12,2,13,14,"neutor",NA
"3/13/2015 4:00",6,12,1,11,18,"neutor",NA
"3/13/2015 5:00",35,15,0,11,50,"neutor",NA
"3/13/2015 6:00",111,36,-1,7,147,"neutor",NA
"3/13/2015 7:00",389,177,1,7,566,"neutor",NA
"3/13/2015 8:00",407,230,3,17,637,"neutor",NA
"3/13/2015 9:00",317,220,5,13,537,"neutor",NA
"3/13/2015 10:00",277,150,5,17,427,"neutor",NA
"3/13/2015 11:00",232,182,6,17,414,"neutor",NA
"3/13/2015 12:00",321,250,6,17,571,"neutor",NA
"3/13/2015 13:00",302,310,7,15,612,"neutor",NA
"3/13/2015 14:00",337,333,8,17,670,"neutor",NA
"3/13/2015 15:00",401,328,7,24,729,"neutor",NA
"3/13/2015 16:00",318,305,8,20,623,"neutor",NA
"3/13/2015 17:00",337,322,6,20,659,"neutor",NA
"3/13/2015 18:00",284,338,5,17,622,"neutor",NA
"3/13/2015 19:00",269,254,4,15,523,"neutor",NA
"3/13/2015 20:00",217,172,4,15,389,"neutor",NA
"3/13/2015 21:00",148,139,3,13,287,"neutor",NA
"3/13/2015 22:00",101,134,2,11,235,"neutor",NA
"3/13/2015 23:00",79,120,1,7,199,"neutor",NA
"3/14/2015 0:00",88,99,1,9,187,"neutor",NA
"3/14/2015 1:00",52,81,2,4,133,"neutor",NA
"3/14/2015 2:00",24,83,4,15,107,"neutor",NA
"3/14/2015 3:00",20,54,4,15,74,"neutor",NA
"3/14/2015 4:00",10,40,3,15,50,"neutor",NA
"3/14/2015 5:00",22,25,3,13,47,"neutor",NA
"3/14/2015 6:00",43,11,3,13,54,"neutor",NA
"3/14/2015 7:00",58,19,2,19,77,"neutor",NA
"3/14/2015 8:00",98,52,3,17,150,"neutor",NA
"3/14/2015 9:00",242,64,3,17,306,"neutor",NA
"3/14/2015 10:00",259,94,3,19,353,"neutor",NA
"3/14/2015 11:00",240,129,4,15,369,"neutor",NA
"3/14/2015 12:00",263,158,4,17,421,"neutor",NA
"3/14/2015 13:00",242,216,4,13,458,"neutor",NA
"3/14/2015 14:00",204,215,4,17,419,"neutor",NA
"3/14/2015 15:00",119,185,4,11,304,"neutor",NA
"3/14/2015 16:00",105,117,4,7,222,"neutor",NA
"3/14/2015 17:00",108,172,5,13,280,"neutor",NA
"3/14/2015 18:00",139,189,5,13,328,"neutor",NA
"3/14/2015 19:00",138,138,5,17,276,"neutor",NA
"3/14/2015 20:00",167,137,5,13,304,"neutor",NA
"3/14/2015 21:00",136,85,5,15,221,"neutor",NA
"3/14/2015 22:00",89,68,5,13,157,"neutor",NA
"3/14/2015 23:00",68,84,5,11,152,"neutor",NA
"3/15/2015 0:00",70,60,5,13,130,"neutor",NA
"3/15/2015 1:00",41,72,5,15,113,"neutor",NA
"3/15/2015 2:00",20,70,5,13,90,"neutor",NA
"3/15/2015 3:00",14,58,5,11,72,"neutor",NA
"3/15/2015 4:00",8,22,5,15,30,"neutor",NA
"3/15/2015 5:00",19,32,4,17,51,"neutor",NA
"3/15/2015 6:00",14,10,4,15,24,"neutor",NA
"3/15/2015 7:00",25,10,4,15,35,"neutor",NA
"3/15/2015 8:00",35,17,5,20,52,"neutor",NA
"3/15/2015 9:00",102,34,4,20,136,"neutor",NA
"3/15/2015 10:00",121,55,5,19,176,"neutor",NA
"3/15/2015 11:00",112,87,5,19,199,"neutor",NA
"3/15/2015 12:00",124,84,6,22,208,"neutor",NA
"3/15/2015 13:00",120,104,7,22,224,"neutor",NA
"3/15/2015 14:00",138,140,7,26,278,"neutor",NA
"3/15/2015 15:00",114,124,7,22,238,"neutor",NA
"3/15/2015 16:00",111,137,7,26,248,"neutor",NA
"3/15/2015 17:00",165,123,6,26,288,"neutor",NA
"3/15/2015 18:00",109,151,6,20,260,"neutor",NA
"3/15/2015 19:00",114,132,5,17,246,"neutor",NA
"3/15/2015 20:00",78,106,5,17,184,"neutor",NA
"3/15/2015 21:00",42,66,6,17,108,"neutor",NA
"3/15/2015 22:00",41,69,6,15,110,"neutor",NA
"3/15/2015 23:00",25,38,5,15,63,"neutor",NA
"3/16/2015 0:00",13,28,6,17,41,"neutor",NA
"3/16/2015 1:00",9,12,6,13,21,"neutor",NA
"3/16/2015 2:00",3,6,5,9,9,"neutor",NA
"3/16/2015 3:00",4,7,5,13,11,"neutor",NA
"3/16/2015 4:00",4,2,4,13,6,"neutor",NA
"3/16/2015 5:00",30,12,4,9,42,"neutor",NA
"3/16/2015 6:00",118,45,4,11,163,"neutor",NA
"3/16/2015 7:00",449,183,5,13,632,"neutor",NA
"3/16/2015 8:00",425,328,7,19,753,"neutor",NA
"3/16/2015 9:00",326,215,8,19,541,"neutor",NA
"3/16/2015 10:00",272,200,9,22,472,"neutor",NA
"3/16/2015 11:00",274,212,11,22,486,"neutor",NA
"3/16/2015 12:00",364,276,12,19,640,"neutor",NA
"3/16/2015 13:00",293,315,12,19,608,"neutor",NA
"3/16/2015 14:00",310,314,12,19,624,"neutor",NA
"3/16/2015 15:00",399,360,12,22,759,"neutor",NA
"3/16/2015 16:00",450,428,11,20,878,"neutor",NA
"3/16/2015 17:00",492,480,11,11,972,"neutor",NA
"3/16/2015 18:00",398,498,10,9,896,"neutor",NA
"3/16/2015 19:00",316,317,9,7,633,"neutor",NA
"3/16/2015 20:00",201,235,8,9,436,"neutor",NA
"3/16/2015 21:00",138,141,8,11,279,"neutor",NA
"3/16/2015 22:00",88,173,8,9,261,"neutor",NA
"3/16/2015 23:00",39,102,7,7,141,"neutor",NA
"3/17/2015 0:00",20,62,7,7,82,"neutor",NA
"3/17/2015 1:00",10,33,4,7,43,"neutor",NA
"3/17/2015 2:00",5,14,3,2,19,"neutor",NA
"3/17/2015 3:00",3,5,2,6,8,"neutor",NA
"3/17/2015 4:00",3,4,2,4,7,"neutor",NA
"3/17/2015 5:00",29,15,1,4,44,"neutor",NA
"3/17/2015 6:00",135,40,1,6,175,"neutor",NA
"3/17/2015 7:00",462,198,1,4,660,"neutor",NA
"3/17/2015 8:00",497,353,6,4,850,"neutor",NA
"3/17/2015 9:00",371,238,11,9,609,"neutor",NA
"3/17/2015 10:00",286,184,13,11,470,"neutor",NA
"3/17/2015 11:00",302,195,14,11,497,"neutor",NA
"3/17/2015 12:00",376,282,14,11,658,"neutor",NA
"3/17/2015 13:00",351,343,16,9,694,"neutor",NA
"3/17/2015 14:00",407,345,16,13,752,"neutor",NA
"3/17/2015 15:00",405,381,16,15,786,"neutor",NA
"3/17/2015 16:00",511,458,16,13,969,"neutor",NA
"3/17/2015 17:00",518,537,14,13,1055,"neutor",NA
"3/17/2015 18:00",466,520,13,11,986,"neutor",NA
"3/17/2015 19:00",359,380,12,9,739,"neutor",NA
"3/17/2015 20:00",262,294,9,7,556,"neutor",NA
"3/17/2015 21:00",185,181,9,7,366,"neutor",NA
"3/17/2015 22:00",129,226,8,7,355,"neutor",NA
"3/17/2015 23:00",61,114,5,6,175,"neutor",NA
"3/18/2015 0:00",36,71,4,4,107,"neutor",NA
"3/18/2015 1:00",12,52,4,2,64,"neutor",NA
"3/18/2015 2:00",10,13,3,2,23,"neutor",NA
"3/18/2015 3:00",5,4,2,2,9,"neutor",NA
"3/18/2015 4:00",7,8,1,2,15,"neutor",NA
"3/18/2015 5:00",28,11,1,2,39,"neutor",NA
"3/18/2015 6:00",132,33,1,2,165,"neutor",NA
"3/18/2015 7:00",506,209,2,0,715,"neutor",NA
"3/18/2015 8:00",522,367,6,6,889,"neutor",NA
"3/18/2015 9:00",408,220,10,4,628,"neutor",NA
"3/18/2015 10:00",330,188,12,9,518,"neutor",NA
"3/18/2015 11:00",327,192,15,11,519,"neutor",NA
"3/18/2015 12:00",390,290,15,9,680,"neutor",NA
"3/18/2015 13:00",406,330,16,9,736,"neutor",NA
"3/18/2015 14:00",441,357,17,13,798,"neutor",NA
"3/18/2015 15:00",436,427,16,13,863,"neutor",NA
"3/18/2015 16:00",474,437,16,15,911,"neutor",NA
"3/18/2015 17:00",520,529,15,13,1049,"neutor",NA
"3/18/2015 18:00",457,524,12,7,981,"neutor",NA
"3/18/2015 19:00",389,437,12,13,826,"neutor",NA
"3/18/2015 20:00",252,293,10,9,545,"neutor",NA
"3/18/2015 21:00",163,185,10,7,348,"neutor",NA
"3/18/2015 22:00",152,196,7,6,348,"neutor",NA
"3/18/2015 23:00",149,161,6,9,310,"neutor",NA
"3/19/2015 0:00",61,99,6,9,160,"neutor",NA
"3/19/2015 1:00",26,67,6,11,93,"neutor",NA
"3/19/2015 2:00",8,49,6,9,57,"neutor",NA
"3/19/2015 3:00",13,55,6,11,68,"neutor",NA
"3/19/2015 4:00",14,33,6,9,47,"neutor",NA
"3/19/2015 5:00",32,25,6,9,57,"neutor",NA
"3/19/2015 6:00",113,43,5,9,156,"neutor",NA
"3/19/2015 7:00",444,197,5,7,641,"neutor",NA
"3/19/2015 8:00",433,309,5,7,742,"neutor",NA
"3/19/2015 9:00",386,207,6,2,593,"neutor",NA
"3/19/2015 10:00",256,201,6,4,457,"neutor",NA
"3/19/2015 11:00",254,205,6,6,459,"neutor",NA
"3/19/2015 12:00",327,241,7,6,568,"neutor",NA
"3/19/2015 13:00",315,300,8,2,615,"neutor",NA
"3/19/2015 14:00",315,297,9,7,612,"neutor",NA
"3/19/2015 15:00",356,374,10,9,730,"neutor",NA
"3/19/2015 16:00",454,400,10,7,854,"neutor",NA
"3/19/2015 17:00",474,445,9,7,919,"neutor",NA
"3/19/2015 18:00",415,448,7,7,863,"neutor",NA
"3/19/2015 19:00",329,306,6,4,635,"neutor",NA
"3/19/2015 20:00",218,225,4,4,443,"neutor",NA
"3/19/2015 21:00",112,190,3,2,302,"neutor",NA
"3/19/2015 22:00",90,192,1,2,282,"neutor",NA
"3/19/2015 23:00",71,155,0,6,226,"neutor",NA
"3/20/2015 0:00",31,70,-1,6,101,"neutor",NA
"3/20/2015 1:00",20,43,1,4,63,"neutor",NA
"3/20/2015 2:00",2,22,2,4,24,"neutor",NA
"3/20/2015 3:00",4,5,1,2,9,"neutor",NA
"3/20/2015 4:00",7,6,0,0,13,"neutor",NA
"3/20/2015 5:00",33,18,0,4,51,"neutor",NA
"3/20/2015 6:00",115,36,0,4,151,"neutor",NA
"3/20/2015 7:00",389,162,0,2,551,"neutor",NA
"3/20/2015 8:00",396,239,0,2,635,"neutor",NA
"3/20/2015 9:00",316,210,1,4,526,"neutor",NA
"3/20/2015 10:00",259,174,0,4,433,"neutor",NA
"3/20/2015 11:00",235,181,1,7,416,"neutor",NA
"3/20/2015 12:00",291,221,1,7,512,"neutor",NA
"3/20/2015 13:00",249,283,2,6,532,"neutor",NA
"3/20/2015 14:00",303,319,4,2,622,"neutor",NA
"3/20/2015 15:00",296,266,5,4,562,"neutor",NA
"3/20/2015 16:00",322,284,5,6,606,"neutor",NA
"3/20/2015 17:00",369,319,4,9,688,"neutor",NA
"3/20/2015 18:00",315,318,3,6,633,"neutor",NA
"3/20/2015 19:00",231,264,1,7,495,"neutor",NA
"3/20/2015 20:00",213,199,1,7,412,"neutor",NA
"3/20/2015 21:00",153,138,0,2,291,"neutor",NA
"3/20/2015 22:00",105,119,0,6,224,"neutor",NA
"3/20/2015 23:00",115,135,0,2,250,"neutor",NA
"3/21/2015 0:00",95,123,2,7,218,"neutor",NA
"3/21/2015 1:00",66,102,3,11,168,"neutor",NA
"3/21/2015 2:00",30,87,3,11,117,"neutor",NA
"3/21/2015 3:00",20,57,3,11,77,"neutor",NA
"3/21/2015 4:00",17,40,3,11,57,"neutor",NA
"3/21/2015 5:00",13,21,4,13,34,"neutor",NA
"3/21/2015 6:00",22,14,4,15,36,"neutor",NA
"3/21/2015 7:00",41,25,4,13,66,"neutor",NA
"3/21/2015 8:00",79,32,5,13,111,"neutor",NA
"3/21/2015 9:00",218,59,6,13,277,"neutor",NA
"3/21/2015 10:00",212,89,6,11,301,"neutor",NA
"3/21/2015 11:00",265,114,7,11,379,"neutor",NA
"3/21/2015 12:00",299,147,7,15,446,"neutor",NA
"3/21/2015 13:00",303,163,6,7,466,"neutor",NA
"3/21/2015 14:00",204,178,7,7,382,"neutor",NA
"3/21/2015 15:00",164,211,7,7,375,"neutor",NA
"3/21/2015 16:00",188,206,5,13,394,"neutor",NA
"3/21/2015 17:00",145,182,6,13,327,"neutor",NA
"3/21/2015 18:00",135,208,5,11,343,"neutor",NA
"3/21/2015 19:00",128,169,5,13,297,"neutor",NA
"3/21/2015 20:00",166,165,5,13,331,"neutor",NA
"3/21/2015 21:00",121,94,5,17,215,"neutor",NA
"3/21/2015 22:00",96,92,5,26,188,"neutor",NA
"3/21/2015 23:00",58,91,4,15,149,"neutor",NA
"3/22/2015 0:00",65,65,4,26,130,"neutor",NA
"3/22/2015 1:00",72,110,4,26,182,"neutor",NA
"3/22/2015 2:00",31,87,3,28,118,"neutor",NA
"3/22/2015 3:00",20,53,3,22,73,"neutor",NA
"3/22/2015 4:00",20,36,3,20,56,"neutor",NA
"3/22/2015 5:00",22,26,2,20,48,"neutor",NA
"3/22/2015 6:00",14,20,1,15,34,"neutor",NA
"3/22/2015 7:00",35,11,1,24,46,"neutor",NA
"3/22/2015 8:00",53,18,1,17,71,"neutor",NA
"3/22/2015 9:00",122,39,2,17,161,"neutor",NA
"3/22/2015 10:00",160,68,3,17,228,"neutor",NA
"3/22/2015 11:00",115,70,5,15,185,"neutor",NA
"3/22/2015 12:00",152,129,6,13,281,"neutor",NA
"3/22/2015 13:00",216,158,6,13,374,"neutor",NA
"3/22/2015 14:00",239,181,7,13,420,"neutor",NA
"3/22/2015 15:00",230,221,7,9,451,"neutor",NA
"3/22/2015 16:00",252,167,7,7,419,"neutor",NA
"3/22/2015 17:00",233,210,7,11,443,"neutor",NA
"3/22/2015 18:00",171,202,5,7,373,"neutor",NA
"3/22/2015 19:00",99,184,4,7,283,"neutor",NA
"3/22/2015 20:00",110,178,3,6,288,"neutor",NA
"3/22/2015 21:00",62,106,2,4,168,"neutor",NA
"3/22/2015 22:00",58,74,1,4,132,"neutor",NA
"3/22/2015 23:00",33,46,1,6,79,"neutor",NA
"3/23/2015 0:00",10,28,-1,4,38,"neutor",NA
"3/23/2015 1:00",2,20,-1,4,22,"neutor",NA
"3/23/2015 2:00",1,8,-1,4,9,"neutor",NA
"3/23/2015 3:00",7,3,-2,4,10,"neutor",NA
"3/23/2015 4:00",4,3,-2,4,7,"neutor",NA
"3/23/2015 5:00",34,12,-2,4,46,"neutor",NA
"3/23/2015 6:00",102,35,-2,6,137,"neutor",NA
"3/23/2015 7:00",451,196,-1,4,647,"neutor",NA
"3/23/2015 8:00",407,332,1,6,739,"neutor",NA
"3/23/2015 9:00",336,244,4,7,580,"neutor",NA
"3/23/2015 10:00",297,249,6,7,546,"neutor",NA
"3/23/2015 11:00",327,215,8,9,542,"neutor",NA
"3/23/2015 12:00",328,280,9,11,608,"neutor",NA
"3/23/2015 13:00",315,286,10,13,601,"neutor",NA
"3/23/2015 14:00",365,333,10,11,698,"neutor",NA
"3/23/2015 15:00",465,383,11,15,848,"neutor",NA
"3/23/2015 16:00",500,452,11,11,952,"neutor",NA
"3/23/2015 17:00",539,488,10,15,1027,"neutor",NA
"3/23/2015 18:00",421,468,9,9,889,"neutor",NA
"3/23/2015 19:00",322,352,7,7,674,"neutor",NA
"3/23/2015 20:00",206,225,6,4,431,"neutor",NA
"3/23/2015 21:00",131,181,5,2,312,"neutor",NA
"3/23/2015 22:00",103,200,5,9,303,"neutor",NA
"3/23/2015 23:00",76,111,5,6,187,"neutor",NA
"3/24/2015 0:00",19,56,5,2,75,"neutor",NA
"3/24/2015 1:00",10,41,4,2,51,"neutor",NA
"3/24/2015 2:00",6,34,4,2,40,"neutor",NA
"3/24/2015 3:00",2,11,3,2,13,"neutor",NA
"3/24/2015 4:00",5,4,1,2,9,"neutor",NA
"3/24/2015 5:00",36,19,0,0,55,"neutor",NA
"3/24/2015 6:00",118,41,0,2,159,"neutor",NA
"3/24/2015 7:00",409,184,1,6,593,"neutor",NA
"3/24/2015 8:00",493,369,4,2,862,"neutor",NA
"3/24/2015 9:00",454,251,6,6,705,"neutor",NA
"3/24/2015 10:00",301,241,8,7,542,"neutor",NA
"3/24/2015 11:00",311,252,8,7,563,"neutor",NA
"3/24/2015 12:00",330,294,9,6,624,"neutor",NA
"3/24/2015 13:00",350,341,10,7,691,"neutor",NA
"3/24/2015 14:00",367,331,10,4,698,"neutor",NA
"3/24/2015 15:00",403,376,11,9,779,"neutor",NA
"3/24/2015 16:00",529,424,10,11,953,"neutor",NA
"3/24/2015 17:00",505,477,9,6,982,"neutor",NA
"3/24/2015 18:00",456,484,7,4,940,"neutor",NA
"3/24/2015 19:00",390,344,5,6,734,"neutor",NA
"3/24/2015 20:00",254,234,4,4,488,"neutor",NA
"3/24/2015 21:00",139,154,4,2,293,"neutor",NA
"3/24/2015 22:00",121,187,5,6,308,"neutor",NA
"3/24/2015 23:00",56,121,6,0,177,"neutor",NA
"3/25/2015 0:00",33,72,7,13,105,"neutor",NA
"3/25/2015 1:00",18,55,7,11,73,"neutor",NA
"3/25/2015 2:00",7,24,6,9,31,"neutor",NA
"3/25/2015 3:00",7,11,7,7,18,"neutor",NA
"3/25/2015 4:00",13,4,8,11,17,"neutor",NA
"3/25/2015 5:00",32,9,6,11,41,"neutor",NA
"3/25/2015 6:00",130,31,6,7,161,"neutor",NA
"3/25/2015 7:00",435,194,6,4,629,"neutor",NA
"3/25/2015 8:00",443,403,8,2,846,"neutor",NA
"3/25/2015 9:00",423,278,10,9,701,"neutor",NA
"3/25/2015 10:00",336,205,11,9,541,"neutor",NA
"3/25/2015 11:00",341,228,12,9,569,"neutor",NA
"3/25/2015 12:00",376,319,12,13,695,"neutor",NA
"3/25/2015 13:00",370,386,10,15,756,"neutor",NA
"3/25/2015 14:00",372,321,10,17,693,"neutor",NA
"3/25/2015 15:00",357,353,8,20,710,"neutor",NA
"3/25/2015 16:00",452,418,8,15,870,"neutor",NA
"3/25/2015 17:00",479,425,7,11,904,"neutor",NA
"3/25/2015 18:00",387,440,7,15,827,"neutor",NA
"3/25/2015 19:00",368,342,7,11,710,"neutor",NA
"3/25/2015 20:00",259,221,6,11,480,"neutor",NA
"3/25/2015 21:00",218,153,6,11,371,"neutor",NA
"3/25/2015 22:00",152,197,6,13,349,"neutor",NA
"3/25/2015 23:00",110,161,5,15,271,"neutor",NA
"3/26/2015 0:00",100,116,5,11,216,"neutor",NA
"3/26/2015 1:00",32,78,5,15,110,"neutor",NA
"3/26/2015 2:00",34,83,4,9,117,"neutor",NA
"3/26/2015 3:00",9,54,4,7,63,"neutor",NA
"3/26/2015 4:00",14,37,4,7,51,"neutor",NA
"3/26/2015 5:00",30,38,5,7,68,"neutor",NA
"3/26/2015 6:00",110,43,5,9,153,"neutor",NA
"3/26/2015 7:00",443,190,5,9,633,"neutor",NA
"3/26/2015 8:00",502,320,6,7,822,"neutor",NA
"3/26/2015 9:00",376,227,6,13,603,"neutor",NA
"3/26/2015 10:00",311,237,6,13,548,"neutor",NA
"3/26/2015 11:00",257,261,7,15,518,"neutor",NA
"3/26/2015 12:00",328,262,8,17,590,"neutor",NA
"3/26/2015 13:00",316,311,8,17,627,"neutor",NA
"3/26/2015 14:00",343,281,8,13,624,"neutor",NA
"3/26/2015 15:00",370,397,8,15,767,"neutor",NA
"3/26/2015 16:00",413,430,6,15,843,"neutor",NA
"3/26/2015 17:00",417,386,6,15,803,"neutor",NA
"3/26/2015 18:00",346,384,5,9,730,"neutor",NA
"3/26/2015 19:00",310,284,5,9,594,"neutor",NA
"3/26/2015 20:00",180,191,5,17,371,"neutor",NA
"3/26/2015 21:00",139,130,5,19,269,"neutor",NA
"3/26/2015 22:00",92,145,5,17,237,"neutor",NA
"3/26/2015 23:00",80,115,5,13,195,"neutor",NA
"3/27/2015 0:00",53,66,6,13,119,"neutor",NA
"3/27/2015 1:00",12,64,7,19,76,"neutor",NA
"3/27/2015 2:00",6,68,7,22,74,"neutor",NA
"3/27/2015 3:00",4,29,7,15,33,"neutor",NA
"3/27/2015 4:00",4,9,6,24,13,"neutor",NA
"3/27/2015 5:00",25,14,6,20,39,"neutor",NA
"3/27/2015 6:00",114,23,6,20,137,"neutor",NA
"3/27/2015 7:00",349,157,6,22,506,"neutor",NA
"3/27/2015 8:00",359,240,6,28,599,"neutor",NA
"3/27/2015 9:00",334,197,7,24,531,"neutor",NA
"3/27/2015 10:00",230,209,8,28,439,"neutor",NA
"3/27/2015 11:00",239,165,8,33,404,"neutor",NA
"3/27/2015 12:00",303,220,8,35,523,"neutor",NA
"3/27/2015 13:00",283,273,9,28,556,"neutor",NA
"3/27/2015 14:00",265,272,8,30,537,"neutor",NA
"3/27/2015 15:00",310,242,6,26,552,"neutor",NA
"3/27/2015 16:00",298,264,7,15,562,"neutor",NA
"3/27/2015 17:00",316,262,7,15,578,"neutor",NA
"3/27/2015 18:00",260,273,7,19,533,"neutor",NA
"3/27/2015 19:00",235,265,7,15,500,"neutor",NA
"3/27/2015 20:00",203,171,6,19,374,"neutor",NA
"3/27/2015 21:00",175,136,6,19,311,"neutor",NA
"3/27/2015 22:00",113,126,6,11,239,"neutor",NA
"3/27/2015 23:00",93,121,6,11,214,"neutor",NA
"3/28/2015 0:00",86,104,4,9,190,"neutor",NA
"3/28/2015 1:00",77,69,3,6,146,"neutor",NA
"3/28/2015 2:00",63,84,2,2,147,"neutor",NA
"3/28/2015 3:00",32,53,0,4,85,"neutor",NA
"3/28/2015 4:00",21,51,0,6,72,"neutor",NA
"3/28/2015 5:00",42,34,0,7,76,"neutor",NA
"3/28/2015 6:00",28,24,-1,6,52,"neutor",NA
"3/28/2015 7:00",57,23,2,7,80,"neutor",NA
"3/28/2015 8:00",116,64,5,7,180,"neutor",NA
"3/28/2015 9:00",230,68,7,15,298,"neutor",NA
"3/28/2015 10:00",311,130,9,13,441,"neutor",NA
"3/28/2015 11:00",319,135,11,15,454,"neutor",NA
"3/28/2015 12:00",285,198,12,19,483,"neutor",NA
"3/28/2015 13:00",263,225,11,19,488,"neutor",NA
"3/28/2015 14:00",156,210,9,13,366,"neutor",NA
"3/28/2015 15:00",142,163,9,17,305,"neutor",NA
"3/28/2015 16:00",110,175,8,13,285,"neutor",NA
"3/28/2015 17:00",133,161,9,17,294,"neutor",NA
"3/28/2015 18:00",131,196,9,19,327,"neutor",NA
"3/28/2015 19:00",160,152,10,17,312,"neutor",NA
"3/28/2015 20:00",143,156,9,17,299,"neutor",NA
"3/28/2015 21:00",136,119,10,19,255,"neutor",NA
"3/28/2015 22:00",84,79,10,17,163,"neutor",NA
"3/28/2015 23:00",72,80,11,22,152,"neutor",NA
"3/29/2015 0:00",60,96,11,20,156,"neutor",NA
"3/29/2015 1:00",68,86,12,26,154,"neutor",NA
"3/29/2015 3:00",NA,NA,NA,NA,NA,"neutor",NA
"3/29/2015 3:00",23,73,11,28,96,"neutor",NA
"3/29/2015 4:00",20,63,11,30,83,"neutor",NA
"3/29/2015 5:00",24,35,11,28,59,"neutor",NA
"3/29/2015 6:00",9,22,10,30,31,"neutor",NA
"3/29/2015 7:00",20,12,10,26,32,"neutor",NA
"3/29/2015 8:00",48,12,9,24,60,"neutor",NA
"3/29/2015 9:00",67,14,9,24,81,"neutor",NA
"3/29/2015 10:00",82,31,10,24,113,"neutor",NA
"3/29/2015 11:00",75,46,9,17,121,"neutor",NA
"3/29/2015 12:00",63,61,10,22,124,"neutor",NA
"3/29/2015 13:00",92,52,10,24,144,"neutor",NA
"3/29/2015 14:00",87,72,9,19,159,"neutor",NA
"3/29/2015 15:00",68,69,10,20,137,"neutor",NA
"3/29/2015 16:00",53,68,10,20,121,"neutor",NA
"3/29/2015 17:00",60,65,11,20,125,"neutor",NA
"3/29/2015 18:00",73,105,11,35,178,"neutor",NA
"3/29/2015 19:00",67,70,11,43,137,"neutor",NA
"3/29/2015 20:00",47,73,10,59,120,"neutor",NA
"3/29/2015 21:00",47,43,9,44,90,"neutor",NA
"3/29/2015 22:00",39,52,7,32,91,"neutor",NA
"3/29/2015 23:00",24,35,7,35,59,"neutor",NA
"3/30/2015 0:00",14,16,7,30,30,"neutor",NA
"3/30/2015 1:00",7,16,7,30,23,"neutor",NA
"3/30/2015 2:00",1,8,7,30,9,"neutor",NA
"3/30/2015 3:00",3,6,7,30,9,"neutor",NA
"3/30/2015 4:00",8,2,7,33,10,"neutor",NA
"3/30/2015 5:00",22,9,7,33,31,"neutor",NA
"3/30/2015 6:00",60,22,5,39,82,"neutor",NA
"3/30/2015 7:00",207,108,6,30,315,"neutor",NA
"3/30/2015 8:00",299,253,6,33,552,"neutor",NA
"3/30/2015 9:00",238,162,7,37,400,"neutor",NA
"3/30/2015 10:00",254,169,8,37,423,"neutor",NA
"3/30/2015 11:00",216,133,8,26,349,"neutor",NA
"3/30/2015 12:00",215,172,5,43,387,"neutor",NA
"3/30/2015 13:00",215,163,8,32,378,"neutor",NA
"3/30/2015 14:00",211,196,8,35,407,"neutor",NA
"3/30/2015 15:00",267,209,9,41,476,"neutor",NA
"3/30/2015 16:00",293,282,8,35,575,"neutor",NA
"3/30/2015 17:00",366,319,8,35,685,"neutor",NA
"3/30/2015 18:00",334,313,7,26,647,"neutor",NA
"3/30/2015 19:00",249,236,6,20,485,"neutor",NA
"3/30/2015 20:00",171,190,6,13,361,"neutor",NA
"3/30/2015 21:00",114,109,6,11,223,"neutor",NA
"3/30/2015 22:00",46,104,6,11,150,"neutor",NA
"3/30/2015 23:00",52,85,6,13,137,"neutor",NA
"3/31/2015 0:00",22,76,5,24,98,"neutor",NA
"3/31/2015 1:00",22,36,4,20,58,"neutor",NA
"3/31/2015 2:00",13,24,4,19,37,"neutor",NA
"3/31/2015 3:00",8,10,4,20,18,"neutor",NA
"3/31/2015 4:00",9,17,4,17,26,"neutor",NA
"3/31/2015 5:00",20,6,8,17,26,"neutor",NA
"3/31/2015 6:00",47,23,11,48,70,"neutor",NA
"3/31/2015 7:00",130,79,8,44,209,"neutor",NA
"3/31/2015 8:00",179,148,9,39,327,"neutor",NA
"3/31/2015 9:00",172,149,9,41,321,"neutor",NA
"3/31/2015 10:00",173,134,8,61,307,"neutor",NA
"3/31/2015 11:00",149,103,9,44,252,"neutor",NA
"3/31/2015 12:00",178,121,8,46,299,"neutor",NA
"3/31/2015 13:00",179,116,8,52,295,"neutor",NA
"3/31/2015 14:00",175,139,8,52,314,"neutor",NA
"3/31/2015 15:00",208,147,9,46,355,"neutor",NA
"3/31/2015 16:00",184,204,9,44,388,"neutor",NA
"3/31/2015 17:00",236,201,9,43,437,"neutor",NA
"3/31/2015 18:00",214,202,8,44,416,"neutor",NA
"3/31/2015 19:00",220,160,6,35,380,"neutor",NA
"3/31/2015 20:00",139,123,6,32,262,"neutor",NA
"3/31/2015 21:00",76,86,6,30,162,"neutor",NA
"3/31/2015 22:00",78,97,4,39,175,"neutor",NA
"3/31/2015 23:00",41,76,5,22,117,"neutor",NA
"4/1/2015 0:00",29,49,5,24,78,"neutor",NA
"4/1/2015 1:00",9,56,5,30,65,"neutor",NA
"4/1/2015 2:00",4,17,4,44,21,"neutor",NA
"4/1/2015 3:00",5,11,4,28,16,"neutor",NA
"4/1/2015 4:00",6,7,2,30,13,"neutor",NA
"4/1/2015 5:00",33,9,2,33,42,"neutor",NA
"4/1/2015 6:00",43,16,3,26,59,"neutor",NA
"4/1/2015 7:00",170,106,3,32,276,"neutor",NA
"4/1/2015 8:00",259,170,3,26,429,"neutor",NA
"4/1/2015 9:00",263,208,5,26,471,"neutor",NA
"4/1/2015 10:00",269,174,6,30,443,"neutor",NA
"4/1/2015 11:00",214,145,7,37,359,"neutor",NA
"4/1/2015 12:00",246,165,7,33,411,"neutor",NA
"4/1/2015 13:00",215,172,6,13,387,"neutor",NA
"4/1/2015 14:00",188,192,6,26,380,"neutor",NA
"4/1/2015 15:00",204,164,7,33,368,"neutor",NA
"4/1/2015 16:00",250,236,6,24,486,"neutor",NA
"4/1/2015 17:00",254,250,6,30,504,"neutor",NA
"4/1/2015 18:00",288,231,5,22,519,"neutor",NA
"4/1/2015 19:00",252,196,4,15,448,"neutor",NA
"4/1/2015 20:00",170,127,4,20,297,"neutor",NA
"4/1/2015 21:00",137,119,5,15,256,"neutor",NA
"4/1/2015 22:00",85,115,5,37,200,"neutor",NA
"4/1/2015 23:00",107,80,5,24,187,"neutor",NA
"4/2/2015 0:00",66,65,5,26,131,"neutor",NA
"4/2/2015 1:00",51,63,5,28,114,"neutor",NA
"4/2/2015 2:00",24,70,5,32,94,"neutor",NA
"4/2/2015 3:00",11,56,5,30,67,"neutor",NA
"4/2/2015 4:00",7,51,3,20,58,"neutor",NA
"4/2/2015 5:00",30,23,2,7,53,"neutor",NA
"4/2/2015 6:00",42,29,0,7,71,"neutor",NA
"4/2/2015 7:00",123,91,1,13,214,"neutor",NA
"4/2/2015 8:00",223,162,2,15,385,"neutor",NA
"4/2/2015 9:00",229,175,4,22,404,"neutor",NA
"4/2/2015 10:00",221,129,4,24,350,"neutor",NA
"4/2/2015 11:00",236,143,6,28,379,"neutor",NA
"4/2/2015 12:00",232,174,7,26,406,"neutor",NA
"4/2/2015 13:00",207,162,6,26,369,"neutor",NA
"4/2/2015 14:00",219,198,7,26,417,"neutor",NA
"4/2/2015 15:00",256,182,5,22,438,"neutor",NA
"4/2/2015 16:00",263,216,7,24,479,"neutor",NA
"4/2/2015 17:00",282,271,8,32,553,"neutor",NA
"4/2/2015 18:00",214,235,6,19,449,"neutor",NA
"4/2/2015 19:00",236,194,5,15,430,"neutor",NA
"4/2/2015 20:00",164,143,5,11,307,"neutor",NA
"4/2/2015 21:00",131,90,5,19,221,"neutor",NA
"4/2/2015 22:00",63,79,5,19,142,"neutor",NA
"4/2/2015 23:00",65,76,5,20,141,"neutor",NA
"4/3/2015 0:00",27,86,4,20,113,"neutor",NA
"4/3/2015 1:00",18,62,4,13,80,"neutor",NA
"4/3/2015 2:00",7,58,4,19,65,"neutor",NA
"4/3/2015 3:00",15,12,4,22,27,"neutor",NA
"4/3/2015 4:00",8,15,4,13,23,"neutor",NA
"4/3/2015 5:00",11,11,4,11,22,"neutor",NA
"4/3/2015 6:00",19,19,4,11,38,"neutor",NA
"4/3/2015 7:00",22,6,4,9,28,"neutor",NA
"4/3/2015 8:00",29,18,5,9,47,"neutor",NA
"4/3/2015 9:00",76,28,5,13,104,"neutor",NA
"4/3/2015 10:00",80,49,6,17,129,"neutor",NA
"4/3/2015 11:00",66,56,7,11,122,"neutor",NA
"4/3/2015 12:00",116,55,8,9,171,"neutor",NA
"4/3/2015 13:00",92,71,8,11,163,"neutor",NA
"4/3/2015 14:00",185,113,9,13,298,"neutor",NA
"4/3/2015 15:00",136,87,10,11,223,"neutor",NA
"4/3/2015 16:00",150,123,9,7,273,"neutor",NA
"4/3/2015 17:00",133,143,10,4,276,"neutor",NA
"4/3/2015 18:00",139,104,9,6,243,"neutor",NA
"4/3/2015 19:00",140,87,8,6,227,"neutor",NA
"4/3/2015 20:00",70,76,6,2,146,"neutor",NA
"4/3/2015 21:00",46,59,4,2,105,"neutor",NA
"4/3/2015 22:00",51,68,3,7,119,"neutor",NA
"4/3/2015 23:00",31,44,3,9,75,"neutor",NA
"4/4/2015 0:00",22,45,4,7,67,"neutor",NA
"4/4/2015 1:00",11,27,3,9,38,"neutor",NA
"4/4/2015 2:00",9,18,3,11,27,"neutor",NA
"4/4/2015 3:00",7,17,3,9,24,"neutor",NA
"4/4/2015 4:00",4,7,3,11,11,"neutor",NA
"4/4/2015 5:00",12,13,3,9,25,"neutor",NA
"4/4/2015 6:00",20,5,3,7,25,"neutor",NA
"4/4/2015 7:00",40,11,3,7,51,"neutor",NA
"4/4/2015 8:00",66,30,3,7,96,"neutor",NA
"4/4/2015 9:00",156,36,4,9,192,"neutor",NA
"4/4/2015 10:00",224,93,5,9,317,"neutor",NA
"4/4/2015 11:00",209,110,6,15,319,"neutor",NA
"4/4/2015 12:00",226,140,8,17,366,"neutor",NA
"4/4/2015 13:00",216,148,7,15,364,"neutor",NA
"4/4/2015 14:00",166,152,9,15,318,"neutor",NA
"4/4/2015 15:00",158,147,8,17,305,"neutor",NA
"4/4/2015 16:00",129,159,8,13,288,"neutor",NA
"4/4/2015 17:00",144,144,8,11,288,"neutor",NA
"4/4/2015 18:00",120,146,8,11,266,"neutor",NA
"4/4/2015 19:00",112,116,6,11,228,"neutor",NA
"4/4/2015 20:00",100,88,5,7,188,"neutor",NA
"4/4/2015 21:00",79,75,4,7,154,"neutor",NA
"4/4/2015 22:00",65,56,3,7,121,"neutor",NA
"4/4/2015 23:00",53,77,2,7,130,"neutor",NA
"4/5/2015 0:00",55,58,2,7,113,"neutor",NA
"4/5/2015 1:00",32,50,2,6,82,"neutor",NA
"4/5/2015 2:00",11,52,1,6,63,"neutor",NA
"4/5/2015 3:00",11,41,1,4,52,"neutor",NA
"4/5/2015 4:00",18,20,0,4,38,"neutor",NA
"4/5/2015 5:00",10,9,-1,4,19,"neutor",NA
"4/5/2015 6:00",10,9,-1,4,19,"neutor",NA
"4/5/2015 7:00",24,12,-1,4,36,"neutor",NA
"4/5/2015 8:00",23,10,2,4,33,"neutor",NA
"4/5/2015 9:00",77,29,4,4,106,"neutor",NA
"4/5/2015 10:00",68,42,7,2,110,"neutor",NA
"4/5/2015 11:00",87,53,8,7,140,"neutor",NA
"4/5/2015 12:00",95,61,9,11,156,"neutor",NA
"4/5/2015 13:00",103,82,9,11,185,"neutor",NA
"4/5/2015 14:00",100,89,11,4,189,"neutor",NA
"4/5/2015 15:00",114,109,10,6,223,"neutor",NA
"4/5/2015 16:00",83,84,10,9,167,"neutor",NA
"4/5/2015 17:00",120,92,10,9,212,"neutor",NA
"4/5/2015 18:00",90,95,9,15,185,"neutor",NA
"4/5/2015 19:00",81,80,8,7,161,"neutor",NA
"4/5/2015 20:00",94,93,7,6,187,"neutor",NA
"4/5/2015 21:00",53,51,6,7,104,"neutor",NA
"4/5/2015 22:00",55,43,5,6,98,"neutor",NA
"4/5/2015 23:00",43,48,5,7,91,"neutor",NA
"4/6/2015 0:00",31,39,5,11,70,"neutor",NA
"4/6/2015 1:00",22,33,5,9,55,"neutor",NA
"4/6/2015 2:00",8,27,5,6,35,"neutor",NA
"4/6/2015 3:00",5,13,5,6,18,"neutor",NA
"4/6/2015 4:00",3,9,4,6,12,"neutor",NA
"4/6/2015 5:00",11,14,4,4,25,"neutor",NA
"4/6/2015 6:00",10,12,4,7,22,"neutor",NA
"4/6/2015 7:00",14,8,5,4,22,"neutor",NA
"4/6/2015 8:00",15,13,5,4,28,"neutor",NA
"4/6/2015 9:00",42,31,5,4,73,"neutor",NA
"4/6/2015 10:00",57,43,5,2,100,"neutor",NA
"4/6/2015 11:00",99,54,6,4,153,"neutor",NA
"4/6/2015 12:00",69,79,7,4,148,"neutor",NA
"4/6/2015 13:00",76,69,8,6,145,"neutor",NA
"4/6/2015 14:00",123,87,9,6,210,"neutor",NA
"4/6/2015 15:00",114,104,11,9,218,"neutor",NA
"4/6/2015 16:00",120,103,11,6,223,"neutor",NA
"4/6/2015 17:00",140,126,11,6,266,"neutor",NA
"4/6/2015 18:00",148,111,10,9,259,"neutor",NA
"4/6/2015 19:00",140,119,8,7,259,"neutor",NA
"4/6/2015 20:00",103,126,6,6,229,"neutor",NA
"4/6/2015 21:00",67,108,4,2,175,"neutor",NA
"4/6/2015 22:00",51,92,3,2,143,"neutor",NA
"4/6/2015 23:00",24,48,2,2,72,"neutor",NA
"4/7/2015 0:00",17,35,1,4,52,"neutor",NA
"4/7/2015 1:00",10,11,0,2,21,"neutor",NA
"4/7/2015 2:00",3,11,0,2,14,"neutor",NA
"4/7/2015 3:00",2,3,-1,2,5,"neutor",NA
"4/7/2015 4:00",5,1,-1,2,6,"neutor",NA
"4/7/2015 5:00",35,15,-1,2,50,"neutor",NA
"4/7/2015 6:00",90,35,-1,4,125,"neutor",NA
"4/7/2015 7:00",309,172,-1,7,481,"neutor",NA
"4/7/2015 8:00",470,346,1,4,816,"neutor",NA
"4/7/2015 9:00",449,385,5,6,834,"neutor",NA
"4/7/2015 10:00",430,443,8,6,873,"neutor",NA
"4/7/2015 11:00",490,309,10,19,799,"neutor",NA
"4/7/2015 12:00",504,346,11,17,850,"neutor",NA
"4/7/2015 13:00",581,411,11,20,992,"neutor",NA
"4/7/2015 14:00",543,451,11,22,994,"neutor",NA
"4/7/2015 15:00",573,404,12,19,977,"neutor",NA
"4/7/2015 16:00",515,511,12,17,1026,"neutor",NA
"4/7/2015 17:00",573,569,12,17,1142,"neutor",NA
"4/7/2015 18:00",464,559,12,13,1023,"neutor",NA
"4/7/2015 19:00",356,357,11,11,713,"neutor",NA
"4/7/2015 20:00",323,327,9,7,650,"neutor",NA
"4/7/2015 21:00",188,207,8,9,395,"neutor",NA
"4/7/2015 22:00",157,168,7,9,325,"neutor",NA
"4/7/2015 23:00",226,158,8,9,384,"neutor",NA
"4/8/2015 0:00",140,85,8,9,225,"neutor",NA
"4/8/2015 1:00",50,106,8,6,156,"neutor",NA
"4/8/2015 2:00",20,72,8,6,92,"neutor",NA
"4/8/2015 3:00",16,90,8,6,106,"neutor",NA
"4/8/2015 4:00",13,27,8,6,40,"neutor",NA
"4/8/2015 5:00",31,20,7,6,51,"neutor",NA
"4/8/2015 6:00",97,30,7,6,127,"neutor",NA
"4/8/2015 7:00",485,166,7,6,651,"neutor",NA
"4/8/2015 8:00",547,400,8,9,947,"neutor",NA
"4/8/2015 9:00",593,386,8,9,979,"neutor",NA
"4/8/2015 10:00",533,530,9,7,1063,"neutor",NA
"4/8/2015 11:00",581,359,9,7,940,"neutor",NA
"4/8/2015 12:00",522,427,9,7,949,"neutor",NA
"4/8/2015 13:00",601,444,11,7,1045,"neutor",NA
"4/8/2015 14:00",502,457,11,4,959,"neutor",NA
"4/8/2015 15:00",508,421,11,7,929,"neutor",NA
"4/8/2015 16:00",473,557,12,4,1030,"neutor",NA
"4/8/2015 17:00",540,524,12,6,1064,"neutor",NA
"4/8/2015 18:00",489,572,11,4,1061,"neutor",NA
"4/8/2015 19:00",551,388,11,6,939,"neutor",NA
"4/8/2015 20:00",360,315,11,7,675,"neutor",NA
"4/8/2015 21:00",240,261,10,7,501,"neutor",NA
"4/8/2015 22:00",177,214,10,7,391,"neutor",NA
"4/8/2015 23:00",262,196,9,7,458,"neutor",NA
"4/9/2015 0:00",227,159,9,6,386,"neutor",NA
"4/9/2015 1:00",66,165,6,4,231,"neutor",NA
"4/9/2015 2:00",21,132,4,4,153,"neutor",NA
"4/9/2015 3:00",16,185,4,4,201,"neutor",NA
"4/9/2015 4:00",21,101,5,6,122,"neutor",NA
"4/9/2015 5:00",34,58,4,6,92,"neutor",NA
"4/9/2015 6:00",89,52,3,4,141,"neutor",NA
"4/9/2015 7:00",377,220,3,4,597,"neutor",NA
"4/9/2015 8:00",563,516,8,6,1079,"neutor",NA
"4/9/2015 9:00",574,325,9,4,899,"neutor",NA
"4/9/2015 10:00",528,423,12,4,951,"neutor",NA
"4/9/2015 11:00",542,342,14,4,884,"neutor",NA
"4/9/2015 12:00",593,443,15,4,1036,"neutor",NA
"4/9/2015 13:00",601,528,16,11,1129,"neutor",NA
"4/9/2015 14:00",590,429,17,6,1019,"neutor",NA
"4/9/2015 15:00",685,503,17,6,1188,"neutor",NA
"4/9/2015 16:00",699,533,18,4,1232,"neutor",NA
"4/9/2015 17:00",639,605,18,2,1244,"neutor",NA
"4/9/2015 18:00",558,607,17,6,1165,"neutor",NA
"4/9/2015 19:00",456,498,16,2,954,"neutor",NA
"4/9/2015 20:00",282,350,13,0,632,"neutor",NA
"4/9/2015 21:00",152,224,11,4,376,"neutor",NA
"4/9/2015 22:00",138,241,11,4,379,"neutor",NA
"4/9/2015 23:00",126,239,9,2,365,"neutor",NA
"4/10/2015 0:00",52,136,8,2,188,"neutor",NA
"4/10/2015 1:00",22,64,7,2,86,"neutor",NA
"4/10/2015 2:00",21,51,6,2,72,"neutor",NA
"4/10/2015 3:00",4,24,6,2,28,"neutor",NA
"4/10/2015 4:00",10,17,5,2,27,"neutor",NA
"4/10/2015 5:00",33,20,4,2,53,"neutor",NA
"4/10/2015 6:00",100,28,4,4,128,"neutor",NA
"4/10/2015 7:00",323,154,5,4,477,"neutor",NA
"4/10/2015 8:00",553,373,9,4,926,"neutor",NA
"4/10/2015 9:00",473,330,12,4,803,"neutor",NA
"4/10/2015 10:00",499,315,15,6,814,"neutor",NA
"4/10/2015 11:00",515,323,17,6,838,"neutor",NA
"4/10/2015 12:00",571,427,18,4,998,"neutor",NA
"4/10/2015 13:00",516,441,19,9,957,"neutor",NA
"4/10/2015 14:00",579,446,20,7,1025,"neutor",NA
"4/10/2015 15:00",595,422,20,9,1017,"neutor",NA
"4/10/2015 16:00",547,470,21,7,1017,"neutor",NA
"4/10/2015 17:00",549,531,20,7,1080,"neutor",NA
"4/10/2015 18:00",509,546,20,2,1055,"neutor",NA
"4/10/2015 19:00",401,463,19,4,864,"neutor",NA
"4/10/2015 20:00",326,421,13,2,747,"neutor",NA
"4/10/2015 21:00",237,331,10,6,568,"neutor",NA
"4/10/2015 22:00",180,273,9,6,453,"neutor",NA
"4/10/2015 23:00",151,221,9,6,372,"neutor",NA
"4/11/2015 0:00",136,188,10,6,324,"neutor",NA
"4/11/2015 1:00",110,156,11,6,266,"neutor",NA
"4/11/2015 2:00",47,125,12,11,172,"neutor",NA
"4/11/2015 3:00",41,127,11,11,168,"neutor",NA
"4/11/2015 4:00",18,88,12,9,106,"neutor",NA
"4/11/2015 5:00",30,41,13,9,71,"neutor",NA
"4/11/2015 6:00",37,26,13,13,63,"neutor",NA
"4/11/2015 7:00",74,29,13,13,103,"neutor",NA
"4/11/2015 8:00",133,66,13,15,199,"neutor",NA
"4/11/2015 9:00",298,84,15,20,382,"neutor",NA
"4/11/2015 10:00",394,135,16,26,529,"neutor",NA
"4/11/2015 11:00",363,204,16,28,567,"neutor",NA
"4/11/2015 12:00",347,268,16,28,615,"neutor",NA
"4/11/2015 13:00",323,259,15,39,582,"neutor",NA
"4/11/2015 14:00",203,204,13,22,407,"neutor",NA
"4/11/2015 15:00",189,197,13,24,386,"neutor",NA
"4/11/2015 16:00",172,256,14,30,428,"neutor",NA
"4/11/2015 17:00",257,216,14,22,473,"neutor",NA
"4/11/2015 18:00",152,240,13,17,392,"neutor",NA
"4/11/2015 19:00",185,156,8,22,341,"neutor",NA
"4/11/2015 20:00",172,225,7,17,397,"neutor",NA
"4/11/2015 21:00",143,163,6,13,306,"neutor",NA
"4/11/2015 22:00",131,144,6,9,275,"neutor",NA
"4/11/2015 23:00",83,128,6,9,211,"neutor",NA
"4/12/2015 0:00",88,122,6,9,210,"neutor",NA
"4/12/2015 1:00",109,122,5,9,231,"neutor",NA
"4/12/2015 2:00",67,79,4,6,146,"neutor",NA
"4/12/2015 3:00",89,100,3,6,189,"neutor",NA
"4/12/2015 4:00",41,66,3,6,107,"neutor",NA
"4/12/2015 5:00",22,50,2,4,72,"neutor",NA
"4/12/2015 6:00",24,20,2,6,44,"neutor",NA
"4/12/2015 7:00",34,15,3,6,49,"neutor",NA
"4/12/2015 8:00",53,20,5,6,73,"neutor",NA
"4/12/2015 9:00",128,55,8,13,183,"neutor",NA
"4/12/2015 10:00",233,103,10,19,336,"neutor",NA
"4/12/2015 11:00",199,143,12,19,342,"neutor",NA
"4/12/2015 12:00",258,227,13,22,485,"neutor",NA
"4/12/2015 13:00",297,291,14,20,588,"neutor",NA
"4/12/2015 14:00",412,250,14,24,662,"neutor",NA
"4/12/2015 15:00",362,251,14,26,613,"neutor",NA
"4/12/2015 16:00",341,293,15,24,634,"neutor",NA
"4/12/2015 17:00",309,294,15,20,603,"neutor",NA
"4/12/2015 18:00",291,248,15,22,539,"neutor",NA
"4/12/2015 19:00",224,306,14,17,530,"neutor",NA
"4/12/2015 20:00",143,284,13,11,427,"neutor",NA
"4/12/2015 21:00",81,166,13,15,247,"neutor",NA
"4/12/2015 22:00",86,170,14,19,256,"neutor",NA
"4/12/2015 23:00",46,67,14,26,113,"neutor",NA
"4/13/2015 0:00",16,43,13,30,59,"neutor",NA
"4/13/2015 1:00",11,8,12,35,19,"neutor",NA
"4/13/2015 2:00",2,5,8,28,7,"neutor",NA
"4/13/2015 3:00",2,2,7,19,4,"neutor",NA
"4/13/2015 4:00",2,1,7,15,3,"neutor",NA
"4/13/2015 5:00",38,13,7,19,51,"neutor",NA
"4/13/2015 6:00",127,39,5,9,166,"neutor",NA
"4/13/2015 7:00",589,217,6,9,806,"neutor",NA
"4/13/2015 8:00",682,507,7,13,1189,"neutor",NA
"4/13/2015 9:00",641,370,8,15,1011,"neutor",NA
"4/13/2015 10:00",546,480,9,15,1026,"neutor",NA
"4/13/2015 11:00",566,469,10,13,1035,"neutor",NA
"4/13/2015 12:00",562,520,11,19,1082,"neutor",NA
"4/13/2015 13:00",669,552,12,20,1221,"neutor",NA
"4/13/2015 14:00",588,580,12,15,1168,"neutor",NA
"4/13/2015 15:00",748,630,12,17,1378,"neutor",NA
"4/13/2015 16:00",681,714,12,19,1395,"neutor",NA
"4/13/2015 17:00",847,851,13,15,1698,"neutor",NA
"4/13/2015 18:00",671,766,12,13,1437,"neutor",NA
"4/13/2015 19:00",618,529,11,9,1147,"neutor",NA
"4/13/2015 20:00",312,509,9,7,821,"neutor",NA
"4/13/2015 21:00",192,270,8,7,462,"neutor",NA
"4/13/2015 22:00",149,286,6,4,435,"neutor",NA
"4/13/2015 23:00",89,168,5,2,257,"neutor",NA
"4/14/2015 0:00",35,78,4,2,113,"neutor",NA
"4/14/2015 1:00",22,53,3,2,75,"neutor",NA
"4/14/2015 2:00",6,15,4,4,21,"neutor",NA
"4/14/2015 3:00",8,0,3,6,8,"neutor",NA
"4/14/2015 4:00",5,2,2,4,7,"neutor",NA
"4/14/2015 5:00",50,6,2,6,56,"neutor",NA
"4/14/2015 6:00",137,53,2,4,190,"neutor",NA
"4/14/2015 7:00",693,280,5,4,973,"neutor",NA
"4/14/2015 8:00",926,619,8,7,1545,"neutor",NA
"4/14/2015 9:00",700,568,10,15,1268,"neutor",NA
"4/14/2015 10:00",670,693,13,15,1363,"neutor",NA
"4/14/2015 11:00",658,524,15,19,1182,"neutor",NA
"4/14/2015 12:00",668,608,17,26,1276,"neutor",NA
"4/14/2015 13:00",762,617,18,28,1379,"neutor",NA
"4/14/2015 14:00",662,696,18,26,1358,"neutor",NA
"4/14/2015 15:00",788,612,20,30,1400,"neutor",NA
"4/14/2015 16:00",814,791,21,30,1605,"neutor",NA
"4/14/2015 17:00",929,778,20,37,1707,"neutor",NA
"4/14/2015 18:00",718,903,19,28,1621,"neutor",NA
"4/14/2015 19:00",678,650,18,24,1328,"neutor",NA
"4/14/2015 20:00",489,466,15,15,955,"neutor",NA
"4/14/2015 21:00",266,358,13,9,624,"neutor",NA
"4/14/2015 22:00",155,382,12,7,537,"neutor",NA
"4/14/2015 23:00",100,186,12,4,286,"neutor",NA
"4/15/2015 0:00",37,107,11,4,144,"neutor",NA
"4/15/2015 1:00",19,94,9,7,113,"neutor",NA
"4/15/2015 2:00",19,10,9,7,29,"neutor",NA
"4/15/2015 3:00",5,8,8,7,13,"neutor",NA
"4/15/2015 4:00",8,6,8,6,14,"neutor",NA
"4/15/2015 5:00",40,14,6,6,54,"neutor",NA
"4/15/2015 6:00",150,54,5,2,204,"neutor",NA
"4/15/2015 7:00",861,261,10,7,1122,"neutor",NA
"4/15/2015 8:00",802,634,13,9,1436,"neutor",NA
"4/15/2015 9:00",789,462,15,15,1251,"neutor",NA
"4/15/2015 10:00",754,606,17,17,1360,"neutor",NA
"4/15/2015 11:00",713,475,19,19,1188,"neutor",NA
"4/15/2015 12:00",713,653,21,28,1366,"neutor",NA
"4/15/2015 13:00",791,544,22,26,1335,"neutor",NA
"4/15/2015 14:00",715,659,23,33,1374,"neutor",NA
"4/15/2015 15:00",789,706,23,33,1495,"neutor",NA
"4/15/2015 16:00",804,751,22,28,1555,"neutor",NA
"4/15/2015 17:00",831,825,21,22,1656,"neutor",NA
"4/15/2015 18:00",733,871,21,19,1604,"neutor",NA
"4/15/2015 19:00",700,721,20,13,1421,"neutor",NA
"4/15/2015 20:00",432,711,17,9,1143,"neutor",NA
"4/15/2015 21:00",278,524,15,15,802,"neutor",NA
"4/15/2015 22:00",282,448,12,9,730,"neutor",NA
"4/15/2015 23:00",188,312,10,15,500,"neutor",NA
"4/16/2015 0:00",141,146,8,7,287,"neutor",NA
"4/16/2015 1:00",46,130,7,9,176,"neutor",NA
"4/16/2015 2:00",23,131,8,9,154,"neutor",NA
"4/16/2015 3:00",13,97,8,6,110,"neutor",NA
"4/16/2015 4:00",21,82,8,4,103,"neutor",NA
"4/16/2015 5:00",32,29,8,4,61,"neutor",NA
"4/16/2015 6:00",111,43,8,7,154,"neutor",NA
"4/16/2015 7:00",580,271,9,13,851,"neutor",NA
"4/16/2015 8:00",765,575,9,11,1340,"neutor",NA
"4/16/2015 9:00",616,402,9,11,1018,"neutor",NA
"4/16/2015 10:00",592,507,10,9,1099,"neutor",NA
"4/16/2015 11:00",577,394,11,9,971,"neutor",NA
"4/16/2015 12:00",524,584,11,7,1108,"neutor",NA
"4/16/2015 13:00",644,647,12,11,1291,"neutor",NA
"4/16/2015 14:00",492,651,12,7,1143,"neutor",NA
"4/16/2015 15:00",705,540,13,7,1245,"neutor",NA
"4/16/2015 16:00",692,617,13,7,1309,"neutor",NA
"4/16/2015 17:00",717,690,12,11,1407,"neutor",NA
"4/16/2015 18:00",612,756,11,15,1368,"neutor",NA
"4/16/2015 19:00",515,582,11,11,1097,"neutor",NA
"4/16/2015 20:00",372,398,10,7,770,"neutor",NA
"4/16/2015 21:00",263,238,9,13,501,"neutor",NA
"4/16/2015 22:00",206,261,9,9,467,"neutor",NA
"4/16/2015 23:00",103,172,8,11,275,"neutor",NA
"4/17/2015 0:00",67,106,8,13,173,"neutor",NA
"4/17/2015 1:00",19,59,7,6,78,"neutor",NA
"4/17/2015 2:00",6,45,7,9,51,"neutor",NA
"4/17/2015 3:00",7,50,6,9,57,"neutor",NA
"4/17/2015 4:00",9,56,5,4,65,"neutor",NA
"4/17/2015 5:00",31,36,5,6,67,"neutor",NA
"4/17/2015 6:00",139,40,4,6,179,"neutor",NA
"4/17/2015 7:00",501,229,6,6,730,"neutor",NA
"4/17/2015 8:00",641,460,7,6,1101,"neutor",NA
"4/17/2015 9:00",535,385,7,9,920,"neutor",NA
"4/17/2015 10:00",460,405,9,9,865,"neutor",NA
"4/17/2015 11:00",488,319,10,11,807,"neutor",NA
"4/17/2015 12:00",568,488,10,11,1056,"neutor",NA
"4/17/2015 13:00",554,556,10,11,1110,"neutor",NA
"4/17/2015 14:00",482,463,11,15,945,"neutor",NA
"4/17/2015 15:00",523,420,12,17,943,"neutor",NA
"4/17/2015 16:00",468,369,12,13,837,"neutor",NA
"4/17/2015 17:00",484,431,12,13,915,"neutor",NA
"4/17/2015 18:00",452,453,11,17,905,"neutor",NA
"4/17/2015 19:00",407,423,10,13,830,"neutor",NA
"4/17/2015 20:00",375,349,8,7,724,"neutor",NA
"4/17/2015 21:00",246,272,7,6,518,"neutor",NA
"4/17/2015 22:00",175,216,7,11,391,"neutor",NA
"4/17/2015 23:00",122,206,5,9,328,"neutor",NA
"4/18/2015 0:00",127,205,4,9,332,"neutor",NA
"4/18/2015 1:00",112,172,4,9,284,"neutor",NA
"4/18/2015 2:00",67,130,3,7,197,"neutor",NA
"4/18/2015 3:00",63,92,2,6,155,"neutor",NA
"4/18/2015 4:00",30,57,2,2,87,"neutor",NA
"4/18/2015 5:00",38,30,0,4,68,"neutor",NA
"4/18/2015 6:00",37,19,0,4,56,"neutor",NA
"4/18/2015 7:00",104,25,3,4,129,"neutor",NA
"4/18/2015 8:00",155,71,7,7,226,"neutor",NA
"4/18/2015 9:00",347,109,9,11,456,"neutor",NA
"4/18/2015 10:00",383,153,10,19,536,"neutor",NA
"4/18/2015 11:00",412,237,12,19,649,"neutor",NA
"4/18/2015 12:00",490,274,13,13,764,"neutor",NA
"4/18/2015 13:00",457,280,12,9,737,"neutor",NA
"4/18/2015 14:00",362,350,13,11,712,"neutor",NA
"4/18/2015 15:00",379,350,13,9,729,"neutor",NA
"4/18/2015 16:00",389,402,13,9,791,"neutor",NA
"4/18/2015 17:00",352,425,13,9,777,"neutor",NA
"4/18/2015 18:00",416,492,14,7,908,"neutor",NA
"4/18/2015 19:00",349,363,12,9,712,"neutor",NA
"4/18/2015 20:00",314,363,9,7,677,"neutor",NA
"4/18/2015 21:00",245,245,9,7,490,"neutor",NA
"4/18/2015 22:00",163,235,7,13,398,"neutor",NA
"4/18/2015 23:00",151,178,6,11,329,"neutor",NA
"4/19/2015 0:00",106,175,5,9,281,"neutor",NA
"4/19/2015 1:00",97,152,4,6,249,"neutor",NA
"4/19/2015 2:00",71,144,3,4,215,"neutor",NA
"4/19/2015 3:00",44,120,2,0,164,"neutor",NA
"4/19/2015 4:00",35,80,2,2,115,"neutor",NA
"4/19/2015 5:00",26,48,1,2,74,"neutor",NA
"4/19/2015 6:00",31,18,1,2,49,"neutor",NA
"4/19/2015 7:00",31,13,1,2,44,"neutor",NA
"4/19/2015 8:00",68,37,4,2,105,"neutor",NA
"4/19/2015 9:00",158,67,6,7,225,"neutor",NA
"4/19/2015 10:00",259,109,8,4,368,"neutor",NA
"4/19/2015 11:00",232,132,10,6,364,"neutor",NA
"4/19/2015 12:00",290,216,12,4,506,"neutor",NA
"4/19/2015 13:00",355,253,13,6,608,"neutor",NA
"4/19/2015 14:00",404,256,14,6,660,"neutor",NA
"4/19/2015 15:00",434,325,15,2,759,"neutor",NA
"4/19/2015 16:00",435,298,15,2,733,"neutor",NA
"4/19/2015 17:00",409,332,15,11,741,"neutor",NA
"4/19/2015 18:00",339,351,15,9,690,"neutor",NA
"4/19/2015 19:00",260,337,14,13,597,"neutor",NA
"4/19/2015 20:00",209,307,11,9,516,"neutor",NA
"4/19/2015 21:00",123,185,9,11,308,"neutor",NA
"4/19/2015 22:00",95,182,8,6,277,"neutor",NA
"4/19/2015 23:00",51,116,8,4,167,"neutor",NA
"4/20/2015 0:00",13,44,7,4,57,"neutor",NA
"4/20/2015 1:00",6,30,5,4,36,"neutor",NA
"4/20/2015 2:00",4,14,5,4,18,"neutor",NA
"4/20/2015 3:00",3,3,4,4,6,"neutor",NA
"4/20/2015 4:00",6,1,4,4,7,"neutor",NA
"4/20/2015 5:00",36,20,3,6,56,"neutor",NA
"4/20/2015 6:00",121,41,3,4,162,"neutor",NA
"4/20/2015 7:00",596,222,7,2,818,"neutor",NA
"4/20/2015 8:00",649,514,10,4,1163,"neutor",NA
"4/20/2015 9:00",652,373,12,6,1025,"neutor",NA
"4/20/2015 10:00",599,536,13,11,1135,"neutor",NA
"4/20/2015 11:00",593,420,15,15,1013,"neutor",NA
"4/20/2015 12:00",609,619,16,11,1228,"neutor",NA
"4/20/2015 13:00",633,614,17,7,1247,"neutor",NA
"4/20/2015 14:00",608,622,18,13,1230,"neutor",NA
"4/20/2015 15:00",791,639,18,11,1430,"neutor",NA
"4/20/2015 16:00",858,776,19,13,1634,"neutor",NA
"4/20/2015 17:00",1006,867,18,13,1873,"neutor",NA
"4/20/2015 18:00",945,922,18,13,1867,"neutor",NA
"4/20/2015 19:00",852,683,17,13,1535,"neutor",NA
"4/20/2015 20:00",454,528,14,9,982,"neutor",NA
"4/20/2015 21:00",256,403,12,9,659,"neutor",NA
"4/20/2015 22:00",162,313,11,7,475,"neutor",NA
"4/20/2015 23:00",84,195,10,4,279,"neutor",NA
"4/21/2015 0:00",30,150,8,4,180,"neutor",NA
"4/21/2015 1:00",17,178,7,6,195,"neutor",NA
"4/21/2015 2:00",10,87,6,4,97,"neutor",NA
"4/21/2015 3:00",5,35,5,6,40,"neutor",NA
"4/21/2015 4:00",8,19,4,7,27,"neutor",NA
"4/21/2015 5:00",37,27,4,7,64,"neutor",NA
"4/21/2015 6:00",141,47,4,6,188,"neutor",NA
"4/21/2015 7:00",671,283,6,4,954,"neutor",NA
"4/21/2015 8:00",902,591,9,6,1493,"neutor",NA
"4/21/2015 9:00",714,515,12,7,1229,"neutor",NA
"4/21/2015 10:00",705,657,14,11,1362,"neutor",NA
"4/21/2015 11:00",578,573,16,9,1151,"neutor",NA
"4/21/2015 12:00",669,580,18,11,1249,"neutor",NA
"4/21/2015 13:00",723,570,19,13,1293,"neutor",NA
"4/21/2015 14:00",673,756,20,17,1429,"neutor",NA
"4/21/2015 15:00",872,623,20,20,1495,"neutor",NA
"4/21/2015 16:00",902,879,19,22,1781,"neutor",NA
"4/21/2015 17:00",1061,913,18,22,1974,"neutor",NA
"4/21/2015 18:00",886,947,17,15,1833,"neutor",NA
"4/21/2015 19:00",792,726,15,17,1518,"neutor",NA
"4/21/2015 20:00",565,641,11,20,1206,"neutor",NA
"4/21/2015 21:00",260,392,8,17,652,"neutor",NA
"4/21/2015 22:00",183,451,7,19,634,"neutor",NA
"4/21/2015 23:00",111,288,6,7,399,"neutor",NA
"4/22/2015 0:00",83,117,5,6,200,"neutor",NA
"4/22/2015 1:00",20,61,4,7,81,"neutor",NA
"4/22/2015 2:00",3,38,5,6,41,"neutor",NA
"4/22/2015 3:00",6,38,5,6,44,"neutor",NA
"4/22/2015 4:00",13,21,6,7,34,"neutor",NA
"4/22/2015 5:00",35,19,6,9,54,"neutor",NA
"4/22/2015 6:00",128,39,6,11,167,"neutor",NA
"4/22/2015 7:00",765,207,6,15,972,"neutor",NA
"4/22/2015 8:00",847,624,7,13,1471,"neutor",NA
"4/22/2015 9:00",617,436,8,17,1053,"neutor",NA
"4/22/2015 10:00",689,626,9,19,1315,"neutor",NA
"4/22/2015 11:00",647,376,9,17,1023,"neutor",NA
"4/22/2015 12:00",606,593,11,17,1199,"neutor",NA
"4/22/2015 13:00",653,498,12,20,1151,"neutor",NA
"4/22/2015 14:00",606,665,12,17,1271,"neutor",NA
"4/22/2015 15:00",603,561,13,13,1164,"neutor",NA
"4/22/2015 16:00",668,757,13,13,1425,"neutor",NA
"4/22/2015 17:00",760,640,13,9,1400,"neutor",NA
"4/22/2015 18:00",755,795,14,9,1550,"neutor",NA
"4/22/2015 19:00",764,544,13,7,1308,"neutor",NA
"4/22/2015 20:00",505,503,12,9,1008,"neutor",NA
"4/22/2015 21:00",269,443,10,9,712,"neutor",NA
"4/22/2015 22:00",252,430,8,9,682,"neutor",NA
"4/22/2015 23:00",160,263,7,7,423,"neutor",NA
"4/23/2015 0:00",169,175,5,7,344,"neutor",NA
"4/23/2015 1:00",71,94,4,0,165,"neutor",NA
"4/23/2015 2:00",49,80,3,4,129,"neutor",NA
"4/23/2015 3:00",19,106,2,2,125,"neutor",NA
"4/23/2015 4:00",23,72,5,7,95,"neutor",NA
"4/23/2015 5:00",48,55,5,7,103,"neutor",NA
"4/23/2015 6:00",128,47,5,6,175,"neutor",NA
"4/23/2015 7:00",542,236,5,6,778,"neutor",NA
"4/23/2015 8:00",814,576,5,7,1390,"neutor",NA
"4/23/2015 9:00",590,331,6,4,921,"neutor",NA
"4/23/2015 10:00",532,540,7,4,1072,"neutor",NA
"4/23/2015 11:00",538,362,8,4,900,"neutor",NA
"4/23/2015 12:00",512,603,10,4,1115,"neutor",NA
"4/23/2015 13:00",634,526,12,11,1160,"neutor",NA
"4/23/2015 14:00",663,655,12,9,1318,"neutor",NA
"4/23/2015 15:00",690,522,13,7,1212,"neutor",NA
"4/23/2015 16:00",781,693,15,6,1474,"neutor",NA
"4/23/2015 17:00",839,753,15,9,1592,"neutor",NA
"4/23/2015 18:00",774,825,16,4,1599,"neutor",NA
"4/23/2015 19:00",719,648,15,2,1367,"neutor",NA
"4/23/2015 20:00",501,530,12,0,1031,"neutor",NA
"4/23/2015 21:00",321,387,9,4,708,"neutor",NA
"4/23/2015 22:00",218,323,7,4,541,"neutor",NA
"4/23/2015 23:00",120,318,6,2,438,"neutor",NA
"4/24/2015 0:00",57,170,5,2,227,"neutor",NA
"4/24/2015 1:00",39,88,4,2,127,"neutor",NA
"4/24/2015 2:00",30,49,3,2,79,"neutor",NA
"4/24/2015 3:00",9,21,3,2,30,"neutor",NA
"4/24/2015 4:00",16,15,2,2,31,"neutor",NA
"4/24/2015 5:00",43,16,2,2,59,"neutor",NA
"4/24/2015 6:00",110,33,2,4,143,"neutor",NA
"4/24/2015 7:00",511,228,5,4,739,"neutor",NA
"4/24/2015 8:00",615,448,8,7,1063,"neutor",NA
"4/24/2015 9:00",523,318,11,7,841,"neutor",NA
"4/24/2015 10:00",485,404,14,4,889,"neutor",NA
"4/24/2015 11:00",550,380,16,13,930,"neutor",NA
"4/24/2015 12:00",623,522,17,15,1145,"neutor",NA
"4/24/2015 13:00",589,565,19,17,1154,"neutor",NA
"4/24/2015 14:00",533,580,19,17,1113,"neutor",NA
"4/24/2015 15:00",625,516,20,15,1141,"neutor",NA
"4/24/2015 16:00",536,467,20,20,1003,"neutor",NA
"4/24/2015 17:00",665,501,20,11,1166,"neutor",NA
"4/24/2015 18:00",612,511,19,17,1123,"neutor",NA
"4/24/2015 19:00",632,424,18,6,1056,"neutor",NA
"4/24/2015 20:00",623,393,16,6,1016,"neutor",NA
"4/24/2015 21:00",325,383,14,4,708,"neutor",NA
"4/24/2015 22:00",188,466,13,4,654,"neutor",NA
"4/24/2015 23:00",170,376,11,6,546,"neutor",NA
"4/25/2015 0:00",146,279,10,6,425,"neutor",NA
"4/25/2015 1:00",110,165,11,6,275,"neutor",NA
"4/25/2015 2:00",51,123,10,6,174,"neutor",NA
"4/25/2015 3:00",27,122,12,13,149,"neutor",NA
"4/25/2015 4:00",44,76,12,6,120,"neutor",NA
"4/25/2015 5:00",30,33,12,7,63,"neutor",NA
"4/25/2015 6:00",53,21,12,6,74,"neutor",NA
"4/25/2015 7:00",81,32,12,9,113,"neutor",NA
"4/25/2015 8:00",164,61,12,11,225,"neutor",NA
"4/25/2015 9:00",240,132,12,7,372,"neutor",NA
"4/25/2015 10:00",201,105,11,19,306,"neutor",NA
"4/25/2015 11:00",250,144,11,13,394,"neutor",NA
"4/25/2015 12:00",280,211,13,15,491,"neutor",NA
"4/25/2015 13:00",349,226,14,17,575,"neutor",NA
"4/25/2015 14:00",323,229,14,15,552,"neutor",NA
"4/25/2015 15:00",289,266,15,11,555,"neutor",NA
"4/25/2015 16:00",271,269,15,17,540,"neutor",NA
"4/25/2015 17:00",305,254,15,15,559,"neutor",NA
"4/25/2015 18:00",273,322,14,19,595,"neutor",NA
"4/25/2015 19:00",188,230,14,15,418,"neutor",NA
"4/25/2015 20:00",267,240,13,11,507,"neutor",NA
"4/25/2015 21:00",217,214,13,9,431,"neutor",NA
"4/25/2015 22:00",152,199,13,9,351,"neutor",NA
"4/25/2015 23:00",105,156,13,9,261,"neutor",NA
"4/26/2015 0:00",100,171,12,7,271,"neutor",NA
"4/26/2015 1:00",79,117,11,7,196,"neutor",NA
"4/26/2015 2:00",54,103,10,6,157,"neutor",NA
"4/26/2015 3:00",66,108,11,6,174,"neutor",NA
"4/26/2015 4:00",17,70,11,9,87,"neutor",NA
"4/26/2015 5:00",18,59,11,7,77,"neutor",NA
"4/26/2015 6:00",25,20,11,7,45,"neutor",NA
"4/26/2015 7:00",26,10,11,7,36,"neutor",NA
"4/26/2015 8:00",53,25,12,9,78,"neutor",NA
"4/26/2015 9:00",124,34,13,15,158,"neutor",NA
"4/26/2015 10:00",185,86,14,15,271,"neutor",NA
"4/26/2015 11:00",193,121,15,11,314,"neutor",NA
"4/26/2015 12:00",233,141,16,24,374,"neutor",NA
"4/26/2015 13:00",207,186,17,24,393,"neutor",NA
"4/26/2015 14:00",281,193,16,17,474,"neutor",NA
"4/26/2015 15:00",273,255,16,17,528,"neutor",NA
"4/26/2015 16:00",322,265,15,9,587,"neutor",NA
"4/26/2015 17:00",256,291,15,13,547,"neutor",NA
"4/26/2015 18:00",227,267,12,13,494,"neutor",NA
"4/26/2015 19:00",183,228,11,7,411,"neutor",NA
"4/26/2015 20:00",136,253,11,7,389,"neutor",NA
"4/26/2015 21:00",92,142,11,9,234,"neutor",NA
"4/26/2015 22:00",98,166,10,11,264,"neutor",NA
"4/26/2015 23:00",50,66,10,11,116,"neutor",NA
"4/27/2015 0:00",22,34,9,9,56,"neutor",NA
"4/27/2015 1:00",7,20,9,9,27,"neutor",NA
"4/27/2015 2:00",1,5,9,9,6,"neutor",NA
"4/27/2015 3:00",4,6,8,13,10,"neutor",NA
"4/27/2015 4:00",4,3,8,13,7,"neutor",NA
"4/27/2015 5:00",34,9,8,15,43,"neutor",NA
"4/27/2015 6:00",88,26,7,15,114,"neutor",NA
"4/27/2015 7:00",411,156,6,19,567,"neutor",NA
"4/27/2015 8:00",536,432,7,11,968,"neutor",NA
"4/27/2015 9:00",476,337,7,11,813,"neutor",NA
"4/27/2015 10:00",458,426,8,17,884,"neutor",NA
"4/27/2015 11:00",438,343,9,19,781,"neutor",NA
"4/27/2015 12:00",510,508,9,13,1018,"neutor",NA
"4/27/2015 13:00",510,522,10,13,1032,"neutor",NA
"4/27/2015 14:00",496,490,11,13,986,"neutor",NA
"4/27/2015 15:00",596,530,12,15,1126,"neutor",NA
"4/27/2015 16:00",619,619,12,19,1238,"neutor",NA
"4/27/2015 17:00",691,715,11,15,1406,"neutor",NA
"4/27/2015 18:00",629,697,11,11,1326,"neutor",NA
"4/27/2015 19:00",510,490,10,11,1000,"neutor",NA
"4/27/2015 20:00",322,441,9,11,763,"neutor",NA
"4/27/2015 21:00",170,264,7,13,434,"neutor",NA
"4/27/2015 22:00",134,261,6,7,395,"neutor",NA
"4/27/2015 23:00",71,164,5,6,235,"neutor",NA
"4/28/2015 0:00",39,80,4,6,119,"neutor",NA
"4/28/2015 1:00",11,41,2,6,52,"neutor",NA
"4/28/2015 2:00",7,14,1,4,21,"neutor",NA
"4/28/2015 3:00",4,4,0,4,8,"neutor",NA
"4/28/2015 4:00",7,4,-1,2,11,"neutor",NA
"4/28/2015 5:00",35,11,-1,2,46,"neutor",NA
"4/28/2015 6:00",124,43,0,2,167,"neutor",NA
"4/28/2015 7:00",598,203,1,4,801,"neutor",NA
"4/28/2015 8:00",933,555,4,2,1488,"neutor",NA
"4/28/2015 9:00",583,462,7,11,1045,"neutor",NA
"4/28/2015 10:00",548,617,8,11,1165,"neutor",NA
"4/28/2015 11:00",584,445,10,11,1029,"neutor",NA
"4/28/2015 12:00",543,531,11,19,1074,"neutor",NA
"4/28/2015 13:00",643,539,11,19,1182,"neutor",NA
"4/28/2015 14:00",497,511,6,30,1008,"neutor",NA
"4/28/2015 15:00",541,533,9,17,1074,"neutor",NA
"4/28/2015 16:00",677,736,9,15,1413,"neutor",NA
"4/28/2015 17:00",793,700,9,7,1493,"neutor",NA
"4/28/2015 18:00",657,748,10,24,1405,"neutor",NA
"4/28/2015 19:00",714,593,9,15,1307,"neutor",NA
"4/28/2015 20:00",468,485,8,11,953,"neutor",NA
"4/28/2015 21:00",200,262,6,6,462,"neutor",NA
"4/28/2015 22:00",131,294,4,2,425,"neutor",NA
"4/28/2015 23:00",152,452,3,2,604,"neutor",NA
"4/29/2015 0:00",63,173,2,4,236,"neutor",NA
"4/29/2015 1:00",41,65,2,4,106,"neutor",NA
"4/29/2015 2:00",43,35,0,4,78,"neutor",NA
"4/29/2015 3:00",39,8,1,7,47,"neutor",NA
"4/29/2015 4:00",19,8,1,6,27,"neutor",NA
"4/29/2015 5:00",35,29,0,6,64,"neutor",NA
"4/29/2015 6:00",139,39,1,6,178,"neutor",NA
"4/29/2015 7:00",671,243,2,9,914,"neutor",NA
"4/29/2015 8:00",738,603,5,13,1341,"neutor",NA
"4/29/2015 9:00",693,437,9,9,1130,"neutor",NA
"4/29/2015 10:00",684,609,11,15,1293,"neutor",NA
"4/29/2015 11:00",624,382,12,15,1006,"neutor",NA
"4/29/2015 12:00",664,558,13,19,1222,"neutor",NA
"4/29/2015 13:00",622,492,13,17,1114,"neutor",NA
"4/29/2015 14:00",561,630,14,15,1191,"neutor",NA
"4/29/2015 15:00",574,505,14,19,1079,"neutor",NA
"4/29/2015 16:00",610,718,14,11,1328,"neutor",NA
"4/29/2015 17:00",720,646,14,13,1366,"neutor",NA
"4/29/2015 18:00",698,742,14,15,1440,"neutor",NA
"4/29/2015 19:00",609,565,13,13,1174,"neutor",NA
"4/29/2015 20:00",337,452,12,6,789,"neutor",NA
"4/29/2015 21:00",226,312,11,7,538,"neutor",NA
"4/29/2015 22:00",193,323,10,6,516,"neutor",NA
"4/29/2015 23:00",94,239,9,7,333,"neutor",NA
"4/30/2015 0:00",46,135,9,9,181,"neutor",NA
"4/30/2015 1:00",31,67,9,7,98,"neutor",NA
"4/30/2015 2:00",12,39,9,26,51,"neutor",NA
"4/30/2015 3:00",10,26,8,6,36,"neutor",NA
"4/30/2015 4:00",10,17,8,7,27,"neutor",NA
"4/30/2015 5:00",35,12,8,7,47,"neutor",NA
"4/30/2015 6:00",92,40,8,9,132,"neutor",NA
"4/30/2015 7:00",445,180,8,11,625,"neutor",NA
"4/30/2015 8:00",706,570,10,15,1276,"neutor",NA
"4/30/2015 9:00",590,352,11,20,942,"neutor",NA
"4/30/2015 10:00",607,530,11,22,1137,"neutor",NA
"4/30/2015 11:00",511,360,12,24,871,"neutor",NA
"4/30/2015 12:00",525,556,12,19,1081,"neutor",NA
"4/30/2015 13:00",557,513,13,20,1070,"neutor",NA
"4/30/2015 14:00",531,584,13,17,1115,"neutor",NA
"4/30/2015 15:00",623,488,13,11,1111,"neutor",NA
"4/30/2015 16:00",625,586,14,22,1211,"neutor",NA
"4/30/2015 17:00",586,572,7,26,1158,"neutor",NA
"4/30/2015 18:00",401,480,9,6,881,"neutor",NA
"4/30/2015 19:00",421,372,8,6,793,"neutor",NA
"4/30/2015 20:00",377,299,9,7,676,"neutor",NA
"4/30/2015 21:00",341,263,8,7,604,"neutor",NA
"4/30/2015 22:00",284,159,7,7,443,"neutor",NA
"4/30/2015 23:00",203,117,5,6,320,"neutor",NA
"5/1/2015 0:00",204,157,4,6,361,"neutor",NA
"5/1/2015 1:00",155,195,3,4,350,"neutor",NA
"5/1/2015 2:00",63,205,2,2,268,"neutor",NA
"5/1/2015 3:00",49,215,1,2,264,"neutor",NA
"5/1/2015 4:00",28,128,1,2,156,"neutor",NA
"5/1/2015 5:00",28,82,3,7,110,"neutor",NA
"5/1/2015 6:00",22,34,3,6,56,"neutor",NA
"5/1/2015 7:00",51,20,5,9,71,"neutor",NA
"5/1/2015 8:00",55,23,7,11,78,"neutor",NA
"5/1/2015 9:00",133,76,9,7,209,"neutor",NA
"5/1/2015 10:00",186,135,9,9,321,"neutor",NA
"5/1/2015 11:00",260,181,10,9,441,"neutor",NA
"5/1/2015 12:00",292,189,11,9,481,"neutor",NA
"5/1/2015 13:00",306,203,12,6,509,"neutor",NA
"5/1/2015 14:00",368,217,12,4,585,"neutor",NA
"5/1/2015 15:00",249,210,12,6,459,"neutor",NA
"5/1/2015 16:00",288,213,13,7,501,"neutor",NA
"5/1/2015 17:00",319,221,12,9,540,"neutor",NA
"5/1/2015 18:00",264,271,12,7,535,"neutor",NA
"5/1/2015 19:00",263,226,12,11,489,"neutor",NA
"5/1/2015 20:00",189,256,9,6,445,"neutor",NA
"5/1/2015 21:00",125,183,8,9,308,"neutor",NA
"5/1/2015 22:00",134,181,7,9,315,"neutor",NA
"5/1/2015 23:00",89,193,6,7,282,"neutor",NA
"5/2/2015 0:00",52,136,5,7,188,"neutor",NA
"5/2/2015 1:00",29,109,4,2,138,"neutor",NA
"5/2/2015 2:00",35,85,4,2,120,"neutor",NA
"5/2/2015 3:00",27,33,3,2,60,"neutor",NA
"5/2/2015 4:00",14,16,2,2,30,"neutor",NA
"5/2/2015 5:00",31,12,1,2,43,"neutor",NA
"5/2/2015 6:00",43,10,1,2,53,"neutor",NA
"5/2/2015 7:00",90,24,4,2,114,"neutor",NA
"5/2/2015 8:00",123,48,7,4,171,"neutor",NA
"5/2/2015 9:00",283,67,9,4,350,"neutor",NA
"5/2/2015 10:00",392,135,10,2,527,"neutor",NA
"5/2/2015 11:00",422,204,11,4,626,"neutor",NA
"5/2/2015 12:00",433,271,11,6,704,"neutor",NA
"5/2/2015 13:00",384,269,12,4,653,"neutor",NA
"5/2/2015 14:00",288,345,14,6,633,"neutor",NA
"5/2/2015 15:00",349,351,14,6,700,"neutor",NA
"5/2/2015 16:00",249,310,15,7,559,"neutor",NA
"5/2/2015 17:00",248,325,15,4,573,"neutor",NA
"5/2/2015 18:00",254,362,15,4,616,"neutor",NA
"5/2/2015 19:00",277,313,14,4,590,"neutor",NA
"5/2/2015 20:00",201,230,12,6,431,"neutor",NA
"5/2/2015 21:00",135,172,10,6,307,"neutor",NA
"5/2/2015 22:00",95,125,10,9,220,"neutor",NA
"5/2/2015 23:00",85,182,10,9,267,"neutor",NA
"5/3/2015 0:00",61,128,11,9,189,"neutor",NA
"5/3/2015 1:00",61,96,10,11,157,"neutor",NA
"5/3/2015 2:00",32,91,9,11,123,"neutor",NA
"5/3/2015 3:00",27,70,9,11,97,"neutor",NA
"5/3/2015 4:00",4,19,9,9,23,"neutor",NA
"5/3/2015 5:00",20,25,8,9,45,"neutor",NA
"5/3/2015 6:00",23,17,9,9,40,"neutor",NA
"5/3/2015 7:00",31,18,11,11,49,"neutor",NA
"5/3/2015 8:00",60,13,12,17,73,"neutor",NA
"5/3/2015 9:00",154,37,14,11,191,"neutor",NA
"5/3/2015 10:00",229,105,16,13,334,"neutor",NA
"5/3/2015 11:00",209,101,17,15,310,"neutor",NA
"5/3/2015 12:00",293,155,18,15,448,"neutor",NA
"5/3/2015 13:00",350,188,18,15,538,"neutor",NA
"5/3/2015 14:00",319,244,18,13,563,"neutor",NA
"5/3/2015 15:00",233,265,17,13,498,"neutor",NA
"5/3/2015 16:00",139,229,15,15,368,"neutor",NA
"5/3/2015 17:00",100,227,14,11,327,"neutor",NA
"5/3/2015 18:00",107,240,14,13,347,"neutor",NA
"5/3/2015 19:00",102,156,15,11,258,"neutor",NA
"5/3/2015 20:00",67,140,15,15,207,"neutor",NA
"5/3/2015 21:00",42,83,15,11,125,"neutor",NA
"5/3/2015 22:00",65,98,15,11,163,"neutor",NA
"5/3/2015 23:00",37,70,15,13,107,"neutor",NA
"5/4/2015 0:00",18,40,15,13,58,"neutor",NA
"5/4/2015 1:00",7,14,14,13,21,"neutor",NA
"5/4/2015 2:00",2,5,14,13,7,"neutor",NA
"5/4/2015 3:00",3,0,13,13,3,"neutor",NA
"5/4/2015 4:00",6,4,13,13,10,"neutor",NA
"5/4/2015 5:00",38,12,13,13,50,"neutor",NA
"5/4/2015 6:00",105,34,13,11,139,"neutor",NA
"5/4/2015 7:00",525,176,13,9,701,"neutor",NA
"5/4/2015 8:00",580,466,15,11,1046,"neutor",NA
"5/4/2015 9:00",528,332,14,9,860,"neutor",NA
"5/4/2015 10:00",532,451,16,15,983,"neutor",NA
"5/4/2015 11:00",451,346,17,20,797,"neutor",NA
"5/4/2015 12:00",505,547,17,15,1052,"neutor",NA
"5/4/2015 13:00",499,515,18,13,1014,"neutor",NA
"5/4/2015 14:00",505,593,18,15,1098,"neutor",NA
"5/4/2015 15:00",595,536,19,17,1131,"neutor",NA
"5/4/2015 16:00",662,716,19,9,1378,"neutor",NA
"5/4/2015 17:00",759,742,19,13,1501,"neutor",NA
"5/4/2015 18:00",686,808,19,7,1494,"neutor",NA
"5/4/2015 19:00",551,519,19,2,1070,"neutor",NA
"5/4/2015 20:00",381,490,17,7,871,"neutor",NA
"5/4/2015 21:00",260,343,16,7,603,"neutor",NA
"5/4/2015 22:00",179,324,16,9,503,"neutor",NA
"5/4/2015 23:00",70,175,17,11,245,"neutor",NA
"5/5/2015 0:00",43,73,16,9,116,"neutor",NA
"5/5/2015 1:00",9,37,15,11,46,"neutor",NA
"5/5/2015 2:00",4,6,14,13,10,"neutor",NA
"5/5/2015 3:00",3,6,14,13,9,"neutor",NA
"5/5/2015 4:00",4,3,14,13,7,"neutor",NA
"5/5/2015 5:00",41,13,14,9,54,"neutor",NA
"5/5/2015 6:00",125,40,15,13,165,"neutor",NA
"5/5/2015 7:00",588,214,18,17,802,"neutor",NA
"5/5/2015 8:00",817,565,19,19,1382,"neutor",NA
"5/5/2015 9:00",501,461,20,22,962,"neutor",NA
"5/5/2015 10:00",521,567,19,17,1088,"neutor",NA
"5/5/2015 11:00",512,384,20,24,896,"neutor",NA
"5/5/2015 12:00",539,493,22,26,1032,"neutor",NA
"5/5/2015 13:00",573,521,24,33,1094,"neutor",NA
"5/5/2015 14:00",557,542,23,24,1099,"neutor",NA
"5/5/2015 15:00",481,439,19,24,920,"neutor",NA
"5/5/2015 16:00",533,651,15,35,1184,"neutor",NA
"5/5/2015 17:00",704,597,17,43,1301,"neutor",NA
"5/5/2015 18:00",551,692,17,33,1243,"neutor",NA
"5/5/2015 19:00",639,620,16,24,1259,"neutor",NA
"5/5/2015 20:00",437,424,15,11,861,"neutor",NA
"5/5/2015 21:00",259,283,13,7,542,"neutor",NA
"5/5/2015 22:00",160,323,11,7,483,"neutor",NA
"5/5/2015 23:00",78,222,11,9,300,"neutor",NA
"5/6/2015 0:00",53,102,10,9,155,"neutor",NA
"5/6/2015 1:00",15,61,11,11,76,"neutor",NA
"5/6/2015 2:00",11,11,11,9,22,"neutor",NA
"5/6/2015 3:00",5,6,11,11,11,"neutor",NA
"5/6/2015 4:00",10,1,11,11,11,"neutor",NA
"5/6/2015 5:00",42,22,11,11,64,"neutor",NA
"5/6/2015 6:00",139,39,11,11,178,"neutor",NA
"5/6/2015 7:00",603,216,12,17,819,"neutor",NA
"5/6/2015 8:00",779,604,13,19,1383,"neutor",NA
"5/6/2015 9:00",624,423,14,24,1047,"neutor",NA
"5/6/2015 10:00",607,611,15,26,1218,"neutor",NA
"5/6/2015 11:00",598,357,16,22,955,"neutor",NA
"5/6/2015 12:00",565,525,16,26,1090,"neutor",NA
"5/6/2015 13:00",553,545,17,24,1098,"neutor",NA
"5/6/2015 14:00",519,617,17,28,1136,"neutor",NA
"5/6/2015 15:00",474,516,12,33,990,"neutor",NA
"5/6/2015 16:00",598,615,16,28,1213,"neutor",NA
"5/6/2015 17:00",743,663,17,33,1406,"neutor",NA
"5/6/2015 18:00",629,649,12,54,1278,"neutor",NA
"5/6/2015 19:00",584,486,13,15,1070,"neutor",NA
"5/6/2015 20:00",467,448,12,11,915,"neutor",NA
"5/6/2015 21:00",201,241,10,17,442,"neutor",NA
"5/6/2015 22:00",203,333,10,13,536,"neutor",NA
"5/6/2015 23:00",175,337,11,15,512,"neutor",NA
"5/7/2015 0:00",75,107,11,24,182,"neutor",NA
"5/7/2015 1:00",29,121,11,20,150,"neutor",NA
"5/7/2015 2:00",15,85,11,20,100,"neutor",NA
"5/7/2015 3:00",21,52,10,17,73,"neutor",NA
"5/7/2015 4:00",18,27,10,22,45,"neutor",NA
"5/7/2015 5:00",34,19,10,22,53,"neutor",NA
"5/7/2015 6:00",131,38,10,22,169,"neutor",NA
"5/7/2015 7:00",522,219,10,20,741,"neutor",NA
"5/7/2015 8:00",767,536,11,20,1303,"neutor",NA
"5/7/2015 9:00",491,352,11,22,843,"neutor",NA
"5/7/2015 10:00",482,467,11,20,949,"neutor",NA
"5/7/2015 11:00",378,317,12,19,695,"neutor",NA
"5/7/2015 12:00",411,495,13,22,906,"neutor",NA
"5/7/2015 13:00",499,443,13,28,942,"neutor",NA
"5/7/2015 14:00",443,490,14,24,933,"neutor",NA
"5/7/2015 15:00",582,478,15,30,1060,"neutor",NA
"5/7/2015 16:00",605,634,15,15,1239,"neutor",NA
"5/7/2015 17:00",600,581,14,20,1181,"neutor",NA
"5/7/2015 18:00",566,618,14,13,1184,"neutor",NA
"5/7/2015 19:00",527,525,14,15,1052,"neutor",NA
"5/7/2015 20:00",317,355,13,7,672,"neutor",NA
"5/7/2015 21:00",338,304,10,4,642,"neutor",NA
"5/7/2015 22:00",198,194,9,4,392,"neutor",NA
"5/7/2015 23:00",215,192,8,2,407,"neutor",NA
"5/8/2015 0:00",155,103,8,6,258,"neutor",NA
"5/8/2015 1:00",30,110,8,4,140,"neutor",NA
"5/8/2015 2:00",6,147,8,2,153,"neutor",NA
"5/8/2015 3:00",5,125,7,2,130,"neutor",NA
"5/8/2015 4:00",19,47,8,4,66,"neutor",NA
"5/8/2015 5:00",42,45,8,4,87,"neutor",NA
"5/8/2015 6:00",138,40,8,4,178,"neutor",NA
"5/8/2015 7:00",495,178,10,6,673,"neutor",NA
"5/8/2015 8:00",614,423,11,6,1037,"neutor",NA
"5/8/2015 9:00",492,368,13,6,860,"neutor",NA
"5/8/2015 10:00",511,399,14,9,910,"neutor",NA
"5/8/2015 11:00",483,332,16,7,815,"neutor",NA
"5/8/2015 12:00",529,477,17,4,1006,"neutor",NA
"5/8/2015 13:00",546,553,17,7,1099,"neutor",NA
"5/8/2015 14:00",548,552,18,7,1100,"neutor",NA
"5/8/2015 15:00",517,504,18,7,1021,"neutor",NA
"5/8/2015 16:00",551,459,19,4,1010,"neutor",NA
"5/8/2015 17:00",545,481,19,4,1026,"neutor",NA
"5/8/2015 18:00",509,562,18,0,1071,"neutor",NA
"5/8/2015 19:00",447,476,17,4,923,"neutor",NA
"5/8/2015 20:00",329,330,16,4,659,"neutor",NA
"5/8/2015 21:00",250,227,14,2,477,"neutor",NA
"5/8/2015 22:00",177,289,12,2,466,"neutor",NA
"5/8/2015 23:00",122,221,11,2,343,"neutor",NA
"5/9/2015 0:00",134,171,12,2,305,"neutor",NA
"5/9/2015 1:00",116,170,12,2,286,"neutor",NA
"5/9/2015 2:00",45,119,12,4,164,"neutor",NA
"5/9/2015 3:00",49,110,12,6,159,"neutor",NA
"5/9/2015 4:00",12,48,13,7,60,"neutor",NA
"5/9/2015 5:00",30,53,14,9,83,"neutor",NA
"5/9/2015 6:00",43,23,14,11,66,"neutor",NA
"5/9/2015 7:00",116,30,15,13,146,"neutor",NA
"5/9/2015 8:00",195,108,15,17,303,"neutor",NA
"5/9/2015 9:00",291,132,15,24,423,"neutor",NA
"5/9/2015 10:00",343,155,16,24,498,"neutor",NA
"5/9/2015 11:00",366,187,17,32,553,"neutor",NA
"5/9/2015 12:00",402,227,17,35,629,"neutor",NA
"5/9/2015 13:00",420,282,17,30,702,"neutor",NA
"5/9/2015 14:00",389,347,18,28,736,"neutor",NA
"5/9/2015 15:00",326,347,18,32,673,"neutor",NA
"5/9/2015 16:00",305,364,18,39,669,"neutor",NA
"5/9/2015 17:00",272,357,17,37,629,"neutor",NA
"5/9/2015 18:00",226,307,16,26,533,"neutor",NA
"5/9/2015 19:00",232,291,13,15,523,"neutor",NA
"5/9/2015 20:00",194,236,13,19,430,"neutor",NA
"5/9/2015 21:00",135,149,12,26,284,"neutor",NA
"5/9/2015 22:00",125,160,12,17,285,"neutor",NA
"5/9/2015 23:00",111,137,12,20,248,"neutor",NA
"5/10/2015 0:00",90,151,12,22,241,"neutor",NA
"5/10/2015 1:00",102,143,11,20,245,"neutor",NA
"5/10/2015 2:00",41,86,10,20,127,"neutor",NA
"5/10/2015 3:00",48,94,9,20,142,"neutor",NA
"5/10/2015 4:00",26,46,9,19,72,"neutor",NA
"5/10/2015 5:00",20,26,8,13,46,"neutor",NA
"5/10/2015 6:00",18,26,8,11,44,"neutor",NA
"5/10/2015 7:00",44,16,9,13,60,"neutor",NA
"5/10/2015 8:00",95,40,9,17,135,"neutor",NA
"5/10/2015 9:00",208,53,11,15,261,"neutor",NA
"5/10/2015 10:00",236,89,11,13,325,"neutor",NA
"5/10/2015 11:00",214,136,13,11,350,"neutor",NA
"5/10/2015 12:00",333,161,14,13,494,"neutor",NA
"5/10/2015 13:00",410,224,15,9,634,"neutor",NA
"5/10/2015 14:00",435,235,16,6,670,"neutor",NA
"5/10/2015 15:00",396,315,17,9,711,"neutor",NA
"5/10/2015 16:00",284,264,17,7,548,"neutor",NA
"5/10/2015 17:00",304,513,17,6,817,"neutor",NA
"5/10/2015 18:00",275,363,17,6,638,"neutor",NA
"5/10/2015 19:00",198,305,17,6,503,"neutor",NA
"5/10/2015 20:00",163,242,15,4,405,"neutor",NA
"5/10/2015 21:00",69,186,13,6,255,"neutor",NA
"5/10/2015 22:00",69,161,13,4,230,"neutor",NA
"5/10/2015 23:00",51,73,12,6,124,"neutor",NA
"5/11/2015 0:00",24,36,12,6,60,"neutor",NA
"5/11/2015 1:00",11,33,12,9,44,"neutor",NA
"5/11/2015 2:00",7,8,11,7,15,"neutor",NA
"5/11/2015 3:00",2,5,11,7,7,"neutor",NA
"5/11/2015 4:00",10,5,10,9,15,"neutor",NA
"5/11/2015 5:00",36,15,10,7,51,"neutor",NA
"5/11/2015 6:00",113,49,11,6,162,"neutor",NA
"5/11/2015 7:00",544,213,11,7,757,"neutor",NA
"5/11/2015 8:00",668,541,14,7,1209,"neutor",NA
"5/11/2015 9:00",562,377,17,9,939,"neutor",NA
"5/11/2015 10:00",556,455,20,7,1011,"neutor",NA
"5/11/2015 11:00",517,402,20,17,919,"neutor",NA
"5/11/2015 12:00",600,517,22,15,1117,"neutor",NA
"5/11/2015 13:00",610,536,24,24,1146,"neutor",NA
"5/11/2015 14:00",518,615,24,17,1133,"neutor",NA
"5/11/2015 15:00",617,584,25,17,1201,"neutor",NA
"5/11/2015 16:00",739,767,25,15,1506,"neutor",NA
"5/11/2015 17:00",829,835,25,17,1664,"neutor",NA
"5/11/2015 18:00",711,859,25,13,1570,"neutor",NA
"5/11/2015 19:00",661,667,24,6,1328,"neutor",NA
"5/11/2015 20:00",373,595,21,6,968,"neutor",NA
"5/11/2015 21:00",371,397,19,6,768,"neutor",NA
"5/11/2015 22:00",194,359,17,6,553,"neutor",NA
"5/11/2015 23:00",105,229,17,6,334,"neutor",NA
"5/12/2015 0:00",53,108,15,2,161,"neutor",NA
"5/12/2015 1:00",11,46,13,2,57,"neutor",NA
"5/12/2015 2:00",11,28,13,4,39,"neutor",NA
"5/12/2015 3:00",6,13,13,2,19,"neutor",NA
"5/12/2015 4:00",9,11,13,6,20,"neutor",NA
"5/12/2015 5:00",30,14,13,2,44,"neutor",NA
"5/12/2015 6:00",142,58,15,6,200,"neutor",NA
"5/12/2015 7:00",582,244,16,2,826,"neutor",NA
"5/12/2015 8:00",863,573,17,7,1436,"neutor",NA
"5/12/2015 9:00",590,471,19,7,1061,"neutor",NA
"5/12/2015 10:00",696,684,20,17,1380,"neutor",NA
"5/12/2015 11:00",594,430,21,26,1024,"neutor",NA
"5/12/2015 12:00",622,574,21,24,1196,"neutor",NA
"5/12/2015 13:00",592,592,22,32,1184,"neutor",NA
"5/12/2015 14:00",556,712,21,30,1268,"neutor",NA
"5/12/2015 15:00",572,536,20,37,1108,"neutor",NA
"5/12/2015 16:00",707,787,19,19,1494,"neutor",NA
"5/12/2015 17:00",822,769,18,32,1591,"neutor",NA
"5/12/2015 18:00",665,736,17,19,1401,"neutor",NA
"5/12/2015 19:00",676,561,15,19,1237,"neutor",NA
"5/12/2015 20:00",455,516,14,22,971,"neutor",NA
"5/12/2015 21:00",205,347,12,9,552,"neutor",NA
"5/12/2015 22:00",178,326,10,6,504,"neutor",NA
"5/12/2015 23:00",115,324,11,7,439,"neutor",NA
"5/13/2015 0:00",43,123,10,7,166,"neutor",NA
"5/13/2015 1:00",21,51,11,9,72,"neutor",NA
"5/13/2015 2:00",11,31,10,9,42,"neutor",NA
"5/13/2015 3:00",3,8,10,7,11,"neutor",NA
"5/13/2015 4:00",11,4,9,7,15,"neutor",NA
"5/13/2015 5:00",36,14,6,4,50,"neutor",NA
"5/13/2015 6:00",145,39,8,6,184,"neutor",NA
"5/13/2015 7:00",694,244,10,11,938,"neutor",NA
"5/13/2015 8:00",800,577,12,13,1377,"neutor",NA
"5/13/2015 9:00",626,480,14,15,1106,"neutor",NA
"5/13/2015 10:00",650,630,15,15,1280,"neutor",NA
"5/13/2015 11:00",705,426,15,22,1131,"neutor",NA
"5/13/2015 12:00",707,637,17,20,1344,"neutor",NA
"5/13/2015 13:00",633,610,17,22,1243,"neutor",NA
"5/13/2015 14:00",573,628,18,22,1201,"neutor",NA
"5/13/2015 15:00",590,583,18,19,1173,"neutor",NA
"5/13/2015 16:00",636,739,17,15,1375,"neutor",NA
"5/13/2015 17:00",705,644,18,13,1349,"neutor",NA
"5/13/2015 18:00",558,713,16,17,1271,"neutor",NA
"5/13/2015 19:00",530,579,15,19,1109,"neutor",NA
"5/13/2015 20:00",443,472,14,15,915,"neutor",NA
"5/13/2015 21:00",373,382,12,13,755,"neutor",NA
"5/13/2015 22:00",240,337,10,15,577,"neutor",NA
"5/13/2015 23:00",230,327,9,11,557,"neutor",NA
"5/14/2015 0:00",257,217,8,7,474,"neutor",NA
"5/14/2015 1:00",270,229,7,6,499,"neutor",NA
"5/14/2015 2:00",135,204,6,4,339,"neutor",NA
"5/14/2015 3:00",108,140,7,4,248,"neutor",NA
"5/14/2015 4:00",73,95,7,7,168,"neutor",NA
"5/14/2015 5:00",46,58,8,6,104,"neutor",NA
"5/14/2015 6:00",40,27,8,6,67,"neutor",NA
"5/14/2015 7:00",67,24,9,6,91,"neutor",NA
"5/14/2015 8:00",76,52,9,7,128,"neutor",NA
"5/14/2015 9:00",153,66,10,9,219,"neutor",NA
"5/14/2015 10:00",183,103,10,6,286,"neutor",NA
"5/14/2015 11:00",185,172,11,4,357,"neutor",NA
"5/14/2015 12:00",203,171,11,4,374,"neutor",NA
"5/14/2015 13:00",239,174,12,9,413,"neutor",NA
"5/14/2015 14:00",303,253,14,6,556,"neutor",NA
"5/14/2015 15:00",424,283,14,6,707,"neutor",NA
"5/14/2015 16:00",308,280,14,9,588,"neutor",NA
"5/14/2015 17:00",352,289,15,13,641,"neutor",NA
"5/14/2015 18:00",359,409,15,11,768,"neutor",NA
"5/14/2015 19:00",294,288,14,13,582,"neutor",NA
"5/14/2015 20:00",219,222,12,11,441,"neutor",NA
"5/14/2015 21:00",150,216,10,9,366,"neutor",NA
"5/14/2015 22:00",133,184,8,7,317,"neutor",NA
"5/14/2015 23:00",77,149,8,7,226,"neutor",NA
"5/15/2015 0:00",46,114,8,4,160,"neutor",NA
"5/15/2015 1:00",21,56,8,11,77,"neutor",NA
"5/15/2015 2:00",9,31,7,11,40,"neutor",NA
"5/15/2015 3:00",5,5,7,13,10,"neutor",NA
"5/15/2015 4:00",7,10,6,11,17,"neutor",NA
"5/15/2015 5:00",16,11,5,9,27,"neutor",NA
"5/15/2015 6:00",100,34,6,11,134,"neutor",NA
"5/15/2015 7:00",262,88,8,11,350,"neutor",NA
"5/15/2015 8:00",426,253,9,15,679,"neutor",NA
"5/15/2015 9:00",404,261,10,13,665,"neutor",NA
"5/15/2015 10:00",566,315,11,15,881,"neutor",NA
"5/15/2015 11:00",474,315,12,15,789,"neutor",NA
"5/15/2015 12:00",517,383,13,11,900,"neutor",NA
"5/15/2015 13:00",531,362,13,9,893,"neutor",NA
"5/15/2015 14:00",453,454,14,6,907,"neutor",NA
"5/15/2015 15:00",483,403,15,9,886,"neutor",NA
"5/15/2015 16:00",433,459,16,9,892,"neutor",NA
"5/15/2015 17:00",399,520,16,11,919,"neutor",NA
"5/15/2015 18:00",337,490,16,9,827,"neutor",NA
"5/15/2015 19:00",331,388,15,9,719,"neutor",NA
"5/15/2015 20:00",256,313,13,11,569,"neutor",NA
"5/15/2015 21:00",213,252,11,4,465,"neutor",NA
"5/15/2015 22:00",178,210,10,6,388,"neutor",NA
"5/15/2015 23:00",124,174,8,6,298,"neutor",NA
"5/16/2015 0:00",78,137,7,6,215,"neutor",NA
"5/16/2015 1:00",69,140,6,4,209,"neutor",NA
"5/16/2015 2:00",48,105,5,4,153,"neutor",NA
"5/16/2015 3:00",21,58,4,2,79,"neutor",NA
"5/16/2015 4:00",14,45,4,2,59,"neutor",NA
"5/16/2015 5:00",39,24,4,2,63,"neutor",NA
"5/16/2015 6:00",46,22,6,4,68,"neutor",NA
"5/16/2015 7:00",159,28,8,9,187,"neutor",NA
"5/16/2015 8:00",291,54,9,13,345,"neutor",NA
"5/16/2015 9:00",318,86,10,15,404,"neutor",NA
"5/16/2015 10:00",303,221,10,13,524,"neutor",NA
"5/16/2015 11:00",322,190,10,13,512,"neutor",NA
"5/16/2015 12:00",288,200,10,13,488,"neutor",NA
"5/16/2015 13:00",241,246,10,15,487,"neutor",NA
"5/16/2015 14:00",237,254,11,17,491,"neutor",NA
"5/16/2015 15:00",239,253,12,15,492,"neutor",NA
"5/16/2015 16:00",219,223,12,15,442,"neutor",NA
"5/16/2015 17:00",126,210,13,17,336,"neutor",NA
"5/16/2015 18:00",147,239,13,17,386,"neutor",NA
"5/16/2015 19:00",219,189,13,20,408,"neutor",NA
"5/16/2015 20:00",186,163,12,22,349,"neutor",NA
"5/16/2015 21:00",140,97,10,15,237,"neutor",NA
"5/16/2015 22:00",107,107,7,11,214,"neutor",NA
"5/16/2015 23:00",77,115,6,9,192,"neutor",NA
"5/17/2015 0:00",100,101,6,7,201,"neutor",NA
"5/17/2015 1:00",53,134,5,7,187,"neutor",NA
"5/17/2015 2:00",36,107,5,7,143,"neutor",NA
"5/17/2015 3:00",19,73,3,2,92,"neutor",NA
"5/17/2015 4:00",18,44,4,4,62,"neutor",NA
"5/17/2015 5:00",16,39,3,2,55,"neutor",NA
"5/17/2015 6:00",23,14,4,7,37,"neutor",NA
"5/17/2015 7:00",33,14,9,9,47,"neutor",NA
"5/17/2015 8:00",68,28,11,17,96,"neutor",NA
"5/17/2015 9:00",175,41,13,17,216,"neutor",NA
"5/17/2015 10:00",191,67,12,17,258,"neutor",NA
"5/17/2015 11:00",174,115,14,22,289,"neutor",NA
"5/17/2015 12:00",165,154,14,19,319,"neutor",NA
"5/17/2015 13:00",194,153,15,30,347,"neutor",NA
"5/17/2015 14:00",257,192,15,20,449,"neutor",NA
"5/17/2015 15:00",239,222,16,24,461,"neutor",NA
"5/17/2015 16:00",201,217,16,20,418,"neutor",NA
"5/17/2015 17:00",247,270,16,17,517,"neutor",NA
"5/17/2015 18:00",211,241,16,19,452,"neutor",NA
"5/17/2015 19:00",185,237,15,17,422,"neutor",NA
"5/17/2015 20:00",123,208,13,13,331,"neutor",NA
"5/17/2015 21:00",69,118,11,7,187,"neutor",NA
"5/17/2015 22:00",82,139,9,2,221,"neutor",NA
"5/17/2015 23:00",41,114,6,4,155,"neutor",NA
"5/18/2015 0:00",31,37,6,4,68,"neutor",NA
"5/18/2015 1:00",6,22,6,2,28,"neutor",NA
"5/18/2015 2:00",4,5,5,4,9,"neutor",NA
"5/18/2015 3:00",3,7,5,4,10,"neutor",NA
"5/18/2015 4:00",6,6,6,2,12,"neutor",NA
"5/18/2015 5:00",27,15,5,2,42,"neutor",NA
"5/18/2015 6:00",126,26,7,4,152,"neutor",NA
"5/18/2015 7:00",523,197,8,7,720,"neutor",NA
"5/18/2015 8:00",677,487,10,9,1164,"neutor",NA
"5/18/2015 9:00",550,345,12,9,895,"neutor",NA
"5/18/2015 10:00",565,460,15,11,1025,"neutor",NA
"5/18/2015 11:00",428,347,15,22,775,"neutor",NA
"5/18/2015 12:00",520,530,16,26,1050,"neutor",NA
"5/18/2015 13:00",522,496,17,24,1018,"neutor",NA
"5/18/2015 14:00",523,546,18,26,1069,"neutor",NA
"5/18/2015 15:00",531,566,18,20,1097,"neutor",NA
"5/18/2015 16:00",577,691,19,24,1268,"neutor",NA
"5/18/2015 17:00",766,758,19,22,1524,"neutor",NA
"5/18/2015 18:00",641,756,19,20,1397,"neutor",NA
"5/18/2015 19:00",579,528,19,15,1107,"neutor",NA
"5/18/2015 20:00",361,447,18,24,808,"neutor",NA
"5/18/2015 21:00",255,269,13,37,524,"neutor",NA
"5/18/2015 22:00",157,293,13,19,450,"neutor",NA
"5/18/2015 23:00",70,167,13,17,237,"neutor",NA
"5/19/2015 0:00",36,102,12,13,138,"neutor",NA
"5/19/2015 1:00",10,57,11,11,67,"neutor",NA
"5/19/2015 2:00",4,28,10,13,32,"neutor",NA
"5/19/2015 3:00",5,12,10,13,17,"neutor",NA
"5/19/2015 4:00",10,6,10,17,16,"neutor",NA
"5/19/2015 5:00",31,10,10,19,41,"neutor",NA
"5/19/2015 6:00",120,35,10,22,155,"neutor",NA
"5/19/2015 7:00",477,242,10,22,719,"neutor",NA
"5/19/2015 8:00",753,511,10,20,1264,"neutor",NA
"5/19/2015 9:00",566,364,11,30,930,"neutor",NA
"5/19/2015 10:00",627,549,11,28,1176,"neutor",NA
"5/19/2015 11:00",463,420,13,28,883,"neutor",NA
"5/19/2015 12:00",574,500,15,28,1074,"neutor",NA
"5/19/2015 13:00",579,499,15,30,1078,"neutor",NA
"5/19/2015 14:00",485,628,15,28,1113,"neutor",NA
"5/19/2015 15:00",589,505,12,30,1094,"neutor",NA
"5/19/2015 16:00",618,635,11,17,1253,"neutor",NA
"5/19/2015 17:00",718,627,12,17,1345,"neutor",NA
"5/19/2015 18:00",591,771,13,19,1362,"neutor",NA
"5/19/2015 19:00",686,513,12,20,1199,"neutor",NA
"5/19/2015 20:00",464,353,12,11,817,"neutor",NA
"5/19/2015 21:00",246,280,10,6,526,"neutor",NA
"5/19/2015 22:00",201,323,9,9,524,"neutor",NA
"5/19/2015 23:00",115,238,8,7,353,"neutor",NA
"5/20/2015 0:00",39,108,8,9,147,"neutor",NA
"5/20/2015 1:00",29,54,8,7,83,"neutor",NA
"5/20/2015 2:00",6,26,7,7,32,"neutor",NA
"5/20/2015 3:00",8,20,7,7,28,"neutor",NA
"5/20/2015 4:00",14,20,7,9,34,"neutor",NA
"5/20/2015 5:00",38,24,6,9,62,"neutor",NA
"5/20/2015 6:00",135,32,7,9,167,"neutor",NA
"5/20/2015 7:00",659,199,8,13,858,"neutor",NA
"5/20/2015 8:00",805,618,9,13,1423,"neutor",NA
"5/20/2015 9:00",624,461,11,17,1085,"neutor",NA
"5/20/2015 10:00",637,641,12,19,1278,"neutor",NA
"5/20/2015 11:00",577,400,12,22,977,"neutor",NA
"5/20/2015 12:00",686,569,14,15,1255,"neutor",NA
"5/20/2015 13:00",548,466,15,17,1014,"neutor",NA
"5/20/2015 14:00",556,525,14,19,1081,"neutor",NA
"5/20/2015 15:00",500,480,10,30,980,"neutor",NA
"5/20/2015 16:00",548,678,13,7,1226,"neutor",NA
"5/20/2015 17:00",656,620,14,17,1276,"neutor",NA
"5/20/2015 18:00",627,635,13,19,1262,"neutor",NA
"5/20/2015 19:00",557,475,12,7,1032,"neutor",NA
"5/20/2015 20:00",413,454,10,26,867,"neutor",NA
"5/20/2015 21:00",303,316,8,4,619,"neutor",NA
"5/20/2015 22:00",222,320,8,7,542,"neutor",NA
"5/20/2015 23:00",165,236,7,4,401,"neutor",NA
"5/21/2015 0:00",143,216,6,6,359,"neutor",NA
"5/21/2015 1:00",63,128,6,6,191,"neutor",NA
"5/21/2015 2:00",37,85,5,6,122,"neutor",NA
"5/21/2015 3:00",27,74,4,6,101,"neutor",NA
"5/21/2015 4:00",31,67,5,6,98,"neutor",NA
"5/21/2015 5:00",42,22,6,6,64,"neutor",NA
"5/21/2015 6:00",134,39,7,7,173,"neutor",NA
"5/21/2015 7:00",513,216,8,9,729,"neutor",NA
"5/21/2015 8:00",749,560,9,13,1309,"neutor",NA
"5/21/2015 9:00",591,347,11,11,938,"neutor",NA
"5/21/2015 10:00",621,536,12,13,1157,"neutor",NA
"5/21/2015 11:00",489,382,13,15,871,"neutor",NA
"5/21/2015 12:00",532,566,14,13,1098,"neutor",NA
"5/21/2015 13:00",578,482,16,17,1060,"neutor",NA
"5/21/2015 14:00",620,603,15,20,1223,"neutor",NA
"5/21/2015 15:00",663,520,17,13,1183,"neutor",NA
"5/21/2015 16:00",696,749,17,9,1445,"neutor",NA
"5/21/2015 17:00",690,628,17,13,1318,"neutor",NA
"5/21/2015 18:00",642,696,15,9,1338,"neutor",NA
"5/21/2015 19:00",516,527,15,7,1043,"neutor",NA
"5/21/2015 20:00",331,359,14,6,690,"neutor",NA
"5/21/2015 21:00",274,252,13,4,526,"neutor",NA
"5/21/2015 22:00",195,217,13,7,412,"neutor",NA
"5/21/2015 23:00",143,250,12,6,393,"neutor",NA
"5/22/2015 0:00",59,123,10,4,182,"neutor",NA
"5/22/2015 1:00",23,88,9,2,111,"neutor",NA
"5/22/2015 2:00",18,57,8,2,75,"neutor",NA
"5/22/2015 3:00",9,72,7,2,81,"neutor",NA
"5/22/2015 4:00",17,53,7,4,70,"neutor",NA
"5/22/2015 5:00",30,30,7,4,60,"neutor",NA
"5/22/2015 6:00",107,28,8,4,135,"neutor",NA
"5/22/2015 7:00",429,212,11,6,641,"neutor",NA
"5/22/2015 8:00",614,399,12,7,1013,"neutor",NA
"5/22/2015 9:00",506,303,15,13,809,"neutor",NA
"5/22/2015 10:00",478,354,16,15,832,"neutor",NA
"5/22/2015 11:00",468,290,17,13,758,"neutor",NA
"5/22/2015 12:00",479,456,18,13,935,"neutor",NA
"5/22/2015 13:00",462,437,19,13,899,"neutor",NA
"5/22/2015 14:00",465,498,19,15,963,"neutor",NA
"5/22/2015 15:00",485,463,19,11,948,"neutor",NA
"5/22/2015 16:00",446,414,20,13,860,"neutor",NA
"5/22/2015 17:00",428,460,19,11,888,"neutor",NA
"5/22/2015 18:00",418,474,19,9,892,"neutor",NA
"5/22/2015 19:00",346,348,19,9,694,"neutor",NA
"5/22/2015 20:00",234,318,18,4,552,"neutor",NA
"5/22/2015 21:00",185,193,16,4,378,"neutor",NA
"5/22/2015 22:00",125,177,16,7,302,"neutor",NA
"5/22/2015 23:00",120,189,15,9,309,"neutor",NA
"5/23/2015 0:00",109,139,15,6,248,"neutor",NA
"5/23/2015 1:00",64,112,15,6,176,"neutor",NA
"5/23/2015 2:00",69,99,14,2,168,"neutor",NA
"5/23/2015 3:00",24,83,13,6,107,"neutor",NA
"5/23/2015 4:00",32,53,13,7,85,"neutor",NA
"5/23/2015 5:00",30,24,13,2,54,"neutor",NA
"5/23/2015 6:00",45,18,13,6,63,"neutor",NA
"5/23/2015 7:00",103,27,14,2,130,"neutor",NA
"5/23/2015 8:00",177,70,14,7,247,"neutor",NA
"5/23/2015 9:00",319,98,16,7,417,"neutor",NA
"5/23/2015 10:00",363,167,16,9,530,"neutor",NA
"5/23/2015 11:00",413,182,16,13,595,"neutor",NA
"5/23/2015 12:00",411,217,15,15,628,"neutor",NA
"5/23/2015 13:00",314,263,14,17,577,"neutor",NA
"5/23/2015 14:00",340,299,13,11,639,"neutor",NA
"5/23/2015 15:00",247,331,13,13,578,"neutor",NA
"5/23/2015 16:00",199,262,13,11,461,"neutor",NA
"5/23/2015 17:00",209,329,14,7,538,"neutor",NA
"5/23/2015 18:00",228,260,15,9,488,"neutor",NA
"5/23/2015 19:00",251,226,14,7,477,"neutor",NA
"5/23/2015 20:00",170,189,14,6,359,"neutor",NA
"5/23/2015 21:00",105,124,12,7,229,"neutor",NA
"5/23/2015 22:00",135,112,11,9,247,"neutor",NA
"5/23/2015 23:00",120,143,10,11,263,"neutor",NA
"5/24/2015 0:00",79,109,8,7,188,"neutor",NA
"5/24/2015 1:00",65,123,6,4,188,"neutor",NA
"5/24/2015 2:00",29,86,5,4,115,"neutor",NA
"5/24/2015 3:00",14,63,6,2,77,"neutor",NA
"5/24/2015 4:00",10,44,7,2,54,"neutor",NA
"5/24/2015 5:00",22,32,7,2,54,"neutor",NA
"5/24/2015 6:00",22,15,8,6,37,"neutor",NA
"5/24/2015 7:00",23,16,10,7,39,"neutor",NA
"5/24/2015 8:00",55,24,12,6,79,"neutor",NA
"5/24/2015 9:00",134,67,12,4,201,"neutor",NA
"5/24/2015 10:00",183,112,15,4,295,"neutor",NA
"5/24/2015 11:00",201,147,15,6,348,"neutor",NA
"5/24/2015 12:00",155,176,16,11,331,"neutor",NA
"5/24/2015 13:00",254,155,16,7,409,"neutor",NA
"5/24/2015 14:00",251,207,17,7,458,"neutor",NA
"5/24/2015 15:00",230,172,18,7,402,"neutor",NA
"5/24/2015 16:00",231,223,19,7,454,"neutor",NA
"5/24/2015 17:00",260,208,20,7,468,"neutor",NA
"5/24/2015 18:00",248,203,19,9,451,"neutor",NA
"5/24/2015 19:00",214,199,19,13,413,"neutor",NA
"5/24/2015 20:00",159,158,18,11,317,"neutor",NA
"5/24/2015 21:00",95,171,14,4,266,"neutor",NA
"5/24/2015 22:00",105,156,11,4,261,"neutor",NA
"5/24/2015 23:00",62,110,10,6,172,"neutor",NA
"5/25/2015 0:00",76,101,10,4,177,"neutor",NA
"5/25/2015 1:00",34,81,10,6,115,"neutor",NA
"5/25/2015 2:00",19,71,11,6,90,"neutor",NA
"5/25/2015 3:00",14,51,11,4,65,"neutor",NA
"5/25/2015 4:00",10,13,11,4,23,"neutor",NA
"5/25/2015 5:00",10,20,11,6,30,"neutor",NA
"5/25/2015 6:00",15,21,12,7,36,"neutor",NA
"5/25/2015 7:00",22,9,11,7,31,"neutor",NA
"5/25/2015 8:00",35,22,11,7,57,"neutor",NA
"5/25/2015 9:00",63,53,12,7,116,"neutor",NA
"5/25/2015 10:00",95,59,11,13,154,"neutor",NA
"5/25/2015 11:00",127,104,13,9,231,"neutor",NA
"5/25/2015 12:00",122,87,14,9,209,"neutor",NA
"5/25/2015 13:00",163,118,16,11,281,"neutor",NA
"5/25/2015 14:00",164,131,17,20,295,"neutor",NA
"5/25/2015 15:00",214,177,16,17,391,"neutor",NA
"5/25/2015 16:00",192,175,16,17,367,"neutor",NA
"5/25/2015 17:00",213,219,15,17,432,"neutor",NA
"5/25/2015 18:00",185,164,15,13,349,"neutor",NA
"5/25/2015 19:00",166,138,14,11,304,"neutor",NA
"5/25/2015 20:00",136,128,13,9,264,"neutor",NA
"5/25/2015 21:00",72,104,12,9,176,"neutor",NA
"5/25/2015 22:00",68,112,12,11,180,"neutor",NA
"5/25/2015 23:00",37,72,11,13,109,"neutor",NA
"5/26/2015 0:00",14,44,11,7,58,"neutor",NA
"5/26/2015 1:00",9,56,10,7,65,"neutor",NA
"5/26/2015 2:00",5,26,10,11,31,"neutor",NA
"5/26/2015 3:00",4,4,10,11,8,"neutor",NA
"5/26/2015 4:00",6,6,9,9,12,"neutor",NA
"5/26/2015 5:00",24,16,8,9,40,"neutor",NA
"5/26/2015 6:00",96,41,8,9,137,"neutor",NA
"5/26/2015 7:00",321,136,10,9,457,"neutor",NA
"5/26/2015 8:00",501,315,11,13,816,"neutor",NA
"5/26/2015 9:00",302,276,12,13,578,"neutor",NA
"5/26/2015 10:00",316,236,12,15,552,"neutor",NA
"5/26/2015 11:00",299,259,11,11,558,"neutor",NA
"5/26/2015 12:00",308,240,13,19,548,"neutor",NA
"5/26/2015 13:00",286,274,12,9,560,"neutor",NA
"5/26/2015 14:00",311,304,13,17,615,"neutor",NA
"5/26/2015 15:00",316,308,14,15,624,"neutor",NA
"5/26/2015 16:00",397,423,14,19,820,"neutor",NA
"5/26/2015 17:00",436,415,14,19,851,"neutor",NA
"5/26/2015 18:00",427,450,11,19,877,"neutor",NA
"5/26/2015 19:00",355,381,12,17,736,"neutor",NA
"5/26/2015 20:00",225,256,11,13,481,"neutor",NA
"5/26/2015 21:00",168,168,11,13,336,"neutor",NA
"5/26/2015 22:00",95,187,10,9,282,"neutor",NA
"5/26/2015 23:00",46,102,10,11,148,"neutor",NA
"5/27/2015 0:00",27,57,10,11,84,"neutor",NA
"5/27/2015 1:00",11,41,9,6,52,"neutor",NA
"5/27/2015 2:00",6,19,9,6,25,"neutor",NA
"5/27/2015 3:00",6,10,9,7,16,"neutor",NA
"5/27/2015 4:00",9,4,9,7,13,"neutor",NA
"5/27/2015 5:00",29,14,9,7,43,"neutor",NA
"5/27/2015 6:00",117,36,10,11,153,"neutor",NA
"5/27/2015 7:00",483,175,10,9,658,"neutor",NA
"5/27/2015 8:00",569,391,11,9,960,"neutor",NA
"5/27/2015 9:00",419,257,12,11,676,"neutor",NA
"5/27/2015 10:00",427,285,13,9,712,"neutor",NA
"5/27/2015 11:00",374,276,14,9,650,"neutor",NA
"5/27/2015 12:00",357,281,15,7,638,"neutor",NA
"5/27/2015 13:00",394,375,16,9,769,"neutor",NA
"5/27/2015 14:00",369,373,16,11,742,"neutor",NA
"5/27/2015 15:00",421,409,16,15,830,"neutor",NA
"5/27/2015 16:00",414,380,16,13,794,"neutor",NA
"5/27/2015 17:00",521,514,16,13,1035,"neutor",NA
"5/27/2015 18:00",512,473,16,9,985,"neutor",NA
"5/27/2015 19:00",395,412,16,7,807,"neutor",NA
"5/27/2015 20:00",274,317,15,7,591,"neutor",NA
"5/27/2015 21:00",210,241,14,7,451,"neutor",NA
"5/27/2015 22:00",151,223,14,9,374,"neutor",NA
"5/27/2015 23:00",95,187,13,13,282,"neutor",NA
"5/28/2015 0:00",69,116,13,11,185,"neutor",NA
"5/28/2015 1:00",50,121,13,9,171,"neutor",NA
"5/28/2015 2:00",27,76,12,7,103,"neutor",NA
"5/28/2015 3:00",33,52,12,13,85,"neutor",NA
"5/28/2015 4:00",34,39,13,15,73,"neutor",NA
"5/28/2015 5:00",43,32,13,15,75,"neutor",NA
"5/28/2015 6:00",115,38,13,19,153,"neutor",NA
"5/28/2015 7:00",466,157,14,19,623,"neutor",NA
"5/28/2015 8:00",455,322,15,20,777,"neutor",NA
"5/28/2015 9:00",417,309,15,20,726,"neutor",NA
"5/28/2015 10:00",319,270,16,26,589,"neutor",NA
"5/28/2015 11:00",294,236,15,24,530,"neutor",NA
"5/28/2015 12:00",328,305,16,24,633,"neutor",NA
"5/28/2015 13:00",327,326,17,24,653,"neutor",NA
"5/28/2015 14:00",415,383,15,22,798,"neutor",NA
"5/28/2015 15:00",319,351,15,17,670,"neutor",NA
"5/28/2015 16:00",423,417,15,15,840,"neutor",NA
"5/28/2015 17:00",483,458,14,11,941,"neutor",NA
"5/28/2015 18:00",531,456,15,19,987,"neutor",NA
"5/28/2015 19:00",457,411,14,11,868,"neutor",NA
"5/28/2015 20:00",319,315,13,17,634,"neutor",NA
"5/28/2015 21:00",159,191,11,9,350,"neutor",NA
"5/28/2015 22:00",187,281,10,4,468,"neutor",NA
"5/28/2015 23:00",73,222,8,2,295,"neutor",NA
"5/29/2015 0:00",46,111,6,2,157,"neutor",NA
"5/29/2015 1:00",17,64,6,2,81,"neutor",NA
"5/29/2015 2:00",9,19,6,2,28,"neutor",NA
"5/29/2015 3:00",2,14,5,2,16,"neutor",NA
"5/29/2015 4:00",6,14,6,6,20,"neutor",NA
"5/29/2015 5:00",37,12,6,6,49,"neutor",NA
"5/29/2015 6:00",109,37,8,4,146,"neutor",NA
"5/29/2015 7:00",430,167,9,6,597,"neutor",NA
"5/29/2015 8:00",487,288,11,11,775,"neutor",NA
"5/29/2015 9:00",423,298,14,11,721,"neutor",NA
"5/29/2015 10:00",351,227,15,17,578,"neutor",NA
"5/29/2015 11:00",349,245,14,19,594,"neutor",NA
"5/29/2015 12:00",371,329,15,17,700,"neutor",NA
"5/29/2015 13:00",388,390,15,22,778,"neutor",NA
"5/29/2015 14:00",396,428,16,24,824,"neutor",NA
"5/29/2015 15:00",399,358,17,26,757,"neutor",NA
"5/29/2015 16:00",421,351,17,24,772,"neutor",NA
"5/29/2015 17:00",445,402,16,28,847,"neutor",NA
"5/29/2015 18:00",468,414,16,22,882,"neutor",NA
"5/29/2015 19:00",428,380,16,26,808,"neutor",NA
"5/29/2015 20:00",395,289,15,22,684,"neutor",NA
"5/29/2015 21:00",283,249,11,37,532,"neutor",NA
"5/29/2015 22:00",153,211,10,20,364,"neutor",NA
"5/29/2015 23:00",111,225,9,19,336,"neutor",NA
"5/30/2015 0:00",94,193,9,20,287,"neutor",NA
"5/30/2015 1:00",65,143,9,15,208,"neutor",NA
"5/30/2015 2:00",38,99,9,9,137,"neutor",NA
"5/30/2015 3:00",42,71,8,19,113,"neutor",NA
"5/30/2015 4:00",14,29,8,15,43,"neutor",NA
"5/30/2015 5:00",25,29,8,11,54,"neutor",NA
"5/30/2015 6:00",34,20,9,15,54,"neutor",NA
"5/30/2015 7:00",62,22,10,19,84,"neutor",NA
"5/30/2015 8:00",124,66,11,24,190,"neutor",NA
"5/30/2015 9:00",254,106,12,28,360,"neutor",NA
"5/30/2015 10:00",334,137,13,32,471,"neutor",NA
"5/30/2015 11:00",244,175,10,37,419,"neutor",NA
"5/30/2015 12:00",314,180,12,20,494,"neutor",NA
"5/30/2015 13:00",301,204,10,32,505,"neutor",NA
"5/30/2015 14:00",214,198,11,17,412,"neutor",NA
"5/30/2015 15:00",261,217,12,20,478,"neutor",NA
"5/30/2015 16:00",200,234,12,9,434,"neutor",NA
"5/30/2015 17:00",248,248,15,13,496,"neutor",NA
"5/30/2015 18:00",261,273,14,19,534,"neutor",NA
"5/30/2015 19:00",348,254,14,15,602,"neutor",NA
"5/30/2015 20:00",205,180,13,9,385,"neutor",NA
"5/30/2015 21:00",178,123,10,7,301,"neutor",NA
"5/30/2015 22:00",162,225,7,4,387,"neutor",NA
"5/30/2015 23:00",118,138,6,0,256,"neutor",NA
"5/31/2015 0:00",125,178,5,2,303,"neutor",NA
"5/31/2015 1:00",83,143,5,4,226,"neutor",NA
"5/31/2015 2:00",66,130,6,4,196,"neutor",NA
"5/31/2015 3:00",36,84,7,6,120,"neutor",NA
"5/31/2015 4:00",27,64,7,6,91,"neutor",NA
"5/31/2015 5:00",14,46,7,6,60,"neutor",NA
"5/31/2015 6:00",27,37,8,7,64,"neutor",NA
"5/31/2015 7:00",24,7,9,9,31,"neutor",NA
"5/31/2015 8:00",51,36,13,13,87,"neutor",NA
"5/31/2015 9:00",156,62,15,17,218,"neutor",NA
"5/31/2015 10:00",207,154,15,15,361,"neutor",NA
"5/31/2015 11:00",159,117,17,13,276,"neutor",NA
"5/31/2015 12:00",172,129,19,20,301,"neutor",NA
"5/31/2015 13:00",195,161,19,20,356,"neutor",NA
"5/31/2015 14:00",240,200,19,24,440,"neutor",NA
"5/31/2015 15:00",212,184,19,17,396,"neutor",NA
"5/31/2015 16:00",178,208,17,30,386,"neutor",NA
"5/31/2015 17:00",189,178,16,22,367,"neutor",NA
"5/31/2015 18:00",183,169,16,19,352,"neutor",NA
"5/31/2015 19:00",158,214,15,20,372,"neutor",NA
"5/31/2015 20:00",72,167,15,19,239,"neutor",NA
"5/31/2015 21:00",55,99,15,20,154,"neutor",NA
"5/31/2015 22:00",62,134,15,20,196,"neutor",NA
"5/31/2015 23:00",30,82,15,22,112,"neutor",NA
"6/1/2015 0:00",14,17,15,22,31,"neutor",NA
"6/1/2015 1:00",0,21,12,26,21,"neutor",NA
"6/1/2015 2:00",2,11,10,11,13,"neutor",NA
"6/1/2015 3:00",2,2,10,7,4,"neutor",NA
"6/1/2015 4:00",6,4,10,9,10,"neutor",NA
"6/1/2015 5:00",35,9,9,7,44,"neutor",NA
"6/1/2015 6:00",119,36,10,11,155,"neutor",NA
"6/1/2015 7:00",505,177,11,13,682,"neutor",NA
"6/1/2015 8:00",569,481,12,15,1050,"neutor",NA
"6/1/2015 9:00",506,375,13,13,881,"neutor",NA
"6/1/2015 10:00",503,466,13,13,969,"neutor",NA
"6/1/2015 11:00",483,372,14,11,855,"neutor",NA
"6/1/2015 12:00",576,507,14,11,1083,"neutor",NA
"6/1/2015 13:00",549,450,14,11,999,"neutor",NA
"6/1/2015 14:00",497,562,15,11,1059,"neutor",NA
"6/1/2015 15:00",550,504,16,17,1054,"neutor",NA
"6/1/2015 16:00",634,759,17,15,1393,"neutor",NA
"6/1/2015 17:00",757,715,16,9,1472,"neutor",NA
"6/1/2015 18:00",651,766,16,9,1417,"neutor",NA
"6/1/2015 19:00",519,563,16,7,1082,"neutor",NA
"6/1/2015 20:00",302,433,14,4,735,"neutor",NA
"6/1/2015 21:00",252,319,12,2,571,"neutor",NA
"6/1/2015 22:00",190,327,12,2,517,"neutor",NA
"6/1/2015 23:00",88,186,12,7,274,"neutor",NA
"6/2/2015 0:00",43,78,12,9,121,"neutor",NA
"6/2/2015 1:00",11,43,13,9,54,"neutor",NA
"6/2/2015 2:00",4,19,12,9,23,"neutor",NA
"6/2/2015 3:00",10,3,12,11,13,"neutor",NA
"6/2/2015 4:00",8,5,12,17,13,"neutor",NA
"6/2/2015 5:00",34,12,12,17,46,"neutor",NA
"6/2/2015 6:00",127,46,13,17,173,"neutor",NA
"6/2/2015 7:00",536,223,14,22,759,"neutor",NA
"6/2/2015 8:00",792,539,15,30,1331,"neutor",NA
"6/2/2015 9:00",515,436,15,30,951,"neutor",NA
"6/2/2015 10:00",585,571,15,26,1156,"neutor",NA
"6/2/2015 11:00",468,346,16,28,814,"neutor",NA
"6/2/2015 12:00",530,506,15,33,1036,"neutor",NA
"6/2/2015 13:00",587,449,16,30,1036,"neutor",NA
"6/2/2015 14:00",489,529,18,35,1018,"neutor",NA
"6/2/2015 15:00",564,479,19,35,1043,"neutor",NA
"6/2/2015 16:00",617,768,19,24,1385,"neutor",NA
"6/2/2015 17:00",784,653,19,22,1437,"neutor",NA
"6/2/2015 18:00",610,701,19,24,1311,"neutor",NA
"6/2/2015 19:00",558,535,19,30,1093,"neutor",NA
"6/2/2015 20:00",374,387,20,26,761,"neutor",NA
"6/2/2015 21:00",254,275,20,28,529,"neutor",NA
"6/2/2015 22:00",126,234,20,32,360,"neutor",NA
"6/2/2015 23:00",73,190,20,28,263,"neutor",NA
"6/3/2015 0:00",74,137,19,24,211,"neutor",NA
"6/3/2015 1:00",25,47,19,32,72,"neutor",NA
"6/3/2015 2:00",11,36,15,28,47,"neutor",NA
"6/3/2015 3:00",2,21,15,20,23,"neutor",NA
"6/3/2015 4:00",19,13,15,19,32,"neutor",NA
"6/3/2015 5:00",34,8,15,22,42,"neutor",NA
"6/3/2015 6:00",136,36,15,20,172,"neutor",NA
"6/3/2015 7:00",631,189,15,22,820,"neutor",NA
"6/3/2015 8:00",683,570,16,32,1253,"neutor",NA
"6/3/2015 9:00",568,463,16,37,1031,"neutor",NA
"6/3/2015 10:00",579,648,16,32,1227,"neutor",NA
"6/3/2015 11:00",584,359,17,30,943,"neutor",NA
"6/3/2015 12:00",588,583,17,33,1171,"neutor",NA
"6/3/2015 13:00",563,541,17,26,1104,"neutor",NA
"6/3/2015 14:00",509,595,17,24,1104,"neutor",NA
"6/3/2015 15:00",598,531,17,20,1129,"neutor",NA
"6/3/2015 16:00",591,670,17,19,1261,"neutor",NA
"6/3/2015 17:00",651,542,18,24,1193,"neutor",NA
"6/3/2015 18:00",580,663,17,13,1243,"neutor",NA
"6/3/2015 19:00",609,453,17,11,1062,"neutor",NA
"6/3/2015 20:00",464,501,16,6,965,"neutor",NA
"6/3/2015 21:00",375,340,14,4,715,"neutor",NA
"6/3/2015 22:00",264,266,13,6,530,"neutor",NA
"6/3/2015 23:00",194,231,10,4,425,"neutor",NA
"6/4/2015 0:00",198,194,9,4,392,"neutor",NA
"6/4/2015 1:00",155,182,8,2,337,"neutor",NA
"6/4/2015 2:00",85,202,8,2,287,"neutor",NA
"6/4/2015 3:00",49,221,7,2,270,"neutor",NA
"6/4/2015 4:00",39,135,8,2,174,"neutor",NA
"6/4/2015 5:00",31,70,9,4,101,"neutor",NA
"6/4/2015 6:00",20,27,11,4,47,"neutor",NA
"6/4/2015 7:00",62,32,13,7,94,"neutor",NA
"6/4/2015 8:00",119,55,15,6,174,"neutor",NA
"6/4/2015 9:00",169,90,16,7,259,"neutor",NA
"6/4/2015 10:00",241,152,18,4,393,"neutor",NA
"6/4/2015 11:00",223,201,19,2,424,"neutor",NA
"6/4/2015 12:00",278,215,20,9,493,"neutor",NA
"6/4/2015 13:00",335,299,20,6,634,"neutor",NA
"6/4/2015 14:00",405,284,21,4,689,"neutor",NA
"6/4/2015 15:00",370,319,21,9,689,"neutor",NA
"6/4/2015 16:00",420,305,21,7,725,"neutor",NA
"6/4/2015 17:00",401,414,22,9,815,"neutor",NA
"6/4/2015 18:00",409,365,22,11,774,"neutor",NA
"6/4/2015 19:00",358,317,21,15,675,"neutor",NA
"6/4/2015 20:00",249,301,20,13,550,"neutor",NA
"6/4/2015 21:00",167,291,18,9,458,"neutor",NA
"6/4/2015 22:00",106,302,17,9,408,"neutor",NA
"6/4/2015 23:00",84,202,17,9,286,"neutor",NA
"6/5/2015 0:00",46,130,16,7,176,"neutor",NA
"6/5/2015 1:00",23,69,16,9,92,"neutor",NA
"6/5/2015 2:00",13,25,15,9,38,"neutor",NA
"6/5/2015 3:00",3,19,15,9,22,"neutor",NA
"6/5/2015 4:00",7,7,15,7,14,"neutor",NA
"6/5/2015 5:00",26,10,15,7,36,"neutor",NA
"6/5/2015 6:00",89,29,15,7,118,"neutor",NA
"6/5/2015 7:00",338,130,17,7,468,"neutor",NA
"6/5/2015 8:00",467,270,19,11,737,"neutor",NA
"6/5/2015 9:00",442,308,22,7,750,"neutor",NA
"6/5/2015 10:00",549,369,24,9,918,"neutor",NA
"6/5/2015 11:00",469,314,26,7,783,"neutor",NA
"6/5/2015 12:00",549,504,27,4,1053,"neutor",NA
"6/5/2015 13:00",542,503,29,9,1045,"neutor",NA
"6/5/2015 14:00",482,510,30,7,992,"neutor",NA
"6/5/2015 15:00",490,428,31,6,918,"neutor",NA
"6/5/2015 16:00",442,425,32,6,867,"neutor",NA
"6/5/2015 17:00",493,476,32,9,969,"neutor",NA
"6/5/2015 18:00",460,488,32,11,948,"neutor",NA
"6/5/2015 19:00",531,383,30,6,914,"neutor",NA
"6/5/2015 20:00",356,326,26,4,682,"neutor",NA
"6/5/2015 21:00",267,251,24,4,518,"neutor",NA
"6/5/2015 22:00",193,313,25,30,506,"neutor",NA
"6/5/2015 23:00",107,384,23,15,491,"neutor",NA
"6/6/2015 0:00",73,219,22,4,292,"neutor",NA
"6/6/2015 1:00",58,196,21,4,254,"neutor",NA
"6/6/2015 2:00",35,87,18,4,122,"neutor",NA
"6/6/2015 3:00",21,73,18,7,94,"neutor",NA
"6/6/2015 4:00",19,54,18,6,73,"neutor",NA
"6/6/2015 5:00",18,33,18,7,51,"neutor",NA
"6/6/2015 6:00",33,18,18,4,51,"neutor",NA
"6/6/2015 7:00",95,33,19,17,128,"neutor",NA
"6/6/2015 8:00",152,60,19,19,212,"neutor",NA
"6/6/2015 9:00",285,99,17,20,384,"neutor",NA
"6/6/2015 10:00",340,144,18,17,484,"neutor",NA
"6/6/2015 11:00",346,183,19,19,529,"neutor",NA
"6/6/2015 12:00",327,202,19,22,529,"neutor",NA
"6/6/2015 13:00",342,275,20,15,617,"neutor",NA
"6/6/2015 14:00",351,331,21,17,682,"neutor",NA
"6/6/2015 15:00",344,336,21,19,680,"neutor",NA
"6/6/2015 16:00",306,347,22,17,653,"neutor",NA
"6/6/2015 17:00",356,330,21,15,686,"neutor",NA
"6/6/2015 18:00",339,349,21,13,688,"neutor",NA
"6/6/2015 19:00",373,314,21,17,687,"neutor",NA
"6/6/2015 20:00",349,319,19,11,668,"neutor",NA
"6/6/2015 21:00",194,203,15,9,397,"neutor",NA
"6/6/2015 22:00",141,205,14,6,346,"neutor",NA
"6/6/2015 23:00",168,322,13,6,490,"neutor",NA
"6/7/2015 0:00",120,250,11,6,370,"neutor",NA
"6/7/2015 1:00",104,172,9,2,276,"neutor",NA
"6/7/2015 2:00",40,134,9,4,174,"neutor",NA
"6/7/2015 3:00",25,99,8,4,124,"neutor",NA
"6/7/2015 4:00",12,66,7,2,78,"neutor",NA
"6/7/2015 5:00",8,29,7,2,37,"neutor",NA
"6/7/2015 6:00",11,27,9,2,38,"neutor",NA
"6/7/2015 7:00",34,15,13,6,49,"neutor",NA
"6/7/2015 8:00",56,25,15,7,81,"neutor",NA
"6/7/2015 9:00",168,69,17,9,237,"neutor",NA
"6/7/2015 10:00",261,113,18,9,374,"neutor",NA
"6/7/2015 11:00",232,175,19,13,407,"neutor",NA
"6/7/2015 12:00",275,215,20,6,490,"neutor",NA
"6/7/2015 13:00",324,231,20,7,555,"neutor",NA
"6/7/2015 14:00",360,307,21,9,667,"neutor",NA
"6/7/2015 15:00",329,296,20,7,625,"neutor",NA
"6/7/2015 16:00",318,268,20,11,586,"neutor",NA
"6/7/2015 17:00",306,328,21,13,634,"neutor",NA
"6/7/2015 18:00",285,304,19,15,589,"neutor",NA
"6/7/2015 19:00",271,309,19,17,580,"neutor",NA
"6/7/2015 20:00",157,323,18,11,480,"neutor",NA
"6/7/2015 21:00",112,221,15,15,333,"neutor",NA
"6/7/2015 22:00",64,214,13,15,278,"neutor",NA
"6/7/2015 23:00",44,102,12,15,146,"neutor",NA
"6/8/2015 0:00",25,56,11,13,81,"neutor",NA
"6/8/2015 1:00",5,33,9,7,38,"neutor",NA
"6/8/2015 2:00",2,3,8,7,5,"neutor",NA
"6/8/2015 3:00",1,1,7,2,2,"neutor",NA
"6/8/2015 4:00",9,4,6,2,13,"neutor",NA
"6/8/2015 5:00",32,16,6,4,48,"neutor",NA
"6/8/2015 6:00",152,41,8,6,193,"neutor",NA
"6/8/2015 7:00",532,208,11,9,740,"neutor",NA
"6/8/2015 8:00",600,482,12,13,1082,"neutor",NA
"6/8/2015 9:00",532,334,13,15,866,"neutor",NA
"6/8/2015 10:00",579,435,13,17,1014,"neutor",NA
"6/8/2015 11:00",418,319,16,15,737,"neutor",NA
"6/8/2015 12:00",499,535,15,19,1034,"neutor",NA
"6/8/2015 13:00",505,519,16,17,1024,"neutor",NA
"6/8/2015 14:00",502,534,17,17,1036,"neutor",NA
"6/8/2015 15:00",624,530,17,17,1154,"neutor",NA
"6/8/2015 16:00",639,756,18,13,1395,"neutor",NA
"6/8/2015 17:00",783,756,17,17,1539,"neutor",NA
"6/8/2015 18:00",588,792,16,19,1380,"neutor",NA
"6/8/2015 19:00",561,559,16,17,1120,"neutor",NA
"6/8/2015 20:00",311,539,14,20,850,"neutor",NA
"6/8/2015 21:00",236,322,12,19,558,"neutor",NA
"6/8/2015 22:00",156,287,11,13,443,"neutor",NA
"6/8/2015 23:00",119,170,10,9,289,"neutor",NA
"6/9/2015 0:00",35,90,9,9,125,"neutor",NA
"6/9/2015 1:00",11,41,9,11,52,"neutor",NA
"6/9/2015 2:00",9,22,8,9,31,"neutor",NA
"6/9/2015 3:00",5,9,8,7,14,"neutor",NA
"6/9/2015 4:00",7,1,7,7,8,"neutor",NA
"6/9/2015 5:00",28,21,7,6,49,"neutor",NA
"6/9/2015 6:00",144,48,8,6,192,"neutor",NA
"6/9/2015 7:00",573,218,9,7,791,"neutor",NA
"6/9/2015 8:00",820,559,12,17,1379,"neutor",NA
"6/9/2015 9:00",535,455,12,15,990,"neutor",NA
"6/9/2015 10:00",698,620,13,17,1318,"neutor",NA
"6/9/2015 11:00",556,419,13,15,975,"neutor",NA
"6/9/2015 12:00",532,628,13,11,1160,"neutor",NA
"6/9/2015 13:00",626,496,14,9,1122,"neutor",NA
"6/9/2015 14:00",589,603,15,15,1192,"neutor",NA
"6/9/2015 15:00",586,460,16,15,1046,"neutor",NA
"6/9/2015 16:00",706,738,16,11,1444,"neutor",NA
"6/9/2015 17:00",762,706,15,13,1468,"neutor",NA
"6/9/2015 18:00",611,813,16,13,1424,"neutor",NA
"6/9/2015 19:00",582,609,15,11,1191,"neutor",NA
"6/9/2015 20:00",410,482,15,7,892,"neutor",NA
"6/9/2015 21:00",227,301,13,7,528,"neutor",NA
"6/9/2015 22:00",140,320,12,7,460,"neutor",NA
"6/9/2015 23:00",91,230,11,9,321,"neutor",NA
"6/10/2015 0:00",32,135,11,13,167,"neutor",NA
"6/10/2015 1:00",21,64,11,11,85,"neutor",NA
"6/10/2015 2:00",17,35,10,6,52,"neutor",NA
"6/10/2015 3:00",5,12,10,6,17,"neutor",NA
"6/10/2015 4:00",10,5,9,4,15,"neutor",NA
"6/10/2015 5:00",40,18,9,7,58,"neutor",NA
"6/10/2015 6:00",147,41,10,6,188,"neutor",NA
"6/10/2015 7:00",675,229,13,7,904,"neutor",NA
"6/10/2015 8:00",767,573,15,11,1340,"neutor",NA
"6/10/2015 9:00",620,407,16,13,1027,"neutor",NA
"6/10/2015 10:00",638,690,18,19,1328,"neutor",NA
"6/10/2015 11:00",615,386,19,17,1001,"neutor",NA
"6/10/2015 12:00",683,597,19,7,1280,"neutor",NA
"6/10/2015 13:00",565,548,21,13,1113,"neutor",NA
"6/10/2015 14:00",521,635,20,17,1156,"neutor",NA
"6/10/2015 15:00",507,567,20,15,1074,"neutor",NA
"6/10/2015 16:00",640,755,21,17,1395,"neutor",NA
"6/10/2015 17:00",773,696,22,11,1469,"neutor",NA
"6/10/2015 18:00",732,813,21,13,1545,"neutor",NA
"6/10/2015 19:00",602,565,21,19,1167,"neutor",NA
"6/10/2015 20:00",397,527,19,13,924,"neutor",NA
"6/10/2015 21:00",268,387,17,7,655,"neutor",NA
"6/10/2015 22:00",204,410,16,13,614,"neutor",NA
"6/10/2015 23:00",182,255,15,15,437,"neutor",NA
"6/11/2015 0:00",197,167,14,11,364,"neutor",NA
"6/11/2015 1:00",76,90,13,13,166,"neutor",NA
"6/11/2015 2:00",20,70,13,11,90,"neutor",NA
"6/11/2015 3:00",17,94,12,9,111,"neutor",NA
"6/11/2015 4:00",17,73,10,7,90,"neutor",NA
"6/11/2015 5:00",51,64,11,4,115,"neutor",NA
"6/11/2015 6:00",132,59,12,13,191,"neutor",NA
"6/11/2015 7:00",571,204,14,11,775,"neutor",NA
"6/11/2015 8:00",731,583,17,11,1314,"neutor",NA
"6/11/2015 9:00",567,469,20,9,1036,"neutor",NA
"6/11/2015 10:00",599,521,21,13,1120,"neutor",NA
"6/11/2015 11:00",525,385,21,13,910,"neutor",NA
"6/11/2015 12:00",578,631,24,13,1209,"neutor",NA
"6/11/2015 13:00",628,561,23,9,1189,"neutor",NA
"6/11/2015 14:00",614,663,23,13,1277,"neutor",NA
"6/11/2015 15:00",710,631,24,7,1341,"neutor",NA
"6/11/2015 16:00",802,798,24,17,1600,"neutor",NA
"6/11/2015 17:00",784,748,24,17,1532,"neutor",NA
"6/11/2015 18:00",918,662,23,17,1580,"neutor",NA
"6/11/2015 19:00",748,556,22,15,1304,"neutor",NA
"6/11/2015 20:00",440,417,21,19,857,"neutor",NA
"6/11/2015 21:00",285,317,20,11,602,"neutor",NA
"6/11/2015 22:00",214,404,18,6,618,"neutor",NA
"6/11/2015 23:00",90,271,15,4,361,"neutor",NA
"6/12/2015 0:00",56,364,15,4,420,"neutor",NA
"6/12/2015 1:00",38,328,13,6,366,"neutor",NA
"6/12/2015 2:00",20,100,12,6,120,"neutor",NA
"6/12/2015 3:00",10,52,12,6,62,"neutor",NA
"6/12/2015 4:00",9,34,12,6,43,"neutor",NA
"6/12/2015 5:00",40,21,11,4,61,"neutor",NA
"6/12/2015 6:00",151,50,14,7,201,"neutor",NA
"6/12/2015 7:00",472,200,17,9,672,"neutor",NA
"6/12/2015 8:00",551,457,20,11,1008,"neutor",NA
"6/12/2015 9:00",481,365,21,11,846,"neutor",NA
"6/12/2015 10:00",531,442,22,9,973,"neutor",NA
"6/12/2015 11:00",504,388,23,6,892,"neutor",NA
"6/12/2015 12:00",552,488,24,6,1040,"neutor",NA
"6/12/2015 13:00",572,531,25,6,1103,"neutor",NA
"6/12/2015 14:00",560,581,25,4,1141,"neutor",NA
"6/12/2015 15:00",565,511,26,7,1076,"neutor",NA
"6/12/2015 16:00",532,439,27,2,971,"neutor",NA
"6/12/2015 17:00",633,529,28,0,1162,"neutor",NA
"6/12/2015 18:00",639,467,27,6,1106,"neutor",NA
"6/12/2015 19:00",588,426,27,4,1014,"neutor",NA
"6/12/2015 20:00",443,359,25,2,802,"neutor",NA
"6/12/2015 21:00",267,367,22,2,634,"neutor",NA
"6/12/2015 22:00",229,377,20,2,606,"neutor",NA
"6/12/2015 23:00",144,385,19,4,529,"neutor",NA
"6/13/2015 0:00",145,288,18,2,433,"neutor",NA
"6/13/2015 1:00",66,197,16,7,263,"neutor",NA
"6/13/2015 2:00",62,120,16,2,182,"neutor",NA
"6/13/2015 3:00",33,93,17,4,126,"neutor",NA
"6/13/2015 4:00",22,51,17,6,73,"neutor",NA
"6/13/2015 5:00",22,34,18,6,56,"neutor",NA
"6/13/2015 6:00",37,29,18,4,66,"neutor",NA
"6/13/2015 7:00",108,29,19,6,137,"neutor",NA
"6/13/2015 8:00",170,100,23,9,270,"neutor",NA
"6/13/2015 9:00",334,123,23,15,457,"neutor",NA
"6/13/2015 10:00",463,246,23,24,709,"neutor",NA
"6/13/2015 11:00",411,275,22,24,686,"neutor",NA
"6/13/2015 12:00",343,304,20,28,647,"neutor",NA
"6/13/2015 13:00",196,200,17,17,396,"neutor",NA
"6/13/2015 14:00",359,300,19,17,659,"neutor",NA
"6/13/2015 15:00",348,261,21,22,609,"neutor",NA
"6/13/2015 16:00",394,247,22,26,641,"neutor",NA
"6/13/2015 17:00",326,294,22,19,620,"neutor",NA
"6/13/2015 18:00",378,330,23,20,708,"neutor",NA
"6/13/2015 19:00",300,333,22,19,633,"neutor",NA
"6/13/2015 20:00",265,263,21,19,528,"neutor",NA
"6/13/2015 21:00",204,218,18,11,422,"neutor",NA
"6/13/2015 22:00",151,202,17,7,353,"neutor",NA
"6/13/2015 23:00",167,239,17,15,406,"neutor",NA
"6/14/2015 0:00",112,190,16,17,302,"neutor",NA
"6/14/2015 1:00",77,223,17,15,300,"neutor",NA
"6/14/2015 2:00",50,147,16,20,197,"neutor",NA
"6/14/2015 3:00",13,107,16,20,120,"neutor",NA
"6/14/2015 4:00",23,103,16,20,126,"neutor",NA
"6/14/2015 5:00",15,44,15,19,59,"neutor",NA
"6/14/2015 6:00",19,30,15,13,49,"neutor",NA
"6/14/2015 7:00",34,19,14,11,53,"neutor",NA
"6/14/2015 8:00",55,31,14,7,86,"neutor",NA
"6/14/2015 9:00",166,62,15,6,228,"neutor",NA
"6/14/2015 10:00",230,114,15,7,344,"neutor",NA
"6/14/2015 11:00",226,127,16,6,353,"neutor",NA
"6/14/2015 12:00",217,205,17,6,422,"neutor",NA
"6/14/2015 13:00",222,247,17,7,469,"neutor",NA
"6/14/2015 14:00",307,209,18,6,516,"neutor",NA
"6/14/2015 15:00",306,198,18,9,504,"neutor",NA
"6/14/2015 16:00",258,253,18,9,511,"neutor",NA
"6/14/2015 17:00",267,296,18,11,563,"neutor",NA
"6/14/2015 18:00",242,310,18,13,552,"neutor",NA
"6/14/2015 19:00",200,294,18,15,494,"neutor",NA
"6/14/2015 20:00",169,245,16,9,414,"neutor",NA
"6/14/2015 21:00",106,190,16,13,296,"neutor",NA
"6/14/2015 22:00",93,134,14,15,227,"neutor",NA
"6/14/2015 23:00",55,90,14,11,145,"neutor",NA
"6/15/2015 0:00",23,49,13,11,72,"neutor",NA
"6/15/2015 1:00",7,23,13,11,30,"neutor",NA
"6/15/2015 2:00",4,16,12,13,20,"neutor",NA
"6/15/2015 3:00",3,5,12,9,8,"neutor",NA
"6/15/2015 4:00",8,5,12,15,13,"neutor",NA
"6/15/2015 5:00",38,22,11,13,60,"neutor",NA
"6/15/2015 6:00",149,37,11,13,186,"neutor",NA
"6/15/2015 7:00",516,190,12,9,706,"neutor",NA
"6/15/2015 8:00",627,494,12,15,1121,"neutor",NA
"6/15/2015 9:00",546,392,13,13,938,"neutor",NA
"6/15/2015 10:00",531,448,14,11,979,"neutor",NA
"6/15/2015 11:00",445,384,15,11,829,"neutor",NA
"6/15/2015 12:00",512,567,17,11,1079,"neutor",NA
"6/15/2015 13:00",552,498,17,13,1050,"neutor",NA
"6/15/2015 14:00",562,575,17,11,1137,"neutor",NA
"6/15/2015 15:00",602,558,18,9,1160,"neutor",NA
"6/15/2015 16:00",611,779,19,11,1390,"neutor",NA
"6/15/2015 17:00",792,744,19,11,1536,"neutor",NA
"6/15/2015 18:00",660,734,18,15,1394,"neutor",NA
"6/15/2015 19:00",644,627,16,15,1271,"neutor",NA
"6/15/2015 20:00",377,537,15,11,914,"neutor",NA
"6/15/2015 21:00",319,317,13,9,636,"neutor",NA
"6/15/2015 22:00",154,379,11,7,533,"neutor",NA
"6/15/2015 23:00",89,168,10,7,257,"neutor",NA
"6/16/2015 0:00",35,104,9,6,139,"neutor",NA
"6/16/2015 1:00",15,68,8,7,83,"neutor",NA
"6/16/2015 2:00",5,29,7,6,34,"neutor",NA
"6/16/2015 3:00",6,8,6,2,14,"neutor",NA
"6/16/2015 4:00",10,1,5,4,11,"neutor",NA
"6/16/2015 5:00",44,15,6,4,59,"neutor",NA
"6/16/2015 6:00",155,42,8,4,197,"neutor",NA
"6/16/2015 7:00",510,258,10,4,768,"neutor",NA
"6/16/2015 8:00",814,549,12,11,1363,"neutor",NA
"6/16/2015 9:00",559,402,13,13,961,"neutor",NA
"6/16/2015 10:00",620,620,14,9,1240,"neutor",NA
"6/16/2015 11:00",511,397,14,11,908,"neutor",NA
"6/16/2015 12:00",554,607,14,11,1161,"neutor",NA
"6/16/2015 13:00",619,546,15,13,1165,"neutor",NA
"6/16/2015 14:00",517,578,14,13,1095,"neutor",NA
"6/16/2015 15:00",567,520,15,11,1087,"neutor",NA
"6/16/2015 16:00",634,782,13,11,1416,"neutor",NA
"6/16/2015 17:00",759,692,14,9,1451,"neutor",NA
"6/16/2015 18:00",577,801,13,7,1378,"neutor",NA
"6/16/2015 19:00",581,598,14,9,1179,"neutor",NA
"6/16/2015 20:00",379,451,14,7,830,"neutor",NA
"6/16/2015 21:00",237,347,13,4,584,"neutor",NA
"6/16/2015 22:00",188,309,10,4,497,"neutor",NA
"6/16/2015 23:00",101,235,8,2,336,"neutor",NA
"6/17/2015 0:00",57,101,7,2,158,"neutor",NA
"6/17/2015 1:00",41,56,6,2,97,"neutor",NA
"6/17/2015 2:00",18,21,6,2,39,"neutor",NA
"6/17/2015 3:00",13,14,5,2,27,"neutor",NA
"6/17/2015 4:00",14,4,4,2,18,"neutor",NA
"6/17/2015 5:00",35,16,5,2,51,"neutor",NA
"6/17/2015 6:00",172,34,7,2,206,"neutor",NA
"6/17/2015 7:00",611,237,11,4,848,"neutor",NA
"6/17/2015 8:00",751,592,14,9,1343,"neutor",NA
"6/17/2015 9:00",590,389,15,13,979,"neutor",NA
"6/17/2015 10:00",627,575,16,15,1202,"neutor",NA
"6/17/2015 11:00",587,377,17,13,964,"neutor",NA
"6/17/2015 12:00",627,552,19,19,1179,"neutor",NA
"6/17/2015 13:00",557,517,19,19,1074,"neutor",NA
"6/17/2015 14:00",579,633,20,19,1212,"neutor",NA
"6/17/2015 15:00",561,541,21,22,1102,"neutor",NA
"6/17/2015 16:00",614,729,20,19,1343,"neutor",NA
"6/17/2015 17:00",736,668,21,19,1404,"neutor",NA
"6/17/2015 18:00",610,740,21,15,1350,"neutor",NA
"6/17/2015 19:00",646,554,21,15,1200,"neutor",NA
"6/17/2015 20:00",385,482,20,9,867,"neutor",NA
"6/17/2015 21:00",271,344,20,13,615,"neutor",NA
"6/17/2015 22:00",268,367,17,17,635,"neutor",NA
"6/17/2015 23:00",127,244,16,7,371,"neutor",NA
"6/18/2015 0:00",83,197,15,7,280,"neutor",NA
"6/18/2015 1:00",33,114,15,9,147,"neutor",NA
"6/18/2015 2:00",13,56,15,7,69,"neutor",NA
"6/18/2015 3:00",11,43,15,7,54,"neutor",NA
"6/18/2015 4:00",17,39,16,7,56,"neutor",NA
"6/18/2015 5:00",43,20,16,9,63,"neutor",NA
"6/18/2015 6:00",118,45,16,15,163,"neutor",NA
"6/18/2015 7:00",456,180,16,11,636,"neutor",NA
"6/18/2015 8:00",666,586,17,13,1252,"neutor",NA
"6/18/2015 9:00",485,397,18,13,882,"neutor",NA
"6/18/2015 10:00",534,523,17,15,1057,"neutor",NA
"6/18/2015 11:00",483,346,17,17,829,"neutor",NA
"6/18/2015 12:00",464,530,19,24,994,"neutor",NA
"6/18/2015 13:00",547,442,19,20,989,"neutor",NA
"6/18/2015 14:00",508,561,18,26,1069,"neutor",NA
"6/18/2015 15:00",579,465,17,22,1044,"neutor",NA
"6/18/2015 16:00",602,594,17,26,1196,"neutor",NA
"6/18/2015 17:00",674,655,17,24,1329,"neutor",NA
"6/18/2015 18:00",586,730,14,11,1316,"neutor",NA
"6/18/2015 19:00",487,532,14,7,1019,"neutor",NA
"6/18/2015 20:00",320,413,14,13,733,"neutor",NA
"6/18/2015 21:00",356,285,13,15,641,"neutor",NA
"6/18/2015 22:00",171,368,13,13,539,"neutor",NA
"6/18/2015 23:00",126,225,13,13,351,"neutor",NA
"6/19/2015 0:00",79,156,12,13,235,"neutor",NA
"6/19/2015 1:00",28,85,12,11,113,"neutor",NA
"6/19/2015 2:00",41,49,12,11,90,"neutor",NA
"6/19/2015 3:00",11,10,11,13,21,"neutor",NA
"6/19/2015 4:00",16,14,10,15,30,"neutor",NA
"6/19/2015 5:00",26,18,10,15,44,"neutor",NA
"6/19/2015 6:00",96,35,10,15,131,"neutor",NA
"6/19/2015 7:00",314,169,11,13,483,"neutor",NA
"6/19/2015 8:00",453,408,12,15,861,"neutor",NA
"6/19/2015 9:00",434,349,13,13,783,"neutor",NA
"6/19/2015 10:00",396,367,15,15,763,"neutor",NA
"6/19/2015 11:00",421,315,15,20,736,"neutor",NA
"6/19/2015 12:00",449,425,15,20,874,"neutor",NA
"6/19/2015 13:00",467,451,13,13,918,"neutor",NA
"6/19/2015 14:00",410,403,12,11,813,"neutor",NA
"6/19/2015 15:00",453,342,13,13,795,"neutor",NA
"6/19/2015 16:00",397,364,13,15,761,"neutor",NA
"6/19/2015 17:00",319,359,13,15,678,"neutor",NA
"6/19/2015 18:00",399,350,13,17,749,"neutor",NA
"6/19/2015 19:00",431,281,12,11,712,"neutor",NA
"6/19/2015 20:00",354,259,12,6,613,"neutor",NA
"6/19/2015 21:00",258,234,12,9,492,"neutor",NA
"6/19/2015 22:00",188,280,12,11,468,"neutor",NA
"6/19/2015 23:00",118,195,11,11,313,"neutor",NA
"6/20/2015 0:00",96,213,11,11,309,"neutor",NA
"6/20/2015 1:00",56,106,11,13,162,"neutor",NA
"6/20/2015 2:00",36,99,10,7,135,"neutor",NA
"6/20/2015 3:00",24,76,10,7,100,"neutor",NA
"6/20/2015 4:00",10,59,9,9,69,"neutor",NA
"6/20/2015 5:00",35,41,9,9,76,"neutor",NA
"6/20/2015 6:00",41,27,10,9,68,"neutor",NA
"6/20/2015 7:00",113,31,11,11,144,"neutor",NA
"6/20/2015 8:00",234,119,12,13,353,"neutor",NA
"6/20/2015 9:00",398,140,13,13,538,"neutor",NA
"6/20/2015 10:00",406,196,14,11,602,"neutor",NA
"6/20/2015 11:00",439,180,14,11,619,"neutor",NA
"6/20/2015 12:00",399,326,14,11,725,"neutor",NA
"6/20/2015 13:00",407,355,14,11,762,"neutor",NA
"6/20/2015 14:00",350,365,15,11,715,"neutor",NA
"6/20/2015 15:00",288,353,14,11,641,"neutor",NA
"6/20/2015 16:00",300,359,14,11,659,"neutor",NA
"6/20/2015 17:00",290,372,15,11,662,"neutor",NA
"6/20/2015 18:00",246,370,15,15,616,"neutor",NA
"6/20/2015 19:00",232,284,14,11,516,"neutor",NA
"6/20/2015 20:00",214,245,14,7,459,"neutor",NA
"6/20/2015 21:00",275,131,13,6,406,"neutor",NA
"6/20/2015 22:00",312,158,13,6,470,"neutor",NA
"6/20/2015 23:00",199,255,13,6,454,"neutor",NA
"6/21/2015 0:00",134,181,12,6,315,"neutor",NA
"6/21/2015 1:00",90,145,12,6,235,"neutor",NA
"6/21/2015 2:00",47,128,11,4,175,"neutor",NA
"6/21/2015 3:00",29,100,11,2,129,"neutor",NA
"6/21/2015 4:00",25,79,11,0,104,"neutor",NA
"6/21/2015 5:00",24,42,11,4,66,"neutor",NA
"6/21/2015 6:00",21,32,11,4,53,"neutor",NA
"6/21/2015 7:00",44,29,12,4,73,"neutor",NA
"6/21/2015 8:00",62,37,13,9,99,"neutor",NA
"6/21/2015 9:00",149,63,13,11,212,"neutor",NA
"6/21/2015 10:00",179,132,15,13,311,"neutor",NA
"6/21/2015 11:00",213,133,16,13,346,"neutor",NA
"6/21/2015 12:00",217,147,16,9,364,"neutor",NA
"6/21/2015 13:00",195,174,16,13,369,"neutor",NA
"6/21/2015 14:00",139,134,16,7,273,"neutor",NA
"6/21/2015 15:00",96,121,16,9,217,"neutor",NA
"6/21/2015 16:00",137,163,15,2,300,"neutor",NA
"6/21/2015 17:00",128,174,16,6,302,"neutor",NA
"6/21/2015 18:00",130,162,18,6,292,"neutor",NA
"6/21/2015 19:00",147,181,17,13,328,"neutor",NA
"6/21/2015 20:00",105,170,17,11,275,"neutor",NA
"6/21/2015 21:00",73,129,15,17,202,"neutor",NA
"6/21/2015 22:00",44,94,13,15,138,"neutor",NA
"6/21/2015 23:00",48,97,12,11,145,"neutor",NA
"6/22/2015 0:00",15,44,11,6,59,"neutor",NA
"6/22/2015 1:00",17,19,11,6,36,"neutor",NA
"6/22/2015 2:00",4,3,11,6,7,"neutor",NA
"6/22/2015 3:00",9,2,11,2,11,"neutor",NA
"6/22/2015 4:00",8,1,11,6,9,"neutor",NA
"6/22/2015 5:00",28,11,11,7,39,"neutor",NA
"6/22/2015 6:00",109,25,12,9,134,"neutor",NA
"6/22/2015 7:00",347,134,13,9,481,"neutor",NA
"6/22/2015 8:00",480,347,12,15,827,"neutor",NA
"6/22/2015 9:00",323,222,12,15,545,"neutor",NA
"6/22/2015 10:00",383,342,13,11,725,"neutor",NA
"6/22/2015 11:00",388,243,14,15,631,"neutor",NA
"6/22/2015 12:00",446,446,15,17,892,"neutor",NA
"6/22/2015 13:00",433,433,14,15,866,"neutor",NA
"6/22/2015 14:00",427,451,14,17,878,"neutor",NA
"6/22/2015 15:00",445,424,14,13,869,"neutor",NA
"6/22/2015 16:00",535,477,14,15,1012,"neutor",NA
"6/22/2015 17:00",502,522,13,19,1024,"neutor",NA
"6/22/2015 18:00",427,554,11,11,981,"neutor",NA
"6/22/2015 19:00",425,417,11,6,842,"neutor",NA
"6/22/2015 20:00",285,357,11,7,642,"neutor",NA
"6/22/2015 21:00",146,223,11,6,369,"neutor",NA
"6/22/2015 22:00",131,197,10,2,328,"neutor",NA
"6/22/2015 23:00",61,141,11,9,202,"neutor",NA
"6/23/2015 0:00",41,94,9,7,135,"neutor",NA
"6/23/2015 1:00",10,53,9,7,63,"neutor",NA
"6/23/2015 2:00",3,25,9,7,28,"neutor",NA
"6/23/2015 3:00",5,6,8,7,11,"neutor",NA
"6/23/2015 4:00",10,1,8,9,11,"neutor",NA
"6/23/2015 5:00",35,14,8,7,49,"neutor",NA
"6/23/2015 6:00",124,31,9,9,155,"neutor",NA
"6/23/2015 7:00",417,167,10,11,584,"neutor",NA
"6/23/2015 8:00",802,533,12,13,1335,"neutor",NA
"6/23/2015 9:00",550,399,12,19,949,"neutor",NA
"6/23/2015 10:00",642,549,14,15,1191,"neutor",NA
"6/23/2015 11:00",515,388,15,15,903,"neutor",NA
"6/23/2015 12:00",507,573,13,19,1080,"neutor",NA
"6/23/2015 13:00",578,476,15,24,1054,"neutor",NA
"6/23/2015 14:00",463,541,16,30,1004,"neutor",NA
"6/23/2015 15:00",530,428,14,19,958,"neutor",NA
"6/23/2015 16:00",502,639,14,19,1141,"neutor",NA
"6/23/2015 17:00",652,587,14,17,1239,"neutor",NA
"6/23/2015 18:00",582,690,13,13,1272,"neutor",NA
"6/23/2015 19:00",610,437,14,20,1047,"neutor",NA
"6/23/2015 20:00",350,400,14,20,750,"neutor",NA
"6/23/2015 21:00",171,288,13,20,459,"neutor",NA
"6/23/2015 22:00",178,303,13,17,481,"neutor",NA
"6/23/2015 23:00",96,222,12,19,318,"neutor",NA
"6/24/2015 0:00",40,99,12,11,139,"neutor",NA
"6/24/2015 1:00",26,53,12,15,79,"neutor",NA
"6/24/2015 2:00",13,13,11,15,26,"neutor",NA
"6/24/2015 3:00",9,15,11,13,24,"neutor",NA
"6/24/2015 4:00",14,4,11,13,18,"neutor",NA
"6/24/2015 5:00",40,18,11,13,58,"neutor",NA
"6/24/2015 6:00",141,38,12,13,179,"neutor",NA
"6/24/2015 7:00",526,188,12,15,714,"neutor",NA
"6/24/2015 8:00",722,535,13,20,1257,"neutor",NA
"6/24/2015 9:00",521,348,13,19,869,"neutor",NA
"6/24/2015 10:00",510,578,14,19,1088,"neutor",NA
"6/24/2015 11:00",506,299,14,17,805,"neutor",NA
"6/24/2015 12:00",569,488,15,17,1057,"neutor",NA
"6/24/2015 13:00",548,485,16,15,1033,"neutor",NA
"6/24/2015 14:00",548,659,16,15,1207,"neutor",NA
"6/24/2015 15:00",525,555,18,15,1080,"neutor",NA
"6/24/2015 16:00",688,694,18,17,1382,"neutor",NA
"6/24/2015 17:00",609,735,19,13,1344,"neutor",NA
"6/24/2015 18:00",698,771,19,15,1469,"neutor",NA
"6/24/2015 19:00",661,519,18,15,1180,"neutor",NA
"6/24/2015 20:00",438,426,17,9,864,"neutor",NA
"6/24/2015 21:00",375,291,16,7,666,"neutor",NA
"6/24/2015 22:00",221,305,16,7,526,"neutor",NA
"6/24/2015 23:00",170,296,15,4,466,"neutor",NA
"6/25/2015 0:00",99,173,13,6,272,"neutor",NA
"6/25/2015 1:00",79,127,12,7,206,"neutor",NA
"6/25/2015 2:00",19,72,12,4,91,"neutor",NA
"6/25/2015 3:00",17,63,11,2,80,"neutor",NA
"6/25/2015 4:00",15,28,11,2,43,"neutor",NA
"6/25/2015 5:00",36,22,11,6,58,"neutor",NA
"6/25/2015 6:00",129,39,12,7,168,"neutor",NA
"6/25/2015 7:00",430,185,14,4,615,"neutor",NA
"6/25/2015 8:00",764,569,16,7,1333,"neutor",NA
"6/25/2015 9:00",567,354,19,11,921,"neutor",NA
"6/25/2015 10:00",570,505,20,9,1075,"neutor",NA
"6/25/2015 11:00",543,356,22,15,899,"neutor",NA
"6/25/2015 12:00",566,549,22,15,1115,"neutor",NA
"6/25/2015 13:00",590,549,22,17,1139,"neutor",NA
"6/25/2015 14:00",555,600,23,13,1155,"neutor",NA
"6/25/2015 15:00",674,549,24,19,1223,"neutor",NA
"6/25/2015 16:00",662,630,23,13,1292,"neutor",NA
"6/25/2015 17:00",691,668,24,15,1359,"neutor",NA
"6/25/2015 18:00",712,688,23,9,1400,"neutor",NA
"6/25/2015 19:00",604,556,23,11,1160,"neutor",NA
"6/25/2015 20:00",440,508,22,6,948,"neutor",NA
"6/25/2015 21:00",275,395,19,2,670,"neutor",NA
"6/25/2015 22:00",209,386,17,4,595,"neutor",NA
"6/25/2015 23:00",114,295,16,4,409,"neutor",NA
"6/26/2015 0:00",50,200,17,6,250,"neutor",NA
"6/26/2015 1:00",37,123,17,4,160,"neutor",NA
"6/26/2015 2:00",22,69,16,4,91,"neutor",NA
"6/26/2015 3:00",11,42,16,2,53,"neutor",NA
"6/26/2015 4:00",10,13,15,4,23,"neutor",NA
"6/26/2015 5:00",36,20,15,4,56,"neutor",NA
"6/26/2015 6:00",118,35,16,4,153,"neutor",NA
"6/26/2015 7:00",375,197,17,4,572,"neutor",NA
"6/26/2015 8:00",541,444,18,2,985,"neutor",NA
"6/26/2015 9:00",490,358,20,2,848,"neutor",NA
"6/26/2015 10:00",468,453,22,7,921,"neutor",NA
"6/26/2015 11:00",482,340,22,4,822,"neutor",NA
"6/26/2015 12:00",512,466,23,6,978,"neutor",NA
"6/26/2015 13:00",493,463,24,11,956,"neutor",NA
"6/26/2015 14:00",524,473,25,13,997,"neutor",NA
"6/26/2015 15:00",525,446,25,22,971,"neutor",NA
"6/26/2015 16:00",520,473,25,17,993,"neutor",NA
"6/26/2015 17:00",479,483,24,20,962,"neutor",NA
"6/26/2015 18:00",554,459,23,11,1013,"neutor",NA
"6/26/2015 19:00",615,382,23,4,997,"neutor",NA
"6/26/2015 20:00",458,376,22,7,834,"neutor",NA
"6/26/2015 21:00",422,291,21,6,713,"neutor",NA
"6/26/2015 22:00",332,279,20,6,611,"neutor",NA
"6/26/2015 23:00",202,628,20,7,830,"neutor",NA
"6/27/2015 0:00",186,349,20,11,535,"neutor",NA
"6/27/2015 1:00",78,206,19,11,284,"neutor",NA
"6/27/2015 2:00",51,134,18,2,185,"neutor",NA
"6/27/2015 3:00",32,91,17,7,123,"neutor",NA
"6/27/2015 4:00",20,57,16,6,77,"neutor",NA
"6/27/2015 5:00",26,29,16,7,55,"neutor",NA
"6/27/2015 6:00",23,19,17,9,42,"neutor",NA
"6/27/2015 7:00",82,28,18,13,110,"neutor",NA
"6/27/2015 8:00",139,65,19,19,204,"neutor",NA
"6/27/2015 9:00",279,144,19,19,423,"neutor",NA
"6/27/2015 10:00",359,147,19,19,506,"neutor",NA
"6/27/2015 11:00",357,194,20,24,551,"neutor",NA
"6/27/2015 12:00",372,219,20,17,591,"neutor",NA
"6/27/2015 13:00",388,277,21,22,665,"neutor",NA
"6/27/2015 14:00",367,305,22,24,672,"neutor",NA
"6/27/2015 15:00",346,298,23,24,644,"neutor",NA
"6/27/2015 16:00",379,324,22,22,703,"neutor",NA
"6/27/2015 17:00",370,362,21,20,732,"neutor",NA
"6/27/2015 18:00",419,387,21,19,806,"neutor",NA
"6/27/2015 19:00",397,337,20,22,734,"neutor",NA
"6/27/2015 20:00",387,304,19,15,691,"neutor",NA
"6/27/2015 21:00",265,241,17,11,506,"neutor",NA
"6/27/2015 22:00",206,209,16,7,415,"neutor",NA
"6/27/2015 23:00",122,379,14,7,501,"neutor",NA
"6/28/2015 0:00",131,249,13,6,380,"neutor",NA
"6/28/2015 1:00",102,148,12,6,250,"neutor",NA
"6/28/2015 2:00",62,90,11,2,152,"neutor",NA
"6/28/2015 3:00",32,112,10,0,144,"neutor",NA
"6/28/2015 4:00",17,47,10,2,64,"neutor",NA
"6/28/2015 5:00",20,51,9,2,71,"neutor",NA
"6/28/2015 6:00",16,24,11,4,40,"neutor",NA
"6/28/2015 7:00",37,16,14,2,53,"neutor",NA
"6/28/2015 8:00",55,37,17,2,92,"neutor",NA
"6/28/2015 9:00",191,111,18,4,302,"neutor",NA
"6/28/2015 10:00",264,121,19,4,385,"neutor",NA
"6/28/2015 11:00",321,201,20,9,522,"neutor",NA
"6/28/2015 12:00",332,262,21,6,594,"neutor",NA
"6/28/2015 13:00",384,310,22,2,694,"neutor",NA
"6/28/2015 14:00",385,386,22,11,771,"neutor",NA
"6/28/2015 15:00",433,358,22,7,791,"neutor",NA
"6/28/2015 16:00",337,372,21,7,709,"neutor",NA
"6/28/2015 17:00",281,301,19,6,582,"neutor",NA
"6/28/2015 18:00",409,320,20,6,729,"neutor",NA
"6/28/2015 19:00",292,281,19,2,573,"neutor",NA
"6/28/2015 20:00",216,263,18,6,479,"neutor",NA
"6/28/2015 21:00",134,261,18,9,395,"neutor",NA
"6/28/2015 22:00",84,208,17,2,292,"neutor",NA
"6/28/2015 23:00",65,112,17,4,177,"neutor",NA
"6/29/2015 0:00",27,53,17,7,80,"neutor",NA
"6/29/2015 1:00",11,28,17,7,39,"neutor",NA
"6/29/2015 2:00",13,13,16,6,26,"neutor",NA
"6/29/2015 3:00",8,11,16,4,19,"neutor",NA
"6/29/2015 4:00",10,5,16,4,15,"neutor",NA
"6/29/2015 5:00",33,10,15,4,43,"neutor",NA
"6/29/2015 6:00",110,35,16,2,145,"neutor",NA
"6/29/2015 7:00",321,166,18,4,487,"neutor",NA
"6/29/2015 8:00",541,424,19,9,965,"neutor",NA
"6/29/2015 9:00",563,365,20,9,928,"neutor",NA
"6/29/2015 10:00",539,497,21,9,1036,"neutor",NA
"6/29/2015 11:00",438,327,22,11,765,"neutor",NA
"6/29/2015 12:00",558,542,22,11,1100,"neutor",NA
"6/29/2015 13:00",597,454,24,15,1051,"neutor",NA
"6/29/2015 14:00",579,554,23,13,1133,"neutor",NA
"6/29/2015 15:00",652,534,24,11,1186,"neutor",NA
"6/29/2015 16:00",743,713,24,11,1456,"neutor",NA
"6/29/2015 17:00",796,758,25,13,1554,"neutor",NA
"6/29/2015 18:00",813,906,25,11,1719,"neutor",NA
"6/29/2015 19:00",735,622,24,11,1357,"neutor",NA
"6/29/2015 20:00",490,583,21,15,1073,"neutor",NA
"6/29/2015 21:00",330,423,19,7,753,"neutor",NA
"6/29/2015 22:00",215,376,19,9,591,"neutor",NA
"6/29/2015 23:00",130,262,17,7,392,"neutor",NA
"6/30/2015 0:00",47,132,16,4,179,"neutor",NA
"6/30/2015 1:00",11,58,15,4,69,"neutor",NA
"6/30/2015 2:00",18,19,14,2,37,"neutor",NA
"6/30/2015 3:00",13,8,12,2,21,"neutor",NA
"6/30/2015 4:00",14,5,12,4,19,"neutor",NA
"6/30/2015 5:00",39,16,12,2,55,"neutor",NA
"6/30/2015 6:00",132,47,15,2,179,"neutor",NA
"6/30/2015 7:00",350,204,18,7,554,"neutor",NA
"6/30/2015 8:00",765,525,20,6,1290,"neutor",NA
"6/30/2015 9:00",561,459,21,7,1020,"neutor",NA
"6/30/2015 10:00",687,633,22,7,1320,"neutor",NA
"6/30/2015 11:00",578,408,23,2,986,"neutor",NA
"6/30/2015 12:00",569,619,23,4,1188,"neutor",NA
"6/30/2015 13:00",623,496,25,7,1119,"neutor",NA
"6/30/2015 14:00",634,592,25,9,1226,"neutor",NA
"6/30/2015 15:00",583,632,26,7,1215,"neutor",NA
"6/30/2015 16:00",737,736,27,13,1473,"neutor",NA
"6/30/2015 17:00",922,643,27,11,1565,"neutor",NA
"6/30/2015 18:00",691,788,26,15,1479,"neutor",NA
"6/30/2015 19:00",656,617,25,15,1273,"neutor",NA
"6/30/2015 20:00",435,506,24,15,941,"neutor",NA
"6/30/2015 21:00",332,350,22,4,682,"neutor",NA
"6/30/2015 22:00",187,410,20,7,597,"neutor",NA
"6/30/2015 23:00",125,320,18,7,445,"neutor",NA
"7/1/2015 0:00",61,173,19,9,234,"neutor",NA
"7/1/2015 1:00",23,78,17,6,101,"neutor",NA
"7/1/2015 2:00",11,21,17,7,32,"neutor",NA
"7/1/2015 3:00",8,8,17,9,16,"neutor",NA
"7/1/2015 4:00",15,7,17,11,22,"neutor",NA
"7/1/2015 5:00",33,20,18,7,53,"neutor",NA
"7/1/2015 6:00",152,47,19,9,199,"neutor",NA
"7/1/2015 7:00",503,220,21,11,723,"neutor",NA
"7/1/2015 8:00",719,554,23,15,1273,"neutor",NA
"7/1/2015 9:00",608,448,24,9,1056,"neutor",NA
"7/1/2015 10:00",644,601,26,11,1245,"neutor",NA
"7/1/2015 11:00",539,379,28,15,918,"neutor",NA
"7/1/2015 12:00",633,594,29,17,1227,"neutor",NA
"7/1/2015 13:00",577,512,30,17,1089,"neutor",NA
"7/1/2015 14:00",566,704,30,15,1270,"neutor",NA
"7/1/2015 15:00",635,555,31,17,1190,"neutor",NA
"7/1/2015 16:00",732,624,31,15,1356,"neutor",NA
"7/1/2015 17:00",772,613,32,17,1385,"neutor",NA
"7/1/2015 18:00",786,705,31,15,1491,"neutor",NA
"7/1/2015 19:00",665,510,30,17,1175,"neutor",NA
"7/1/2015 20:00",402,474,29,15,876,"neutor",NA
"7/1/2015 21:00",234,378,27,13,612,"neutor",NA
"7/1/2015 22:00",210,464,26,11,674,"neutor",NA
"7/1/2015 23:00",114,361,25,13,475,"neutor",NA
"7/2/2015 0:00",95,210,24,11,305,"neutor",NA
"7/2/2015 1:00",68,108,23,9,176,"neutor",NA
"7/2/2015 2:00",40,63,22,11,103,"neutor",NA
"7/2/2015 3:00",9,42,22,13,51,"neutor",NA
"7/2/2015 4:00",20,31,22,11,51,"neutor",NA
"7/2/2015 5:00",50,26,22,9,76,"neutor",NA
"7/2/2015 6:00",143,53,22,11,196,"neutor",NA
"7/2/2015 7:00",357,195,24,13,552,"neutor",NA
"7/2/2015 8:00",719,578,26,11,1297,"neutor",NA
"7/2/2015 9:00",564,408,28,11,972,"neutor",NA
"7/2/2015 10:00",547,501,30,9,1048,"neutor",NA
"7/2/2015 11:00",459,409,31,13,868,"neutor",NA
"7/2/2015 12:00",552,615,32,11,1167,"neutor",NA
"7/2/2015 13:00",489,476,34,11,965,"neutor",NA
"7/2/2015 14:00",518,486,36,11,1004,"neutor",NA
"7/2/2015 15:00",689,472,36,11,1161,"neutor",NA
"7/2/2015 16:00",739,562,37,9,1301,"neutor",NA
"7/2/2015 17:00",586,532,37,7,1118,"neutor",NA
"7/2/2015 18:00",554,581,36,13,1135,"neutor",NA
"7/2/2015 19:00",580,455,35,11,1035,"neutor",NA
"7/2/2015 20:00",386,395,33,7,781,"neutor",NA
"7/2/2015 21:00",297,338,31,11,635,"neutor",NA
"7/2/2015 22:00",212,304,29,4,516,"neutor",NA
"7/2/2015 23:00",133,272,26,2,405,"neutor",NA
"7/3/2015 0:00",76,202,25,24,278,"neutor",NA
"7/3/2015 1:00",35,113,23,20,148,"neutor",NA
"7/3/2015 2:00",16,51,23,19,67,"neutor",NA
"7/3/2015 3:00",12,54,20,11,66,"neutor",NA
"7/3/2015 4:00",15,50,20,9,65,"neutor",NA
"7/3/2015 5:00",30,33,20,6,63,"neutor",NA
"7/3/2015 6:00",147,60,20,2,207,"neutor",NA
"7/3/2015 7:00",295,162,21,2,457,"neutor",NA
"7/3/2015 8:00",511,394,23,7,905,"neutor",NA
"7/3/2015 9:00",431,372,24,2,803,"neutor",NA
"7/3/2015 10:00",486,388,26,4,874,"neutor",NA
"7/3/2015 11:00",453,333,27,7,786,"neutor",NA
"7/3/2015 12:00",423,428,28,11,851,"neutor",NA
"7/3/2015 13:00",450,412,29,7,862,"neutor",NA
"7/3/2015 14:00",466,457,30,7,923,"neutor",NA
"7/3/2015 15:00",488,401,30,11,889,"neutor",NA
"7/3/2015 16:00",460,390,30,11,850,"neutor",NA
"7/3/2015 17:00",464,384,31,11,848,"neutor",NA
"7/3/2015 18:00",487,440,30,15,927,"neutor",NA
"7/3/2015 19:00",565,355,29,13,920,"neutor",NA
"7/3/2015 20:00",444,366,28,6,810,"neutor",NA
"7/3/2015 21:00",285,252,26,9,537,"neutor",NA
"7/3/2015 22:00",213,314,24,9,527,"neutor",NA
"7/3/2015 23:00",177,344,23,7,521,"neutor",NA
"7/4/2015 0:00",139,335,22,4,474,"neutor",NA
"7/4/2015 1:00",69,220,21,6,289,"neutor",NA
"7/4/2015 2:00",51,126,21,7,177,"neutor",NA
"7/4/2015 3:00",39,55,21,4,94,"neutor",NA
"7/4/2015 4:00",14,44,19,2,58,"neutor",NA
"7/4/2015 5:00",18,35,19,2,53,"neutor",NA
"7/4/2015 6:00",55,34,20,2,89,"neutor",NA
"7/4/2015 7:00",104,44,24,6,148,"neutor",NA
"7/4/2015 8:00",235,111,26,9,346,"neutor",NA
"7/4/2015 9:00",391,173,29,9,564,"neutor",NA
"7/4/2015 10:00",375,200,31,9,575,"neutor",NA
"7/4/2015 11:00",316,179,34,7,495,"neutor",NA
"7/4/2015 12:00",302,218,35,11,520,"neutor",NA
"7/4/2015 13:00",327,247,35,15,574,"neutor",NA
"7/4/2015 14:00",283,258,37,15,541,"neutor",NA
"7/4/2015 15:00",277,241,37,20,518,"neutor",NA
"7/4/2015 16:00",229,221,36,17,450,"neutor",NA
"7/4/2015 17:00",307,245,35,24,552,"neutor",NA
"7/4/2015 18:00",297,282,34,17,579,"neutor",NA
"7/4/2015 19:00",272,278,33,13,550,"neutor",NA
"7/4/2015 20:00",390,292,30,13,682,"neutor",NA
"7/4/2015 21:00",244,262,28,6,506,"neutor",NA
"7/4/2015 22:00",206,232,26,9,438,"neutor",NA
"7/4/2015 23:00",165,240,25,11,405,"neutor",NA
"7/5/2015 0:00",92,258,24,9,350,"neutor",NA
"7/5/2015 1:00",106,180,23,7,286,"neutor",NA
"7/5/2015 2:00",53,98,23,9,151,"neutor",NA
"7/5/2015 3:00",17,89,22,6,106,"neutor",NA
"7/5/2015 4:00",12,69,20,7,81,"neutor",NA
"7/5/2015 5:00",15,45,20,6,60,"neutor",NA
"7/5/2015 6:00",28,30,21,9,58,"neutor",NA
"7/5/2015 7:00",32,21,22,7,53,"neutor",NA
"7/5/2015 8:00",51,48,22,4,99,"neutor",NA
"7/5/2015 9:00",148,71,24,11,219,"neutor",NA
"7/5/2015 10:00",93,44,22,6,137,"neutor",NA
"7/5/2015 11:00",68,40,21,9,108,"neutor",NA
"7/5/2015 12:00",122,60,21,9,182,"neutor",NA
"7/5/2015 13:00",123,102,22,9,225,"neutor",NA
"7/5/2015 14:00",221,148,26,7,369,"neutor",NA
"7/5/2015 15:00",223,156,28,9,379,"neutor",NA
"7/5/2015 16:00",242,186,26,13,428,"neutor",NA
"7/5/2015 17:00",233,247,27,9,480,"neutor",NA
"7/5/2015 18:00",282,273,23,33,555,"neutor",NA
"7/5/2015 19:00",172,244,19,17,416,"neutor",NA
"7/5/2015 20:00",120,190,19,9,310,"neutor",NA
"7/5/2015 21:00",109,167,19,9,276,"neutor",NA
"7/5/2015 22:00",74,130,19,11,204,"neutor",NA
"7/5/2015 23:00",39,114,19,11,153,"neutor",NA
"7/6/2015 0:00",33,48,19,17,81,"neutor",NA
"7/6/2015 1:00",8,34,17,13,42,"neutor",NA
"7/6/2015 2:00",6,11,16,9,17,"neutor",NA
"7/6/2015 3:00",2,3,16,11,5,"neutor",NA
"7/6/2015 4:00",18,3,16,13,21,"neutor",NA
"7/6/2015 5:00",27,20,16,11,47,"neutor",NA
"7/6/2015 6:00",117,44,16,13,161,"neutor",NA
"7/6/2015 7:00",331,181,17,15,512,"neutor",NA
"7/6/2015 8:00",567,392,18,15,959,"neutor",NA
"7/6/2015 9:00",526,372,20,15,898,"neutor",NA
"7/6/2015 10:00",468,429,20,17,897,"neutor",NA
"7/6/2015 11:00",429,306,21,19,735,"neutor",NA
"7/6/2015 12:00",485,540,21,22,1025,"neutor",NA
"7/6/2015 13:00",450,423,22,24,873,"neutor",NA
"7/6/2015 14:00",442,500,23,20,942,"neutor",NA
"7/6/2015 15:00",532,469,23,17,1001,"neutor",NA
"7/6/2015 16:00",630,600,25,13,1230,"neutor",NA
"7/6/2015 17:00",656,564,25,11,1220,"neutor",NA
"7/6/2015 18:00",577,679,24,15,1256,"neutor",NA
"7/6/2015 19:00",512,631,24,11,1143,"neutor",NA
"7/6/2015 20:00",319,479,22,7,798,"neutor",NA
"7/6/2015 21:00",243,327,18,4,570,"neutor",NA
"7/6/2015 22:00",154,306,17,2,460,"neutor",NA
"7/6/2015 23:00",106,223,15,2,329,"neutor",NA
"7/7/2015 0:00",41,125,14,0,166,"neutor",NA
"7/7/2015 1:00",15,66,13,2,81,"neutor",NA
"7/7/2015 2:00",11,12,13,2,23,"neutor",NA
"7/7/2015 3:00",7,10,15,6,17,"neutor",NA
"7/7/2015 4:00",15,5,14,4,20,"neutor",NA
"7/7/2015 5:00",36,18,14,4,54,"neutor",NA
"7/7/2015 6:00",124,51,16,7,175,"neutor",NA
"7/7/2015 7:00",364,186,18,4,550,"neutor",NA
"7/7/2015 8:00",747,429,21,4,1176,"neutor",NA
"7/7/2015 9:00",567,422,24,7,989,"neutor",NA
"7/7/2015 10:00",572,518,25,7,1090,"neutor",NA
"7/7/2015 11:00",482,477,27,9,959,"neutor",NA
"7/7/2015 12:00",526,576,29,13,1102,"neutor",NA
"7/7/2015 13:00",586,518,29,15,1104,"neutor",NA
"7/7/2015 14:00",498,591,29,9,1089,"neutor",NA
"7/7/2015 15:00",521,437,29,6,958,"neutor",NA
"7/7/2015 16:00",594,673,29,6,1267,"neutor",NA
"7/7/2015 17:00",608,570,24,35,1178,"neutor",NA
"7/7/2015 18:00",583,633,26,33,1216,"neutor",NA
"7/7/2015 19:00",533,474,25,26,1007,"neutor",NA
"7/7/2015 20:00",383,402,24,24,785,"neutor",NA
"7/7/2015 21:00",236,320,22,19,556,"neutor",NA
"7/7/2015 22:00",135,360,20,9,495,"neutor",NA
"7/7/2015 23:00",89,259,21,20,348,"neutor",NA
"7/8/2015 0:00",37,183,20,20,220,"neutor",NA
"7/8/2015 1:00",22,97,19,26,119,"neutor",NA
"7/8/2015 2:00",7,26,18,22,33,"neutor",NA
"7/8/2015 3:00",2,21,18,22,23,"neutor",NA
"7/8/2015 4:00",16,4,17,19,20,"neutor",NA
"7/8/2015 5:00",44,12,16,19,56,"neutor",NA
"7/8/2015 6:00",130,27,16,26,157,"neutor",NA
"7/8/2015 7:00",350,174,16,24,524,"neutor",NA
"7/8/2015 8:00",663,441,17,28,1104,"neutor",NA
"7/8/2015 9:00",513,331,18,28,844,"neutor",NA
"7/8/2015 10:00",621,451,18,30,1072,"neutor",NA
"7/8/2015 11:00",518,342,18,30,860,"neutor",NA
"7/8/2015 12:00",471,464,17,22,935,"neutor",NA
"7/8/2015 13:00",404,405,17,30,809,"neutor",NA
"7/8/2015 14:00",414,533,17,20,947,"neutor",NA
"7/8/2015 15:00",402,381,17,30,783,"neutor",NA
"7/8/2015 16:00",438,561,16,20,999,"neutor",NA
"7/8/2015 17:00",504,449,18,19,953,"neutor",NA
"7/8/2015 18:00",407,546,17,26,953,"neutor",NA
"7/8/2015 19:00",397,439,17,20,836,"neutor",NA
"7/8/2015 20:00",266,438,17,17,704,"neutor",NA
"7/8/2015 21:00",204,276,16,13,480,"neutor",NA
"7/8/2015 22:00",229,243,16,15,472,"neutor",NA
"7/8/2015 23:00",141,218,15,15,359,"neutor",NA
"7/9/2015 0:00",59,127,15,17,186,"neutor",NA
"7/9/2015 1:00",31,88,13,17,119,"neutor",NA
"7/9/2015 2:00",32,80,13,13,112,"neutor",NA
"7/9/2015 3:00",10,38,11,11,48,"neutor",NA
"7/9/2015 4:00",10,23,11,13,33,"neutor",NA
"7/9/2015 5:00",42,29,11,11,71,"neutor",NA
"7/9/2015 6:00",118,42,12,15,160,"neutor",NA
"7/9/2015 7:00",317,180,12,19,497,"neutor",NA
"7/9/2015 8:00",615,405,14,22,1020,"neutor",NA
"7/9/2015 9:00",494,307,15,24,801,"neutor",NA
"7/9/2015 10:00",480,405,15,20,885,"neutor",NA
"7/9/2015 11:00",389,345,17,24,734,"neutor",NA
"7/9/2015 12:00",396,518,16,17,914,"neutor",NA
"7/9/2015 13:00",433,400,15,13,833,"neutor",NA
"7/9/2015 14:00",427,488,16,19,915,"neutor",NA
"7/9/2015 15:00",568,423,16,24,991,"neutor",NA
"7/9/2015 16:00",536,517,18,28,1053,"neutor",NA
"7/9/2015 17:00",528,538,17,22,1066,"neutor",NA
"7/9/2015 18:00",504,599,17,20,1103,"neutor",NA
"7/9/2015 19:00",476,501,16,19,977,"neutor",NA
"7/9/2015 20:00",389,369,15,13,758,"neutor",NA
"7/9/2015 21:00",270,264,13,9,534,"neutor",NA
"7/9/2015 22:00",243,277,12,11,520,"neutor",NA
"7/9/2015 23:00",115,322,11,9,437,"neutor",NA
"7/10/2015 0:00",57,202,10,6,259,"neutor",NA
"7/10/2015 1:00",28,127,9,7,155,"neutor",NA
"7/10/2015 2:00",13,67,8,6,80,"neutor",NA
"7/10/2015 3:00",2,18,7,6,20,"neutor",NA
"7/10/2015 4:00",14,13,6,2,27,"neutor",NA
"7/10/2015 5:00",38,20,8,6,58,"neutor",NA
"7/10/2015 6:00",123,34,9,0,157,"neutor",NA
"7/10/2015 7:00",294,169,11,4,463,"neutor",NA
"7/10/2015 8:00",542,357,13,2,899,"neutor",NA
"7/10/2015 9:00",481,319,14,6,800,"neutor",NA
"7/10/2015 10:00",500,349,16,7,849,"neutor",NA
"7/10/2015 11:00",443,334,17,9,777,"neutor",NA
"7/10/2015 12:00",493,468,18,9,961,"neutor",NA
"7/10/2015 13:00",438,448,20,13,886,"neutor",NA
"7/10/2015 14:00",399,478,20,20,877,"neutor",NA
"7/10/2015 15:00",487,457,21,7,944,"neutor",NA
"7/10/2015 16:00",470,439,22,13,909,"neutor",NA
"7/10/2015 17:00",443,422,22,9,865,"neutor",NA
"7/10/2015 18:00",581,504,21,9,1085,"neutor",NA
"7/10/2015 19:00",629,375,21,2,1004,"neutor",NA
"7/10/2015 20:00",511,353,20,6,864,"neutor",NA
"7/10/2015 21:00",332,279,18,4,611,"neutor",NA
"7/10/2015 22:00",247,318,16,2,565,"neutor",NA
"7/10/2015 23:00",190,386,13,6,576,"neutor",NA
"7/11/2015 0:00",92,409,14,7,501,"neutor",NA
"7/11/2015 1:00",70,274,14,6,344,"neutor",NA
"7/11/2015 2:00",39,162,13,4,201,"neutor",NA
"7/11/2015 3:00",10,91,13,7,101,"neutor",NA
"7/11/2015 4:00",13,56,12,7,69,"neutor",NA
"7/11/2015 5:00",18,28,13,7,46,"neutor",NA
"7/11/2015 6:00",35,26,14,7,61,"neutor",NA
"7/11/2015 7:00",96,46,14,6,142,"neutor",NA
"7/11/2015 8:00",164,78,16,7,242,"neutor",NA
"7/11/2015 9:00",314,123,19,9,437,"neutor",NA
"7/11/2015 10:00",373,157,21,9,530,"neutor",NA
"7/11/2015 11:00",386,234,22,11,620,"neutor",NA
"7/11/2015 12:00",396,267,24,13,663,"neutor",NA
"7/11/2015 13:00",446,287,26,7,733,"neutor",NA
"7/11/2015 14:00",378,397,27,6,775,"neutor",NA
"7/11/2015 15:00",399,335,27,6,734,"neutor",NA
"7/11/2015 16:00",398,305,29,11,703,"neutor",NA
"7/11/2015 17:00",346,358,28,9,704,"neutor",NA
"7/11/2015 18:00",429,401,28,13,830,"neutor",NA
"7/11/2015 19:00",517,376,27,9,893,"neutor",NA
"7/11/2015 20:00",452,311,25,2,763,"neutor",NA
"7/11/2015 21:00",323,246,21,4,569,"neutor",NA
"7/11/2015 22:00",213,279,22,15,492,"neutor",NA
"7/11/2015 23:00",155,345,21,15,500,"neutor",NA
"7/12/2015 0:00",98,467,19,19,565,"neutor",NA
"7/12/2015 1:00",59,274,17,7,333,"neutor",NA
"7/12/2015 2:00",41,162,18,7,203,"neutor",NA
"7/12/2015 3:00",16,86,17,6,102,"neutor",NA
"7/12/2015 4:00",10,59,16,6,69,"neutor",NA
"7/12/2015 5:00",12,42,16,7,54,"neutor",NA
"7/12/2015 6:00",14,19,17,7,33,"neutor",NA
"7/12/2015 7:00",25,25,17,11,50,"neutor",NA
"7/12/2015 8:00",67,35,18,9,102,"neutor",NA
"7/12/2015 9:00",154,64,16,13,218,"neutor",NA
"7/12/2015 10:00",169,79,16,13,248,"neutor",NA
"7/12/2015 11:00",125,94,17,13,219,"neutor",NA
"7/12/2015 12:00",146,119,18,15,265,"neutor",NA
"7/12/2015 13:00",185,131,19,20,316,"neutor",NA
"7/12/2015 14:00",232,142,19,19,374,"neutor",NA
"7/12/2015 15:00",196,168,18,19,364,"neutor",NA
"7/12/2015 16:00",177,155,18,19,332,"neutor",NA
"7/12/2015 17:00",195,194,17,17,389,"neutor",NA
"7/12/2015 18:00",183,237,17,17,420,"neutor",NA
"7/12/2015 19:00",214,248,18,11,462,"neutor",NA
"7/12/2015 20:00",119,248,16,7,367,"neutor",NA
"7/12/2015 21:00",91,140,17,7,231,"neutor",NA
"7/12/2015 22:00",52,210,17,11,262,"neutor",NA
"7/12/2015 23:00",33,97,17,9,130,"neutor",NA
"7/13/2015 0:00",28,71,17,13,99,"neutor",NA
"7/13/2015 1:00",19,24,17,15,43,"neutor",NA
"7/13/2015 2:00",3,10,17,15,13,"neutor",NA
"7/13/2015 3:00",3,4,16,17,7,"neutor",NA
"7/13/2015 4:00",11,4,17,15,15,"neutor",NA
"7/13/2015 5:00",30,14,17,13,44,"neutor",NA
"7/13/2015 6:00",115,35,17,13,150,"neutor",NA
"7/13/2015 7:00",240,133,17,15,373,"neutor",NA
"7/13/2015 8:00",450,268,17,15,718,"neutor",NA
"7/13/2015 9:00",418,304,16,15,722,"neutor",NA
"7/13/2015 10:00",358,337,16,13,695,"neutor",NA
"7/13/2015 11:00",264,299,17,13,563,"neutor",NA
"7/13/2015 12:00",296,279,16,4,575,"neutor",NA
"7/13/2015 13:00",323,263,17,13,586,"neutor",NA
"7/13/2015 14:00",297,296,17,15,593,"neutor",NA
"7/13/2015 15:00",332,295,18,19,627,"neutor",NA
"7/13/2015 16:00",381,399,19,20,780,"neutor",NA
"7/13/2015 17:00",399,427,19,15,826,"neutor",NA
"7/13/2015 18:00",316,457,18,20,773,"neutor",NA
"7/13/2015 19:00",288,357,18,13,645,"neutor",NA
"7/13/2015 20:00",177,307,17,11,484,"neutor",NA
"7/13/2015 21:00",127,194,17,9,321,"neutor",NA
"7/13/2015 22:00",58,168,17,7,226,"neutor",NA
"7/13/2015 23:00",57,130,17,7,187,"neutor",NA
"7/14/2015 0:00",32,57,17,11,89,"neutor",NA
"7/14/2015 1:00",19,24,17,17,43,"neutor",NA
"7/14/2015 2:00",7,16,17,13,23,"neutor",NA
"7/14/2015 3:00",8,5,17,17,13,"neutor",NA
"7/14/2015 4:00",14,2,17,13,16,"neutor",NA
"7/14/2015 5:00",37,10,17,15,47,"neutor",NA
"7/14/2015 6:00",89,30,17,15,119,"neutor",NA
"7/14/2015 7:00",346,139,17,17,485,"neutor",NA
"7/14/2015 8:00",454,249,18,15,703,"neutor",NA
"7/14/2015 9:00",402,323,18,20,725,"neutor",NA
"7/14/2015 10:00",339,340,20,13,679,"neutor",NA
"7/14/2015 11:00",377,283,20,22,660,"neutor",NA
"7/14/2015 12:00",351,365,21,26,716,"neutor",NA
"7/14/2015 13:00",454,376,22,22,830,"neutor",NA
"7/14/2015 14:00",474,407,21,20,881,"neutor",NA
"7/14/2015 15:00",379,362,21,22,741,"neutor",NA
"7/14/2015 16:00",392,524,23,24,916,"neutor",NA
"7/14/2015 17:00",500,509,23,22,1009,"neutor",NA
"7/14/2015 18:00",431,545,22,17,976,"neutor",NA
"7/14/2015 19:00",396,422,21,19,818,"neutor",NA
"7/14/2015 20:00",301,363,20,20,664,"neutor",NA
"7/14/2015 21:00",183,246,19,13,429,"neutor",NA
"7/14/2015 22:00",134,252,18,7,386,"neutor",NA
"7/14/2015 23:00",112,205,16,7,317,"neutor",NA
"7/15/2015 0:00",44,133,15,7,177,"neutor",NA
"7/15/2015 1:00",32,76,15,9,108,"neutor",NA
"7/15/2015 2:00",24,31,16,7,55,"neutor",NA
"7/15/2015 3:00",16,10,14,6,26,"neutor",NA
"7/15/2015 4:00",19,8,14,7,27,"neutor",NA
"7/15/2015 5:00",43,14,13,2,57,"neutor",NA
"7/15/2015 6:00",128,33,14,2,161,"neutor",NA
"7/15/2015 7:00",340,152,16,2,492,"neutor",NA
"7/15/2015 8:00",547,329,17,6,876,"neutor",NA
"7/15/2015 9:00",540,304,19,4,844,"neutor",NA
"7/15/2015 10:00",476,395,20,9,871,"neutor",NA
"7/15/2015 11:00",451,361,19,11,812,"neutor",NA
"7/15/2015 12:00",498,427,20,11,925,"neutor",NA
"7/15/2015 13:00",404,383,21,11,787,"neutor",NA
"7/15/2015 14:00",426,458,22,9,884,"neutor",NA
"7/15/2015 15:00",411,426,22,11,837,"neutor",NA
"7/15/2015 16:00",529,555,23,9,1084,"neutor",NA
"7/15/2015 17:00",534,522,23,9,1056,"neutor",NA
"7/15/2015 18:00",403,535,22,13,938,"neutor",NA
"7/15/2015 19:00",486,457,21,13,943,"neutor",NA
"7/15/2015 20:00",312,379,21,13,691,"neutor",NA
"7/15/2015 21:00",205,308,20,9,513,"neutor",NA
"7/15/2015 22:00",217,266,19,7,483,"neutor",NA
"7/15/2015 23:00",178,179,19,7,357,"neutor",NA
"7/16/2015 0:00",123,165,18,6,288,"neutor",NA
"7/16/2015 1:00",58,114,18,9,172,"neutor",NA
"7/16/2015 2:00",23,98,17,7,121,"neutor",NA
"7/16/2015 3:00",21,102,16,9,123,"neutor",NA
"7/16/2015 4:00",20,76,17,6,96,"neutor",NA
"7/16/2015 5:00",50,25,17,7,75,"neutor",NA
"7/16/2015 6:00",95,42,16,13,137,"neutor",NA
"7/16/2015 7:00",290,179,16,9,469,"neutor",NA
"7/16/2015 8:00",476,320,16,7,796,"neutor",NA
"7/16/2015 9:00",458,312,16,6,770,"neutor",NA
"7/16/2015 10:00",453,339,17,4,792,"neutor",NA
"7/16/2015 11:00",427,306,19,4,733,"neutor",NA
"7/16/2015 12:00",438,391,20,7,829,"neutor",NA
"7/16/2015 13:00",476,445,21,7,921,"neutor",NA
"7/16/2015 14:00",490,503,24,7,993,"neutor",NA
"7/16/2015 15:00",512,474,24,6,986,"neutor",NA
"7/16/2015 16:00",532,540,25,9,1072,"neutor",NA
"7/16/2015 17:00",573,488,25,6,1061,"neutor",NA
"7/16/2015 18:00",542,617,24,7,1159,"neutor",NA
"7/16/2015 19:00",479,465,24,7,944,"neutor",NA
"7/16/2015 20:00",393,362,23,4,755,"neutor",NA
"7/16/2015 21:00",271,312,21,4,583,"neutor",NA
"7/16/2015 22:00",245,296,19,4,541,"neutor",NA
"7/16/2015 23:00",109,246,19,7,355,"neutor",NA
"7/17/2015 0:00",72,310,19,6,382,"neutor",NA
"7/17/2015 1:00",53,110,19,7,163,"neutor",NA
"7/17/2015 2:00",17,81,19,4,98,"neutor",NA
"7/17/2015 3:00",5,25,18,4,30,"neutor",NA
"7/17/2015 4:00",14,27,18,7,41,"neutor",NA
"7/17/2015 5:00",41,24,18,2,65,"neutor",NA
"7/17/2015 6:00",102,27,18,6,129,"neutor",NA
"7/17/2015 7:00",225,130,19,15,355,"neutor",NA
"7/17/2015 8:00",424,234,22,17,658,"neutor",NA
"7/17/2015 9:00",402,257,24,15,659,"neutor",NA
"7/17/2015 10:00",381,300,28,26,681,"neutor",NA
"7/17/2015 11:00",430,293,29,32,723,"neutor",NA
"7/17/2015 12:00",461,344,30,32,805,"neutor",NA
"7/17/2015 13:00",355,400,30,33,755,"neutor",NA
"7/17/2015 14:00",461,427,31,26,888,"neutor",NA
"7/17/2015 15:00",481,344,31,28,825,"neutor",NA
"7/17/2015 16:00",449,420,31,30,869,"neutor",NA
"7/17/2015 17:00",446,393,31,30,839,"neutor",NA
"7/17/2015 18:00",422,438,30,19,860,"neutor",NA
"7/17/2015 19:00",589,383,28,17,972,"neutor",NA
"7/17/2015 20:00",524,429,26,15,953,"neutor",NA
"7/17/2015 21:00",382,375,24,9,757,"neutor",NA
"7/17/2015 22:00",313,413,21,4,726,"neutor",NA
"7/17/2015 23:00",309,471,20,2,780,"neutor",NA
"7/18/2015 0:00",245,409,20,0,654,"neutor",NA
"7/18/2015 1:00",263,255,20,6,518,"neutor",NA
"7/18/2015 2:00",109,173,21,9,282,"neutor",NA
"7/18/2015 3:00",91,104,19,15,195,"neutor",NA
"7/18/2015 4:00",41,81,18,11,122,"neutor",NA
"7/18/2015 5:00",51,74,17,7,125,"neutor",NA
"7/18/2015 6:00",38,39,17,13,77,"neutor",NA
"7/18/2015 7:00",72,42,18,15,114,"neutor",NA
"7/18/2015 8:00",189,71,19,20,260,"neutor",NA
"7/18/2015 9:00",341,114,19,13,455,"neutor",NA
"7/18/2015 10:00",506,170,20,13,676,"neutor",NA
"7/18/2015 11:00",510,231,20,15,741,"neutor",NA
"7/18/2015 12:00",612,313,22,19,925,"neutor",NA
"7/18/2015 13:00",501,307,23,22,808,"neutor",NA
"7/18/2015 14:00",367,405,23,22,772,"neutor",NA
"7/18/2015 15:00",350,344,23,24,694,"neutor",NA
"7/18/2015 16:00",304,335,25,24,639,"neutor",NA
"7/18/2015 17:00",324,350,24,22,674,"neutor",NA
"7/18/2015 18:00",337,316,24,17,653,"neutor",NA
"7/18/2015 19:00",353,410,22,17,763,"neutor",NA
"7/18/2015 20:00",375,322,21,9,697,"neutor",NA
"7/18/2015 21:00",250,212,18,11,462,"neutor",NA
"7/18/2015 22:00",118,214,17,11,332,"neutor",NA
"7/18/2015 23:00",126,190,15,6,316,"neutor",NA
"7/19/2015 0:00",119,170,15,2,289,"neutor",NA
"7/19/2015 1:00",122,272,14,2,394,"neutor",NA
"7/19/2015 2:00",50,96,13,0,146,"neutor",NA
"7/19/2015 3:00",44,74,13,4,118,"neutor",NA
"7/19/2015 4:00",6,58,14,2,64,"neutor",NA
"7/19/2015 5:00",10,29,14,0,39,"neutor",NA
"7/19/2015 6:00",12,39,14,4,51,"neutor",NA
"7/19/2015 7:00",13,24,14,0,37,"neutor",NA
"7/19/2015 8:00",36,30,15,6,66,"neutor",NA
"7/19/2015 9:00",163,53,16,7,216,"neutor",NA
"7/19/2015 10:00",200,103,16,4,303,"neutor",NA
"7/19/2015 11:00",139,121,16,6,260,"neutor",NA
"7/19/2015 12:00",152,117,17,6,269,"neutor",NA
"7/19/2015 13:00",182,178,18,9,360,"neutor",NA
"7/19/2015 14:00",181,183,17,7,364,"neutor",NA
"7/19/2015 15:00",185,157,17,9,342,"neutor",NA
"7/19/2015 16:00",166,168,17,11,334,"neutor",NA
"7/19/2015 17:00",184,222,18,19,406,"neutor",NA
"7/19/2015 18:00",225,185,18,20,410,"neutor",NA
"7/19/2015 19:00",166,204,19,20,370,"neutor",NA
"7/19/2015 20:00",137,151,19,19,288,"neutor",NA
"7/19/2015 21:00",78,138,18,17,216,"neutor",NA
"7/19/2015 22:00",33,108,16,7,141,"neutor",NA
"7/19/2015 23:00",21,78,16,9,99,"neutor",NA
"7/20/2015 0:00",27,67,16,17,94,"neutor",NA
"7/20/2015 1:00",18,16,14,6,34,"neutor",NA
"7/20/2015 2:00",11,7,12,4,18,"neutor",NA
"7/20/2015 3:00",7,2,11,4,9,"neutor",NA
"7/20/2015 4:00",10,6,10,4,16,"neutor",NA
"7/20/2015 5:00",45,23,11,2,68,"neutor",NA
"7/20/2015 6:00",106,49,11,2,155,"neutor",NA
"7/20/2015 7:00",295,156,15,6,451,"neutor",NA
"7/20/2015 8:00",507,274,17,9,781,"neutor",NA
"7/20/2015 9:00",351,241,19,7,592,"neutor",NA
"7/20/2015 10:00",319,256,20,11,575,"neutor",NA
"7/20/2015 11:00",395,295,21,9,690,"neutor",NA
"7/20/2015 12:00",361,291,22,13,652,"neutor",NA
"7/20/2015 13:00",429,341,24,13,770,"neutor",NA
"7/20/2015 14:00",343,349,24,15,692,"neutor",NA
"7/20/2015 15:00",348,402,24,17,750,"neutor",NA
"7/20/2015 16:00",412,532,23,17,944,"neutor",NA
"7/20/2015 17:00",409,519,21,13,928,"neutor",NA
"7/20/2015 18:00",369,436,20,6,805,"neutor",NA
"7/20/2015 19:00",357,355,20,7,712,"neutor",NA
"7/20/2015 20:00",234,274,20,4,508,"neutor",NA
"7/20/2015 21:00",107,162,20,6,269,"neutor",NA
"7/20/2015 22:00",62,170,20,6,232,"neutor",NA
"7/20/2015 23:00",47,142,20,4,189,"neutor",NA
"7/21/2015 0:00",34,76,20,4,110,"neutor",NA
"7/21/2015 1:00",30,38,20,13,68,"neutor",NA
"7/21/2015 2:00",5,23,20,11,28,"neutor",NA
"7/21/2015 3:00",5,10,20,11,15,"neutor",NA
"7/21/2015 4:00",16,12,20,9,28,"neutor",NA
"7/21/2015 5:00",43,17,20,11,60,"neutor",NA
"7/21/2015 6:00",112,49,20,13,161,"neutor",NA
"7/21/2015 7:00",224,136,21,19,360,"neutor",NA
"7/21/2015 8:00",438,222,21,20,660,"neutor",NA
"7/21/2015 9:00",352,226,21,26,578,"neutor",NA
"7/21/2015 10:00",327,274,22,30,601,"neutor",NA
"7/21/2015 11:00",299,234,24,26,533,"neutor",NA
"7/21/2015 12:00",405,335,25,33,740,"neutor",NA
"7/21/2015 13:00",387,318,25,30,705,"neutor",NA
"7/21/2015 14:00",365,379,26,22,744,"neutor",NA
"7/21/2015 15:00",337,330,26,24,667,"neutor",NA
"7/21/2015 16:00",428,425,27,26,853,"neutor",NA
"7/21/2015 17:00",452,496,26,22,948,"neutor",NA
"7/21/2015 18:00",469,486,26,15,955,"neutor",NA
"7/21/2015 19:00",434,397,25,26,831,"neutor",NA
"7/21/2015 20:00",291,309,24,9,600,"neutor",NA
"7/21/2015 21:00",199,251,22,6,450,"neutor",NA
"7/21/2015 22:00",142,272,21,4,414,"neutor",NA
"7/21/2015 23:00",77,195,19,4,272,"neutor",NA
"7/22/2015 0:00",49,151,18,0,200,"neutor",NA
"7/22/2015 1:00",28,72,16,0,100,"neutor",NA
"7/22/2015 2:00",10,32,17,7,42,"neutor",NA
"7/22/2015 3:00",21,14,17,2,35,"neutor",NA
"7/22/2015 4:00",15,16,17,4,31,"neutor",NA
"7/22/2015 5:00",50,16,18,4,66,"neutor",NA
"7/22/2015 6:00",123,50,18,2,173,"neutor",NA
"7/22/2015 7:00",294,139,19,7,433,"neutor",NA
"7/22/2015 8:00",493,253,19,15,746,"neutor",NA
"7/22/2015 9:00",394,247,20,17,641,"neutor",NA
"7/22/2015 10:00",390,273,21,20,663,"neutor",NA
"7/22/2015 11:00",362,280,23,19,642,"neutor",NA
"7/22/2015 12:00",473,351,24,20,824,"neutor",NA
"7/22/2015 13:00",460,392,24,24,852,"neutor",NA
"7/22/2015 14:00",378,402,25,22,780,"neutor",NA
"7/22/2015 15:00",364,411,25,20,775,"neutor",NA
"7/22/2015 16:00",436,481,25,20,917,"neutor",NA
"7/22/2015 17:00",463,530,25,22,993,"neutor",NA
"7/22/2015 18:00",484,513,23,20,997,"neutor",NA
"7/22/2015 19:00",464,448,22,15,912,"neutor",NA
"7/22/2015 20:00",332,342,21,13,674,"neutor",NA
"7/22/2015 21:00",201,258,19,6,459,"neutor",NA
"7/22/2015 22:00",210,298,17,4,508,"neutor",NA
"7/22/2015 23:00",114,245,15,4,359,"neutor",NA
"7/23/2015 0:00",123,230,14,0,353,"neutor",NA
"7/23/2015 1:00",79,102,15,4,181,"neutor",NA
"7/23/2015 2:00",28,84,16,2,112,"neutor",NA
"7/23/2015 3:00",25,78,17,7,103,"neutor",NA
"7/23/2015 4:00",22,62,16,7,84,"neutor",NA
"7/23/2015 5:00",48,41,16,11,89,"neutor",NA
"7/23/2015 6:00",126,43,16,13,169,"neutor",NA
"7/23/2015 7:00",251,151,17,17,402,"neutor",NA
"7/23/2015 8:00",452,234,17,19,686,"neutor",NA
"7/23/2015 9:00",342,267,18,20,609,"neutor",NA
"7/23/2015 10:00",313,218,19,17,531,"neutor",NA
"7/23/2015 11:00",365,249,21,22,614,"neutor",NA
"7/23/2015 12:00",393,266,20,17,659,"neutor",NA
"7/23/2015 13:00",454,315,22,19,769,"neutor",NA
"7/23/2015 14:00",384,328,21,19,712,"neutor",NA
"7/23/2015 15:00",322,338,22,19,660,"neutor",NA
"7/23/2015 16:00",398,495,22,17,893,"neutor",NA
"7/23/2015 17:00",494,518,22,13,1012,"neutor",NA
"7/23/2015 18:00",409,537,21,13,946,"neutor",NA
"7/23/2015 19:00",425,425,21,9,850,"neutor",NA
"7/23/2015 20:00",318,308,19,7,626,"neutor",NA
"7/23/2015 21:00",201,303,16,4,504,"neutor",NA
"7/23/2015 22:00",140,243,14,0,383,"neutor",NA
"7/23/2015 23:00",78,221,13,2,299,"neutor",NA
"7/24/2015 0:00",NA,179,12,2,179,"neutor",NA
"7/24/2015 1:00",NA,85,12,4,85,"neutor",NA
"7/24/2015 2:00",NA,41,15,7,41,"neutor",NA
"7/24/2015 3:00",NA,23,15,6,23,"neutor",NA
"7/24/2015 4:00",NA,37,15,6,37,"neutor",NA
"7/24/2015 5:00",NA,43,14,2,43,"neutor",NA
"7/24/2015 6:00",NA,40,16,4,40,"neutor",NA
"7/24/2015 7:00",NA,191,16,6,191,"neutor",NA
"7/24/2015 8:00",NA,197,18,7,197,"neutor",NA
"7/24/2015 9:00",NA,214,20,7,214,"neutor",NA
"7/24/2015 10:00",NA,201,22,7,201,"neutor",NA
"7/24/2015 11:00",NA,278,24,7,278,"neutor",NA
"7/24/2015 12:00",NA,266,24,13,266,"neutor",NA
"7/24/2015 13:00",NA,369,25,11,369,"neutor",NA
"7/24/2015 14:00",NA,389,25,9,389,"neutor",NA
"7/24/2015 15:00",NA,393,26,11,393,"neutor",NA
"7/24/2015 16:00",NA,385,26,7,385,"neutor",NA
"7/24/2015 17:00",NA,377,26,11,377,"neutor",NA
"7/24/2015 18:00",NA,341,26,6,341,"neutor",NA
"7/24/2015 19:00",NA,324,25,6,324,"neutor",NA
"7/24/2015 20:00",NA,236,24,6,236,"neutor",NA
"7/24/2015 21:00",NA,172,23,6,172,"neutor",NA
"7/24/2015 22:00",NA,197,22,4,197,"neutor",NA
"7/24/2015 23:00",NA,188,22,7,188,"neutor",NA
"7/25/2015 0:00",14,94,20,13,108,"neutor",NA
"7/25/2015 1:00",59,153,18,4,212,"neutor",NA
"7/25/2015 2:00",171,97,18,7,268,"neutor",NA
"7/25/2015 3:00",291,70,18,7,361,"neutor",NA
"7/25/2015 4:00",376,52,17,7,428,"neutor",NA
"7/25/2015 5:00",25,29,17,9,54,"neutor",NA
"7/25/2015 6:00",27,18,18,15,45,"neutor",NA
"7/25/2015 7:00",37,18,19,20,55,"neutor",NA
"7/25/2015 8:00",116,43,20,19,159,"neutor",NA
"7/25/2015 9:00",262,79,21,26,341,"neutor",NA
"7/25/2015 10:00",161,95,20,24,256,"neutor",NA
"7/25/2015 11:00",152,131,19,26,283,"neutor",NA
"7/25/2015 12:00",209,143,19,30,352,"neutor",NA
"7/25/2015 13:00",145,136,16,33,281,"neutor",NA
"7/25/2015 14:00",158,173,17,35,331,"neutor",NA
"7/25/2015 15:00",109,113,16,44,222,"neutor",NA
"7/25/2015 16:00",68,139,14,50,207,"neutor",NA
"7/25/2015 17:00",37,104,13,57,141,"neutor",NA
"7/25/2015 18:00",33,94,13,57,127,"neutor",NA
"7/25/2015 19:00",60,120,13,48,180,"neutor",NA
"7/25/2015 20:00",81,82,13,39,163,"neutor",NA
"7/25/2015 21:00",70,59,12,26,129,"neutor",NA
"7/25/2015 22:00",43,49,12,28,92,"neutor",NA
"7/25/2015 23:00",37,27,12,32,64,"neutor",NA
"7/26/2015 0:00",31,38,12,22,69,"neutor",NA
"7/26/2015 1:00",19,53,12,22,72,"neutor",NA
"7/26/2015 2:00",17,36,12,20,53,"neutor",NA
"7/26/2015 3:00",11,20,12,19,31,"neutor",NA
"7/26/2015 4:00",10,23,11,13,33,"neutor",NA
"7/26/2015 5:00",10,20,10,13,30,"neutor",NA
"7/26/2015 6:00",14,10,11,11,24,"neutor",NA
"7/26/2015 7:00",26,12,12,13,38,"neutor",NA
"7/26/2015 8:00",47,22,14,15,69,"neutor",NA
"7/26/2015 9:00",163,71,15,17,234,"neutor",NA
"7/26/2015 10:00",194,110,16,15,304,"neutor",NA
"7/26/2015 11:00",292,131,18,15,423,"neutor",NA
"7/26/2015 12:00",204,243,19,13,447,"neutor",NA
"7/26/2015 13:00",235,220,20,20,455,"neutor",NA
"7/26/2015 14:00",277,277,20,15,554,"neutor",NA
"7/26/2015 15:00",288,240,22,19,528,"neutor",NA
"7/26/2015 16:00",240,245,22,17,485,"neutor",NA
"7/26/2015 17:00",203,307,21,13,510,"neutor",NA
"7/26/2015 18:00",198,234,20,11,432,"neutor",NA
"7/26/2015 19:00",124,225,17,15,349,"neutor",NA
"7/26/2015 20:00",79,105,14,4,184,"neutor",NA
"7/26/2015 21:00",52,95,14,9,147,"neutor",NA
"7/26/2015 22:00",40,99,14,13,139,"neutor",NA
"7/26/2015 23:00",39,54,13,11,93,"neutor",NA
"7/27/2015 0:00",27,50,14,17,77,"neutor",NA
"7/27/2015 1:00",8,20,13,11,28,"neutor",NA
"7/27/2015 2:00",3,3,13,13,6,"neutor",NA
"7/27/2015 3:00",4,2,13,15,6,"neutor",NA
"7/27/2015 4:00",9,7,13,11,16,"neutor",NA
"7/27/2015 5:00",29,22,13,13,51,"neutor",NA
"7/27/2015 6:00",79,40,14,11,119,"neutor",NA
"7/27/2015 7:00",218,130,15,15,348,"neutor",NA
"7/27/2015 8:00",343,214,16,19,557,"neutor",NA
"7/27/2015 9:00",285,168,17,20,453,"neutor",NA
"7/27/2015 10:00",253,190,17,20,443,"neutor",NA
"7/27/2015 11:00",219,199,18,28,418,"neutor",NA
"7/27/2015 12:00",225,189,18,33,414,"neutor",NA
"7/27/2015 13:00",166,188,17,32,354,"neutor",NA
"7/27/2015 14:00",209,178,17,24,387,"neutor",NA
"7/27/2015 15:00",157,222,16,26,379,"neutor",NA
"7/27/2015 16:00",244,285,17,22,529,"neutor",NA
"7/27/2015 17:00",277,328,18,19,605,"neutor",NA
"7/27/2015 18:00",252,321,18,26,573,"neutor",NA
"7/27/2015 19:00",245,242,18,24,487,"neutor",NA
"7/27/2015 20:00",161,198,18,24,359,"neutor",NA
"7/27/2015 21:00",103,124,18,15,227,"neutor",NA
"7/27/2015 22:00",74,130,17,17,204,"neutor",NA
"7/27/2015 23:00",55,116,17,24,171,"neutor",NA
"7/28/2015 0:00",32,58,16,24,90,"neutor",NA
"7/28/2015 1:00",17,49,15,20,66,"neutor",NA
"7/28/2015 2:00",8,28,15,19,36,"neutor",NA
"7/28/2015 3:00",7,15,15,20,22,"neutor",NA
"7/28/2015 4:00",11,5,15,24,16,"neutor",NA
"7/28/2015 5:00",32,16,14,24,48,"neutor",NA
"7/28/2015 6:00",80,51,14,24,131,"neutor",NA
"7/28/2015 7:00",199,143,15,30,342,"neutor",NA
"7/28/2015 8:00",386,205,15,28,591,"neutor",NA
"7/28/2015 9:00",341,146,16,28,487,"neutor",NA
"7/28/2015 10:00",241,150,16,32,391,"neutor",NA
"7/28/2015 11:00",201,206,15,30,407,"neutor",NA
"7/28/2015 12:00",205,204,17,24,409,"neutor",NA
"7/28/2015 13:00",274,223,19,30,497,"neutor",NA
"7/28/2015 14:00",276,250,19,28,526,"neutor",NA
"7/28/2015 15:00",245,267,17,13,512,"neutor",NA
"7/28/2015 16:00",314,378,17,28,692,"neutor",NA
"7/28/2015 17:00",360,437,18,19,797,"neutor",NA
"7/28/2015 18:00",307,345,17,24,652,"neutor",NA
"7/28/2015 19:00",252,294,17,26,546,"neutor",NA
"7/28/2015 20:00",221,204,17,20,425,"neutor",NA
"7/28/2015 21:00",158,166,16,11,324,"neutor",NA
"7/28/2015 22:00",97,188,16,15,285,"neutor",NA
"7/28/2015 23:00",51,118,16,20,169,"neutor",NA
"7/29/2015 0:00",36,93,15,20,129,"neutor",NA
"7/29/2015 1:00",36,52,15,22,88,"neutor",NA
"7/29/2015 2:00",7,24,14,20,31,"neutor",NA
"7/29/2015 3:00",15,9,14,19,24,"neutor",NA
"7/29/2015 4:00",10,9,13,20,19,"neutor",NA
"7/29/2015 5:00",34,16,13,17,50,"neutor",NA
"7/29/2015 6:00",92,45,13,22,137,"neutor",NA
"7/29/2015 7:00",244,149,13,20,393,"neutor",NA
"7/29/2015 8:00",409,215,13,20,624,"neutor",NA
"7/29/2015 9:00",349,180,15,22,529,"neutor",NA
"7/29/2015 10:00",326,207,14,17,533,"neutor",NA
"7/29/2015 11:00",302,197,17,24,499,"neutor",NA
"7/29/2015 12:00",192,261,13,20,453,"neutor",NA
"7/29/2015 13:00",269,214,15,24,483,"neutor",NA
"7/29/2015 14:00",230,297,17,28,527,"neutor",NA
"7/29/2015 15:00",222,263,17,43,485,"neutor",NA
"7/29/2015 16:00",318,352,14,35,670,"neutor",NA
"7/29/2015 17:00",346,326,15,17,672,"neutor",NA
"7/29/2015 18:00",265,370,15,28,635,"neutor",NA
"7/29/2015 19:00",283,293,14,20,576,"neutor",NA
"7/29/2015 20:00",225,231,15,32,456,"neutor",NA
"7/29/2015 21:00",154,144,14,20,298,"neutor",NA
"7/29/2015 22:00",138,173,14,24,311,"neutor",NA
"7/29/2015 23:00",88,129,13,24,217,"neutor",NA
"7/30/2015 0:00",61,94,13,22,155,"neutor",NA
"7/30/2015 1:00",50,91,12,20,141,"neutor",NA
"7/30/2015 2:00",42,39,12,20,81,"neutor",NA
"7/30/2015 3:00",16,50,12,22,66,"neutor",NA
"7/30/2015 4:00",19,59,12,17,78,"neutor",NA
"7/30/2015 5:00",36,30,12,17,66,"neutor",NA
"7/30/2015 6:00",103,42,12,17,145,"neutor",NA
"7/30/2015 7:00",241,150,13,22,391,"neutor",NA
"7/30/2015 8:00",344,203,14,22,547,"neutor",NA
"7/30/2015 9:00",378,226,15,22,604,"neutor",NA
"7/30/2015 10:00",258,173,17,28,431,"neutor",NA
"7/30/2015 11:00",263,200,13,22,463,"neutor",NA
"7/30/2015 12:00",224,215,18,24,439,"neutor",NA
"7/30/2015 13:00",269,235,17,15,504,"neutor",NA
"7/30/2015 14:00",279,300,19,26,579,"neutor",NA
"7/30/2015 15:00",270,274,18,30,544,"neutor",NA
"7/30/2015 16:00",334,335,18,22,669,"neutor",NA
"7/30/2015 17:00",381,424,19,26,805,"neutor",NA
"7/30/2015 18:00",349,389,17,19,738,"neutor",NA
"7/30/2015 19:00",290,287,17,20,577,"neutor",NA
"7/30/2015 20:00",215,246,15,15,461,"neutor",NA
"7/30/2015 21:00",147,180,13,9,327,"neutor",NA
"7/30/2015 22:00",70,129,12,9,199,"neutor",NA
"7/30/2015 23:00",81,131,10,7,212,"neutor",NA
"7/31/2015 0:00",30,103,9,7,133,"neutor",NA
"7/31/2015 1:00",31,62,9,7,93,"neutor",NA
"7/31/2015 2:00",6,32,9,7,38,"neutor",NA
"7/31/2015 3:00",5,17,8,7,22,"neutor",NA
"7/31/2015 4:00",12,10,8,6,22,"neutor",NA
"7/31/2015 5:00",28,17,7,0,45,"neutor",NA
"7/31/2015 6:00",108,45,8,0,153,"neutor",NA
"7/31/2015 7:00",245,128,10,6,373,"neutor",NA
"7/31/2015 8:00",326,219,13,7,545,"neutor",NA
"7/31/2015 9:00",363,179,14,13,542,"neutor",NA
"7/31/2015 10:00",306,197,15,9,503,"neutor",NA
"7/31/2015 11:00",350,207,15,11,557,"neutor",NA
"7/31/2015 12:00",327,259,17,7,586,"neutor",NA
"7/31/2015 13:00",304,278,17,7,582,"neutor",NA
"7/31/2015 14:00",280,308,19,4,588,"neutor",NA
"7/31/2015 15:00",334,326,19,9,660,"neutor",NA
"7/31/2015 16:00",330,317,18,6,647,"neutor",NA
"7/31/2015 17:00",342,354,18,9,696,"neutor",NA
"7/31/2015 18:00",266,401,18,7,667,"neutor",NA
"7/31/2015 19:00",295,292,17,7,587,"neutor",NA
"7/31/2015 20:00",233,249,15,6,482,"neutor",NA
"7/31/2015 21:00",195,173,13,4,368,"neutor",NA
"7/31/2015 22:00",129,212,12,4,341,"neutor",NA
"7/31/2015 23:00",126,129,10,2,255,"neutor",NA
"8/1/2015 0:00",81,132,10,4,213,"neutor",NA
"8/1/2015 1:00",52,118,10,7,170,"neutor",NA
"8/1/2015 2:00",39,70,11,6,109,"neutor",NA
"8/1/2015 3:00",16,57,10,6,73,"neutor",NA
"8/1/2015 4:00",13,58,10,6,71,"neutor",NA
"8/1/2015 5:00",19,36,10,6,55,"neutor",NA
"8/1/2015 6:00",42,28,9,6,70,"neutor",NA
"8/1/2015 7:00",56,27,13,6,83,"neutor",NA
"8/1/2015 8:00",114,76,15,7,190,"neutor",NA
"8/1/2015 9:00",248,99,17,9,347,"neutor",NA
"8/1/2015 10:00",371,164,19,9,535,"neutor",NA
"8/1/2015 11:00",361,174,20,6,535,"neutor",NA
"8/1/2015 12:00",377,225,22,6,602,"neutor",NA
"8/1/2015 13:00",310,311,22,7,621,"neutor",NA
"8/1/2015 14:00",310,288,24,6,598,"neutor",NA
"8/1/2015 15:00",333,340,24,7,673,"neutor",NA
"8/1/2015 16:00",306,257,23,7,563,"neutor",NA
"8/1/2015 17:00",256,325,23,13,581,"neutor",NA
"8/1/2015 18:00",261,314,23,13,575,"neutor",NA
"8/1/2015 19:00",334,325,22,13,659,"neutor",NA
"8/1/2015 20:00",309,220,19,9,529,"neutor",NA
"8/1/2015 21:00",152,157,17,9,309,"neutor",NA
"8/1/2015 22:00",102,178,15,6,280,"neutor",NA
"8/1/2015 23:00",85,177,14,4,262,"neutor",NA
"8/2/2015 0:00",91,235,12,2,326,"neutor",NA
"8/2/2015 1:00",63,120,11,6,183,"neutor",NA
"8/2/2015 2:00",31,73,11,2,104,"neutor",NA
"8/2/2015 3:00",18,79,10,4,97,"neutor",NA
"8/2/2015 4:00",12,52,9,4,64,"neutor",NA
"8/2/2015 5:00",10,26,9,0,36,"neutor",NA
"8/2/2015 6:00",14,19,9,2,33,"neutor",NA
"8/2/2015 7:00",32,14,13,2,46,"neutor",NA
"8/2/2015 8:00",33,46,16,2,79,"neutor",NA
"8/2/2015 9:00",116,66,19,4,182,"neutor",NA
"8/2/2015 10:00",181,137,21,4,318,"neutor",NA
"8/2/2015 11:00",214,144,21,7,358,"neutor",NA
"8/2/2015 12:00",279,186,23,6,465,"neutor",NA
"8/2/2015 13:00",278,198,23,6,476,"neutor",NA
"8/2/2015 14:00",340,210,23,7,550,"neutor",NA
"8/2/2015 15:00",312,299,24,9,611,"neutor",NA
"8/2/2015 16:00",311,224,25,4,535,"neutor",NA
"8/2/2015 17:00",253,302,25,11,555,"neutor",NA
"8/2/2015 18:00",246,276,25,6,522,"neutor",NA
"8/2/2015 19:00",306,260,23,9,566,"neutor",NA
"8/2/2015 20:00",252,216,21,6,468,"neutor",NA
"8/2/2015 21:00",106,179,19,6,285,"neutor",NA
"8/2/2015 22:00",62,155,19,7,217,"neutor",NA
"8/2/2015 23:00",83,247,16,4,330,"neutor",NA
"8/3/2015 0:00",30,55,17,6,85,"neutor",NA
"8/3/2015 1:00",11,14,16,4,25,"neutor",NA
"8/3/2015 2:00",4,9,16,4,13,"neutor",NA
"8/3/2015 3:00",3,6,15,4,9,"neutor",NA
"8/3/2015 4:00",11,6,15,4,17,"neutor",NA
"8/3/2015 5:00",34,16,16,7,50,"neutor",NA
"8/3/2015 6:00",108,59,17,7,167,"neutor",NA
"8/3/2015 7:00",282,178,18,9,460,"neutor",NA
"8/3/2015 8:00",447,239,20,9,686,"neutor",NA
"8/3/2015 9:00",292,206,23,13,498,"neutor",NA
"8/3/2015 10:00",296,282,26,13,578,"neutor",NA
"8/3/2015 11:00",377,270,28,13,647,"neutor",NA
"8/3/2015 12:00",362,301,30,11,663,"neutor",NA
"8/3/2015 13:00",315,301,31,22,616,"neutor",NA
"8/3/2015 14:00",320,285,32,19,605,"neutor",NA
"8/3/2015 15:00",371,344,31,19,715,"neutor",NA
"8/3/2015 16:00",348,409,32,19,757,"neutor",NA
"8/3/2015 17:00",451,482,32,17,933,"neutor",NA
"8/3/2015 18:00",420,324,31,17,744,"neutor",NA
"8/3/2015 19:00",483,336,29,7,819,"neutor",NA
"8/3/2015 20:00",340,245,28,6,585,"neutor",NA
"8/3/2015 21:00",155,243,23,4,398,"neutor",NA
"8/3/2015 22:00",89,238,21,4,327,"neutor",NA
"8/3/2015 23:00",63,204,20,4,267,"neutor",NA
"8/4/2015 0:00",63,281,22,6,344,"neutor",NA
"8/4/2015 1:00",19,62,19,2,81,"neutor",NA
"8/4/2015 2:00",9,45,17,4,54,"neutor",NA
"8/4/2015 3:00",5,5,19,4,10,"neutor",NA
"8/4/2015 4:00",8,8,20,7,16,"neutor",NA
"8/4/2015 5:00",38,25,20,11,63,"neutor",NA
"8/4/2015 6:00",110,70,20,7,180,"neutor",NA
"8/4/2015 7:00",282,176,21,7,458,"neutor",NA
"8/4/2015 8:00",355,192,21,7,547,"neutor",NA
"8/4/2015 9:00",348,177,24,7,525,"neutor",NA
"8/4/2015 10:00",303,192,26,4,495,"neutor",NA
"8/4/2015 11:00",289,221,26,15,510,"neutor",NA
"8/4/2015 12:00",192,215,23,24,407,"neutor",NA
"8/4/2015 13:00",139,185,19,7,324,"neutor",NA
"8/4/2015 14:00",165,195,19,7,360,"neutor",NA
"8/4/2015 15:00",207,193,19,7,400,"neutor",NA
"8/4/2015 16:00",244,298,20,11,542,"neutor",NA
"8/4/2015 17:00",271,340,17,26,611,"neutor",NA
"8/4/2015 18:00",244,313,17,11,557,"neutor",NA
"8/4/2015 19:00",240,246,17,9,486,"neutor",NA
"8/4/2015 20:00",200,167,17,9,367,"neutor",NA
"8/4/2015 21:00",100,152,16,9,252,"neutor",NA
"8/4/2015 22:00",80,129,16,11,209,"neutor",NA
"8/4/2015 23:00",32,81,15,9,113,"neutor",NA
"8/5/2015 0:00",29,84,14,6,113,"neutor",NA
"8/5/2015 1:00",6,60,13,6,66,"neutor",NA
"8/5/2015 2:00",5,17,12,6,22,"neutor",NA
"8/5/2015 3:00",5,11,13,7,16,"neutor",NA
"8/5/2015 4:00",8,6,12,6,14,"neutor",NA
"8/5/2015 5:00",41,21,12,7,62,"neutor",NA
"8/5/2015 6:00",121,55,12,7,176,"neutor",NA
"8/5/2015 7:00",311,176,14,7,487,"neutor",NA
"8/5/2015 8:00",435,230,16,7,665,"neutor",NA
"8/5/2015 9:00",433,263,18,9,696,"neutor",NA
"8/5/2015 10:00",377,285,20,9,662,"neutor",NA
"8/5/2015 11:00",337,269,21,13,606,"neutor",NA
"8/5/2015 12:00",409,347,23,13,756,"neutor",NA
"8/5/2015 13:00",330,324,23,15,654,"neutor",NA
"8/5/2015 14:00",362,381,24,11,743,"neutor",NA
"8/5/2015 15:00",359,366,24,13,725,"neutor",NA
"8/5/2015 16:00",402,481,25,11,883,"neutor",NA
"8/5/2015 17:00",555,498,25,6,1053,"neutor",NA
"8/5/2015 18:00",422,522,25,7,944,"neutor",NA
"8/5/2015 19:00",389,394,23,6,783,"neutor",NA
"8/5/2015 20:00",265,286,22,6,551,"neutor",NA
"8/5/2015 21:00",142,255,21,6,397,"neutor",NA
"8/5/2015 22:00",133,227,19,6,360,"neutor",NA
"8/5/2015 23:00",75,163,19,6,238,"neutor",NA
"8/6/2015 0:00",81,92,18,6,173,"neutor",NA
"8/6/2015 1:00",31,82,18,6,113,"neutor",NA
"8/6/2015 2:00",19,53,17,6,72,"neutor",NA
"8/6/2015 3:00",4,75,18,7,79,"neutor",NA
"8/6/2015 4:00",10,33,17,7,43,"neutor",NA
"8/6/2015 5:00",36,24,17,7,60,"neutor",NA
"8/6/2015 6:00",130,55,17,6,185,"neutor",NA
"8/6/2015 7:00",267,183,18,7,450,"neutor",NA
"8/6/2015 8:00",497,265,21,7,762,"neutor",NA
"8/6/2015 9:00",347,224,23,9,571,"neutor",NA
"8/6/2015 10:00",297,232,26,6,529,"neutor",NA
"8/6/2015 11:00",330,239,28,7,569,"neutor",NA
"8/6/2015 12:00",313,304,30,15,617,"neutor",NA
"8/6/2015 13:00",359,339,32,15,698,"neutor",NA
"8/6/2015 14:00",354,364,32,13,718,"neutor",NA
"8/6/2015 15:00",363,340,32,15,703,"neutor",NA
"8/6/2015 16:00",427,424,32,20,851,"neutor",NA
"8/6/2015 17:00",433,462,32,20,895,"neutor",NA
"8/6/2015 18:00",422,400,32,22,822,"neutor",NA
"8/6/2015 19:00",339,324,30,11,663,"neutor",NA
"8/6/2015 20:00",262,272,26,15,534,"neutor",NA
"8/6/2015 21:00",160,266,23,15,426,"neutor",NA
"8/6/2015 22:00",130,238,21,7,368,"neutor",NA
"8/6/2015 23:00",85,198,21,6,283,"neutor",NA
"8/7/2015 0:00",60,113,19,6,173,"neutor",NA
"8/7/2015 1:00",19,83,19,7,102,"neutor",NA
"8/7/2015 2:00",11,43,18,7,54,"neutor",NA
"8/7/2015 3:00",11,39,18,7,50,"neutor",NA
"8/7/2015 4:00",10,35,18,6,45,"neutor",NA
"8/7/2015 5:00",33,16,17,7,49,"neutor",NA
"8/7/2015 6:00",88,44,17,9,132,"neutor",NA
"8/7/2015 7:00",149,96,17,6,245,"neutor",NA
"8/7/2015 8:00",229,119,17,7,348,"neutor",NA
"8/7/2015 9:00",161,91,17,9,252,"neutor",NA
"8/7/2015 10:00",179,142,18,4,321,"neutor",NA
"8/7/2015 11:00",199,186,19,6,385,"neutor",NA
"8/7/2015 12:00",256,233,22,7,489,"neutor",NA
"8/7/2015 13:00",287,232,24,6,519,"neutor",NA
"8/7/2015 14:00",298,266,25,4,564,"neutor",NA
"8/7/2015 15:00",303,231,26,6,534,"neutor",NA
"8/7/2015 16:00",301,252,26,13,553,"neutor",NA
"8/7/2015 17:00",274,310,27,15,584,"neutor",NA
"8/7/2015 18:00",312,291,27,13,603,"neutor",NA
"8/7/2015 19:00",335,264,26,11,599,"neutor",NA
"8/7/2015 20:00",260,233,24,7,493,"neutor",NA
"8/7/2015 21:00",185,173,22,6,358,"neutor",NA
"8/7/2015 22:00",124,200,21,2,324,"neutor",NA
"8/7/2015 23:00",104,160,21,7,264,"neutor",NA
"8/8/2015 0:00",82,135,22,11,217,"neutor",NA
"8/8/2015 1:00",52,115,21,9,167,"neutor",NA
"8/8/2015 2:00",35,110,20,11,145,"neutor",NA
"8/8/2015 3:00",19,64,20,7,83,"neutor",NA
"8/8/2015 4:00",6,43,19,20,49,"neutor",NA
"8/8/2015 5:00",11,27,17,7,38,"neutor",NA
"8/8/2015 6:00",28,14,17,7,42,"neutor",NA
"8/8/2015 7:00",60,24,17,9,84,"neutor",NA
"8/8/2015 8:00",101,73,18,11,174,"neutor",NA
"8/8/2015 9:00",230,94,19,9,324,"neutor",NA
"8/8/2015 10:00",309,148,20,13,457,"neutor",NA
"8/8/2015 11:00",353,192,19,19,545,"neutor",NA
"8/8/2015 12:00",329,181,19,15,510,"neutor",NA
"8/8/2015 13:00",256,278,19,17,534,"neutor",NA
"8/8/2015 14:00",263,305,20,15,568,"neutor",NA
"8/8/2015 15:00",247,260,21,9,507,"neutor",NA
"8/8/2015 16:00",233,299,22,9,532,"neutor",NA
"8/8/2015 17:00",217,263,23,11,480,"neutor",NA
"8/8/2015 18:00",228,238,23,13,466,"neutor",NA
"8/8/2015 19:00",257,238,21,6,495,"neutor",NA
"8/8/2015 20:00",192,171,20,15,363,"neutor",NA
"8/8/2015 21:00",165,151,18,7,316,"neutor",NA
"8/8/2015 22:00",117,173,16,6,290,"neutor",NA
"8/8/2015 23:00",80,144,15,6,224,"neutor",NA
"8/9/2015 0:00",89,129,14,6,218,"neutor",NA
"8/9/2015 1:00",59,99,13,4,158,"neutor",NA
"8/9/2015 2:00",38,93,12,7,131,"neutor",NA
"8/9/2015 3:00",26,77,12,2,103,"neutor",NA
"8/9/2015 4:00",7,39,11,4,46,"neutor",NA
"8/9/2015 5:00",6,36,11,4,42,"neutor",NA
"8/9/2015 6:00",13,27,11,2,40,"neutor",NA
"8/9/2015 7:00",22,19,14,4,41,"neutor",NA
"8/9/2015 8:00",44,29,16,4,73,"neutor",NA
"8/9/2015 9:00",106,85,18,6,191,"neutor",NA
"8/9/2015 10:00",174,114,20,6,288,"neutor",NA
"8/9/2015 11:00",189,124,21,6,313,"neutor",NA
"8/9/2015 12:00",170,184,22,7,354,"neutor",NA
"8/9/2015 13:00",198,211,24,11,409,"neutor",NA
"8/9/2015 14:00",258,191,23,7,449,"neutor",NA
"8/9/2015 15:00",210,234,24,9,444,"neutor",NA
"8/9/2015 16:00",235,256,24,9,491,"neutor",NA
"8/9/2015 17:00",220,239,25,6,459,"neutor",NA
"8/9/2015 18:00",225,212,25,7,437,"neutor",NA
"8/9/2015 19:00",190,207,23,9,397,"neutor",NA
"8/9/2015 20:00",116,180,22,6,296,"neutor",NA
"8/9/2015 21:00",101,129,20,2,230,"neutor",NA
"8/9/2015 22:00",63,129,19,2,192,"neutor",NA
"8/9/2015 23:00",37,90,19,2,127,"neutor",NA
"8/10/2015 0:00",25,63,19,6,88,"neutor",NA
"8/10/2015 1:00",8,36,19,6,44,"neutor",NA
"8/10/2015 2:00",5,3,18,4,8,"neutor",NA
"8/10/2015 3:00",3,7,17,4,10,"neutor",NA
"8/10/2015 4:00",10,7,17,2,17,"neutor",NA
"8/10/2015 5:00",35,19,16,2,54,"neutor",NA
"8/10/2015 6:00",102,55,17,6,157,"neutor",NA
"8/10/2015 7:00",279,175,18,4,454,"neutor",NA
"8/10/2015 8:00",404,272,19,4,676,"neutor",NA
"8/10/2015 9:00",280,150,20,6,430,"neutor",NA
"8/10/2015 10:00",204,171,20,6,375,"neutor",NA
"8/10/2015 11:00",199,198,19,9,397,"neutor",NA
"8/10/2015 12:00",287,227,21,11,514,"neutor",NA
"8/10/2015 13:00",274,228,23,11,502,"neutor",NA
"8/10/2015 14:00",311,312,24,7,623,"neutor",NA
"8/10/2015 15:00",351,331,23,15,682,"neutor",NA
"8/10/2015 16:00",358,371,22,13,729,"neutor",NA
"8/10/2015 17:00",332,451,20,9,783,"neutor",NA
"8/10/2015 18:00",283,382,19,11,665,"neutor",NA
"8/10/2015 19:00",211,263,18,9,474,"neutor",NA
"8/10/2015 20:00",165,217,18,9,382,"neutor",NA
"8/10/2015 21:00",106,132,17,7,238,"neutor",NA
"8/10/2015 22:00",42,121,17,6,163,"neutor",NA
"8/10/2015 23:00",23,91,17,4,114,"neutor",NA
"8/11/2015 0:00",17,49,16,9,66,"neutor",NA
"8/11/2015 1:00",11,26,16,2,37,"neutor",NA
"8/11/2015 2:00",8,10,16,9,18,"neutor",NA
"8/11/2015 3:00",3,3,15,11,6,"neutor",NA
"8/11/2015 4:00",7,6,14,4,13,"neutor",NA
"8/11/2015 5:00",33,14,13,4,47,"neutor",NA
"8/11/2015 6:00",126,55,13,0,181,"neutor",NA
"8/11/2015 7:00",297,214,15,2,511,"neutor",NA
"8/11/2015 8:00",429,246,16,4,675,"neutor",NA
"8/11/2015 9:00",362,210,18,4,572,"neutor",NA
"8/11/2015 10:00",322,215,20,4,537,"neutor",NA
"8/11/2015 11:00",332,265,21,6,597,"neutor",NA
"8/11/2015 12:00",311,304,23,6,615,"neutor",NA
"8/11/2015 13:00",330,340,23,6,670,"neutor",NA
"8/11/2015 14:00",384,325,23,9,709,"neutor",NA
"8/11/2015 15:00",390,402,25,7,792,"neutor",NA
"8/11/2015 16:00",433,448,25,9,881,"neutor",NA
"8/11/2015 17:00",460,532,24,11,992,"neutor",NA
"8/11/2015 18:00",409,502,25,9,911,"neutor",NA
"8/11/2015 19:00",364,376,23,4,740,"neutor",NA
"8/11/2015 20:00",267,280,21,4,547,"neutor",NA
"8/11/2015 21:00",145,254,20,7,399,"neutor",NA
"8/11/2015 22:00",106,203,20,9,309,"neutor",NA
"8/11/2015 23:00",56,133,19,11,189,"neutor",NA
"8/12/2015 0:00",36,71,19,6,107,"neutor",NA
"8/12/2015 1:00",16,41,18,9,57,"neutor",NA
"8/12/2015 2:00",5,11,18,9,16,"neutor",NA
"8/12/2015 3:00",2,12,18,6,14,"neutor",NA
"8/12/2015 4:00",11,6,17,9,17,"neutor",NA
"8/12/2015 5:00",44,27,17,9,71,"neutor",NA
"8/12/2015 6:00",142,69,17,13,211,"neutor",NA
"8/12/2015 7:00",454,247,18,13,701,"neutor",NA
"8/12/2015 8:00",454,270,18,13,724,"neutor",NA
"8/12/2015 9:00",401,227,19,13,628,"neutor",NA
"8/12/2015 10:00",335,213,20,9,548,"neutor",NA
"8/12/2015 11:00",373,293,21,15,666,"neutor",NA
"8/12/2015 12:00",367,339,22,13,706,"neutor",NA
"8/12/2015 13:00",358,410,22,11,768,"neutor",NA
"8/12/2015 14:00",326,376,23,13,702,"neutor",NA
"8/12/2015 15:00",333,370,23,15,703,"neutor",NA
"8/12/2015 16:00",438,468,23,19,906,"neutor",NA
"8/12/2015 17:00",457,496,23,11,953,"neutor",NA
"8/12/2015 18:00",435,465,23,15,900,"neutor",NA
"8/12/2015 19:00",330,415,22,13,745,"neutor",NA
"8/12/2015 20:00",227,306,21,11,533,"neutor",NA
"8/12/2015 21:00",190,223,19,7,413,"neutor",NA
"8/12/2015 22:00",151,200,18,6,351,"neutor",NA
"8/12/2015 23:00",94,146,18,11,240,"neutor",NA
"8/13/2015 0:00",108,103,18,7,211,"neutor",NA
"8/13/2015 1:00",12,94,17,9,106,"neutor",NA
"8/13/2015 2:00",20,61,17,9,81,"neutor",NA
"8/13/2015 3:00",13,23,16,7,36,"neutor",NA
"8/13/2015 4:00",10,24,17,9,34,"neutor",NA
"8/13/2015 5:00",33,35,17,9,68,"neutor",NA
"8/13/2015 6:00",144,55,17,9,199,"neutor",NA
"8/13/2015 7:00",485,250,18,9,735,"neutor",NA
"8/13/2015 8:00",420,262,19,11,682,"neutor",NA
"8/13/2015 9:00",326,213,21,17,539,"neutor",NA
"8/13/2015 10:00",298,241,23,13,539,"neutor",NA
"8/13/2015 11:00",310,238,24,13,548,"neutor",NA
"8/13/2015 12:00",307,274,25,17,581,"neutor",NA
"8/13/2015 13:00",348,342,26,11,690,"neutor",NA
"8/13/2015 14:00",385,377,27,13,762,"neutor",NA
"8/13/2015 15:00",372,411,27,13,783,"neutor",NA
"8/13/2015 16:00",466,430,28,13,896,"neutor",NA
"8/13/2015 17:00",458,462,28,13,920,"neutor",NA
"8/13/2015 18:00",463,466,28,15,929,"neutor",NA
"8/13/2015 19:00",345,378,27,11,723,"neutor",NA
"8/13/2015 20:00",302,270,25,9,572,"neutor",NA
"8/13/2015 21:00",168,241,24,9,409,"neutor",NA
"8/13/2015 22:00",113,263,24,9,376,"neutor",NA
"8/13/2015 23:00",72,153,23,6,225,"neutor",NA
"8/14/2015 0:00",50,118,22,7,168,"neutor",NA
"8/14/2015 1:00",16,52,23,9,68,"neutor",NA
"8/14/2015 2:00",0,20,21,7,20,"neutor",NA
"8/14/2015 3:00",6,15,20,4,21,"neutor",NA
"8/14/2015 4:00",11,8,20,4,19,"neutor",NA
"8/14/2015 5:00",39,27,19,9,66,"neutor",NA
"8/14/2015 6:00",113,56,19,2,169,"neutor",NA
"8/14/2015 7:00",473,235,20,2,708,"neutor",NA
"8/14/2015 8:00",371,230,21,6,601,"neutor",NA
"8/14/2015 9:00",347,178,22,11,525,"neutor",NA
"8/14/2015 10:00",244,183,23,19,427,"neutor",NA
"8/14/2015 11:00",270,222,24,19,492,"neutor",NA
"8/14/2015 12:00",291,300,25,17,591,"neutor",NA
"8/14/2015 13:00",348,408,26,22,756,"neutor",NA
"8/14/2015 14:00",331,344,26,20,675,"neutor",NA
"8/14/2015 15:00",346,369,25,11,715,"neutor",NA
"8/14/2015 16:00",333,389,25,9,722,"neutor",NA
"8/14/2015 17:00",327,346,26,6,673,"neutor",NA
"8/14/2015 18:00",357,357,25,4,714,"neutor",NA
"8/14/2015 19:00",342,281,24,6,623,"neutor",NA
"8/14/2015 20:00",286,246,23,4,532,"neutor",NA
"8/14/2015 21:00",106,129,22,15,235,"neutor",NA
"8/14/2015 22:00",82,170,20,6,252,"neutor",NA
"8/14/2015 23:00",111,166,20,4,277,"neutor",NA
"8/15/2015 0:00",91,146,20,2,237,"neutor",NA
"8/15/2015 1:00",58,152,20,2,210,"neutor",NA
"8/15/2015 2:00",33,83,19,2,116,"neutor",NA
"8/15/2015 3:00",10,55,19,4,65,"neutor",NA
"8/15/2015 4:00",6,35,19,4,41,"neutor",NA
"8/15/2015 5:00",24,44,19,6,68,"neutor",NA
"8/15/2015 6:00",44,25,19,6,69,"neutor",NA
"8/15/2015 7:00",111,21,19,6,132,"neutor",NA
"8/15/2015 8:00",156,61,20,9,217,"neutor",NA
"8/15/2015 9:00",299,128,21,9,427,"neutor",NA
"8/15/2015 10:00",448,194,23,15,642,"neutor",NA
"8/15/2015 11:00",434,256,24,11,690,"neutor",NA
"8/15/2015 12:00",558,307,24,13,865,"neutor",NA
"8/15/2015 13:00",469,384,24,11,853,"neutor",NA
"8/15/2015 14:00",310,349,24,13,659,"neutor",NA
"8/15/2015 15:00",274,326,25,7,600,"neutor",NA
"8/15/2015 16:00",207,340,25,13,547,"neutor",NA
"8/15/2015 17:00",234,318,25,9,552,"neutor",NA
"8/15/2015 18:00",222,297,25,15,519,"neutor",NA
"8/15/2015 19:00",230,226,22,19,456,"neutor",NA
"8/15/2015 20:00",152,167,21,13,319,"neutor",NA
"8/15/2015 21:00",84,114,19,6,198,"neutor",NA
"8/15/2015 22:00",89,144,18,9,233,"neutor",NA
"8/15/2015 23:00",80,141,18,17,221,"neutor",NA
"8/16/2015 0:00",82,103,18,13,185,"neutor",NA
"8/16/2015 1:00",56,81,18,13,137,"neutor",NA
"8/16/2015 2:00",20,77,17,9,97,"neutor",NA
"8/16/2015 3:00",24,61,17,9,85,"neutor",NA
"8/16/2015 4:00",11,39,17,9,50,"neutor",NA
"8/16/2015 5:00",1,22,17,13,23,"neutor",NA
"8/16/2015 6:00",6,15,16,15,21,"neutor",NA
"8/16/2015 7:00",15,19,16,13,34,"neutor",NA
"8/16/2015 8:00",28,23,16,9,51,"neutor",NA
"8/16/2015 9:00",82,36,17,11,118,"neutor",NA
"8/16/2015 10:00",95,90,17,11,185,"neutor",NA
"8/16/2015 11:00",90,36,17,9,126,"neutor",NA
"8/16/2015 12:00",58,67,18,11,125,"neutor",NA
"8/16/2015 13:00",57,64,18,15,121,"neutor",NA
"8/16/2015 14:00",90,94,18,15,184,"neutor",NA
"8/16/2015 15:00",69,68,17,17,137,"neutor",NA
"8/16/2015 16:00",77,62,17,15,139,"neutor",NA
"8/16/2015 17:00",61,69,17,15,130,"neutor",NA
"8/16/2015 18:00",40,65,16,15,105,"neutor",NA
"8/16/2015 19:00",46,75,16,13,121,"neutor",NA
"8/16/2015 20:00",36,52,16,11,88,"neutor",NA
"8/16/2015 21:00",24,32,16,13,56,"neutor",NA
"8/16/2015 22:00",25,53,16,13,78,"neutor",NA
"8/16/2015 23:00",12,25,16,11,37,"neutor",NA
"8/17/2015 0:00",8,18,16,13,26,"neutor",NA
"8/17/2015 1:00",1,10,15,13,11,"neutor",NA
"8/17/2015 2:00",0,4,15,13,4,"neutor",NA
"8/17/2015 3:00",4,2,15,17,6,"neutor",NA
"8/17/2015 4:00",10,1,15,15,11,"neutor",NA
"8/17/2015 5:00",27,13,14,17,40,"neutor",NA
"8/17/2015 6:00",68,28,14,13,96,"neutor",NA
"8/17/2015 7:00",357,156,14,13,513,"neutor",NA
"8/17/2015 8:00",229,150,14,13,379,"neutor",NA
"8/17/2015 9:00",190,94,14,11,284,"neutor",NA
"8/17/2015 10:00",89,86,15,13,175,"neutor",NA
"8/17/2015 11:00",83,107,15,15,190,"neutor",NA
"8/17/2015 12:00",164,122,15,13,286,"neutor",NA
"8/17/2015 13:00",158,173,16,15,331,"neutor",NA
"8/17/2015 14:00",147,170,16,13,317,"neutor",NA
"8/17/2015 15:00",176,201,15,11,377,"neutor",NA
"8/17/2015 16:00",167,215,15,13,382,"neutor",NA
"8/17/2015 17:00",200,262,15,7,462,"neutor",NA
"8/17/2015 18:00",140,239,15,11,379,"neutor",NA
"8/17/2015 19:00",132,135,15,7,267,"neutor",NA
"8/17/2015 20:00",82,117,15,7,199,"neutor",NA
"8/17/2015 21:00",46,74,15,9,120,"neutor",NA
"8/17/2015 22:00",45,62,15,7,107,"neutor",NA
"8/17/2015 23:00",14,35,15,9,49,"neutor",NA
"8/18/2015 0:00",12,15,15,9,27,"neutor",NA
"8/18/2015 1:00",8,12,15,9,20,"neutor",NA
"8/18/2015 2:00",2,3,15,9,5,"neutor",NA
"8/18/2015 3:00",3,1,15,13,4,"neutor",NA
"8/18/2015 4:00",7,5,15,13,12,"neutor",NA
"8/18/2015 5:00",28,7,14,13,35,"neutor",NA
"8/18/2015 6:00",85,41,14,15,126,"neutor",NA
"8/18/2015 7:00",443,172,14,15,615,"neutor",NA
"8/18/2015 8:00",349,233,14,15,582,"neutor",NA
"8/18/2015 9:00",308,163,14,17,471,"neutor",NA
"8/18/2015 10:00",251,157,14,17,408,"neutor",NA
"8/18/2015 11:00",254,206,14,15,460,"neutor",NA
"8/18/2015 12:00",285,257,14,17,542,"neutor",NA
"8/18/2015 13:00",267,255,15,15,522,"neutor",NA
"8/18/2015 14:00",304,289,16,17,593,"neutor",NA
"8/18/2015 15:00",261,322,15,13,583,"neutor",NA
"8/18/2015 16:00",327,389,15,13,716,"neutor",NA
"8/18/2015 17:00",361,443,16,11,804,"neutor",NA
"8/18/2015 18:00",324,389,16,9,713,"neutor",NA
"8/18/2015 19:00",306,338,16,6,644,"neutor",NA
"8/18/2015 20:00",249,267,14,4,516,"neutor",NA
"8/18/2015 21:00",115,174,13,0,289,"neutor",NA
"8/18/2015 22:00",117,182,13,6,299,"neutor",NA
"8/18/2015 23:00",57,117,13,4,174,"neutor",NA
"8/19/2015 0:00",34,66,13,6,100,"neutor",NA
"8/19/2015 1:00",11,32,12,0,43,"neutor",NA
"8/19/2015 2:00",6,12,13,6,18,"neutor",NA
"8/19/2015 3:00",4,9,13,4,13,"neutor",NA
"8/19/2015 4:00",6,8,11,4,14,"neutor",NA
"8/19/2015 5:00",42,14,11,4,56,"neutor",NA
"8/19/2015 6:00",129,44,10,4,173,"neutor",NA
"8/19/2015 7:00",577,237,12,6,814,"neutor",NA
"8/19/2015 8:00",465,284,14,7,749,"neutor",NA
"8/19/2015 9:00",403,244,16,9,647,"neutor",NA
"8/19/2015 10:00",350,203,17,9,553,"neutor",NA
"8/19/2015 11:00",320,229,18,7,549,"neutor",NA
"8/19/2015 12:00",330,264,19,11,594,"neutor",NA
"8/19/2015 13:00",324,375,19,7,699,"neutor",NA
"8/19/2015 14:00",324,365,20,9,689,"neutor",NA
"8/19/2015 15:00",346,399,20,4,745,"neutor",NA
"8/19/2015 16:00",457,449,20,2,906,"neutor",NA
"8/19/2015 17:00",479,540,20,4,1019,"neutor",NA
"8/19/2015 18:00",382,469,20,6,851,"neutor",NA
"8/19/2015 19:00",393,464,18,4,857,"neutor",NA
"8/19/2015 20:00",273,291,16,2,564,"neutor",NA
"8/19/2015 21:00",166,214,15,2,380,"neutor",NA
"8/19/2015 22:00",163,196,14,2,359,"neutor",NA
"8/19/2015 23:00",105,143,13,2,248,"neutor",NA
"8/20/2015 0:00",39,107,12,2,146,"neutor",NA
"8/20/2015 1:00",41,66,12,4,107,"neutor",NA
"8/20/2015 2:00",16,54,12,2,70,"neutor",NA
"8/20/2015 3:00",12,63,12,2,75,"neutor",NA
"8/20/2015 4:00",13,36,12,2,49,"neutor",NA
"8/20/2015 5:00",30,31,13,4,61,"neutor",NA
"8/20/2015 6:00",119,55,13,0,174,"neutor",NA
"8/20/2015 7:00",505,253,14,4,758,"neutor",NA
"8/20/2015 8:00",456,263,16,4,719,"neutor",NA
"8/20/2015 9:00",349,213,17,4,562,"neutor",NA
"8/20/2015 10:00",285,195,20,4,480,"neutor",NA
"8/20/2015 11:00",267,258,21,6,525,"neutor",NA
"8/20/2015 12:00",355,283,22,9,638,"neutor",NA
"8/20/2015 13:00",313,347,22,7,660,"neutor",NA
"8/20/2015 14:00",362,380,22,6,742,"neutor",NA
"8/20/2015 15:00",405,394,23,7,799,"neutor",NA
"8/20/2015 16:00",422,435,24,6,857,"neutor",NA
"8/20/2015 17:00",484,548,23,7,1032,"neutor",NA
"8/20/2015 18:00",452,497,23,6,949,"neutor",NA
"8/20/2015 19:00",372,365,21,4,737,"neutor",NA
"8/20/2015 20:00",252,285,18,0,537,"neutor",NA
"8/20/2015 21:00",150,242,16,0,392,"neutor",NA
"8/20/2015 22:00",129,224,15,4,353,"neutor",NA
"8/20/2015 23:00",53,155,14,4,208,"neutor",NA
"8/21/2015 0:00",32,88,15,4,120,"neutor",NA
"8/21/2015 1:00",18,33,14,2,51,"neutor",NA
"8/21/2015 2:00",11,15,14,4,26,"neutor",NA
"8/21/2015 3:00",6,15,14,2,21,"neutor",NA
"8/21/2015 4:00",15,14,14,4,29,"neutor",NA
"8/21/2015 5:00",40,18,14,6,58,"neutor",NA
"8/21/2015 6:00",131,53,14,6,184,"neutor",NA
"8/21/2015 7:00",492,240,15,4,732,"neutor",NA
"8/21/2015 8:00",387,221,17,6,608,"neutor",NA
"8/21/2015 9:00",366,211,19,6,577,"neutor",NA
"8/21/2015 10:00",293,218,21,6,511,"neutor",NA
"8/21/2015 11:00",306,240,22,7,546,"neutor",NA
"8/21/2015 12:00",364,281,24,11,645,"neutor",NA
"8/21/2015 13:00",354,419,24,7,773,"neutor",NA
"8/21/2015 14:00",417,448,25,7,865,"neutor",NA
"8/21/2015 15:00",418,399,25,4,817,"neutor",NA
"8/21/2015 16:00",406,369,25,2,775,"neutor",NA
"8/21/2015 17:00",365,428,25,6,793,"neutor",NA
"8/21/2015 18:00",389,414,25,4,803,"neutor",NA
"8/21/2015 19:00",342,344,23,4,686,"neutor",NA
"8/21/2015 20:00",269,257,21,6,526,"neutor",NA
"8/21/2015 21:00",197,195,18,6,392,"neutor",NA
"8/21/2015 22:00",128,261,17,6,389,"neutor",NA
"8/21/2015 23:00",95,184,17,4,279,"neutor",NA
"8/22/2015 0:00",85,133,17,4,218,"neutor",NA
"8/22/2015 1:00",75,130,16,6,205,"neutor",NA
"8/22/2015 2:00",63,87,16,7,150,"neutor",NA
"8/22/2015 3:00",25,68,16,6,93,"neutor",NA
"8/22/2015 4:00",25,50,15,6,75,"neutor",NA
"8/22/2015 5:00",20,24,14,4,44,"neutor",NA
"8/22/2015 6:00",27,21,12,2,48,"neutor",NA
"8/22/2015 7:00",66,28,17,4,94,"neutor",NA
"8/22/2015 8:00",132,60,19,6,192,"neutor",NA
"8/22/2015 9:00",273,112,21,7,385,"neutor",NA
"8/22/2015 10:00",321,180,23,11,501,"neutor",NA
"8/22/2015 11:00",361,254,24,11,615,"neutor",NA
"8/22/2015 12:00",399,292,25,11,691,"neutor",NA
"8/22/2015 13:00",356,270,25,13,626,"neutor",NA
"8/22/2015 14:00",293,295,25,11,588,"neutor",NA
"8/22/2015 15:00",292,320,25,9,612,"neutor",NA
"8/22/2015 16:00",259,306,25,11,565,"neutor",NA
"8/22/2015 17:00",229,334,25,7,563,"neutor",NA
"8/22/2015 18:00",230,345,25,6,575,"neutor",NA
"8/22/2015 19:00",269,297,23,6,566,"neutor",NA
"8/22/2015 20:00",191,214,20,4,405,"neutor",NA
"8/22/2015 21:00",166,154,19,7,320,"neutor",NA
"8/22/2015 22:00",130,183,20,9,313,"neutor",NA
"8/22/2015 23:00",86,174,19,6,260,"neutor",NA
"8/23/2015 0:00",129,112,18,6,241,"neutor",NA
"8/23/2015 1:00",81,114,18,6,195,"neutor",NA
"8/23/2015 2:00",47,91,18,7,138,"neutor",NA
"8/23/2015 3:00",26,82,18,7,108,"neutor",NA
"8/23/2015 4:00",10,48,17,7,58,"neutor",NA
"8/23/2015 5:00",15,31,17,7,46,"neutor",NA
"8/23/2015 6:00",12,22,17,7,34,"neutor",NA
"8/23/2015 7:00",24,20,17,9,44,"neutor",NA
"8/23/2015 8:00",50,34,19,11,84,"neutor",NA
"8/23/2015 9:00",107,89,20,9,196,"neutor",NA
"8/23/2015 10:00",157,161,22,13,318,"neutor",NA
"8/23/2015 11:00",142,156,23,20,298,"neutor",NA
"8/23/2015 12:00",203,191,24,19,394,"neutor",NA
"8/23/2015 13:00",208,210,24,17,418,"neutor",NA
"8/23/2015 14:00",266,217,25,19,483,"neutor",NA
"8/23/2015 15:00",282,243,25,19,525,"neutor",NA
"8/23/2015 16:00",277,240,25,19,517,"neutor",NA
"8/23/2015 17:00",283,248,24,19,531,"neutor",NA
"8/23/2015 18:00",248,260,23,13,508,"neutor",NA
"8/23/2015 19:00",158,226,22,9,384,"neutor",NA
"8/23/2015 20:00",105,203,21,9,308,"neutor",NA
"8/23/2015 21:00",71,135,21,11,206,"neutor",NA
"8/23/2015 22:00",67,106,21,11,173,"neutor",NA
"8/23/2015 23:00",36,54,20,13,90,"neutor",NA
"8/24/2015 0:00",14,34,19,6,48,"neutor",NA
"8/24/2015 1:00",9,17,17,9,26,"neutor",NA
"8/24/2015 2:00",9,5,16,4,14,"neutor",NA
"8/24/2015 3:00",2,3,15,4,5,"neutor",NA
"8/24/2015 4:00",7,4,15,4,11,"neutor",NA
"8/24/2015 5:00",26,11,15,6,37,"neutor",NA
"8/24/2015 6:00",115,46,15,4,161,"neutor",NA
"8/24/2015 7:00",428,212,16,4,640,"neutor",NA
"8/24/2015 8:00",391,235,16,7,626,"neutor",NA
"8/24/2015 9:00",310,220,17,9,530,"neutor",NA
"8/24/2015 10:00",274,179,19,15,453,"neutor",NA
"8/24/2015 11:00",249,217,21,13,466,"neutor",NA
"8/24/2015 12:00",306,243,22,19,549,"neutor",NA
"8/24/2015 13:00",298,322,23,17,620,"neutor",NA
"8/24/2015 14:00",283,295,23,11,578,"neutor",NA
"8/24/2015 15:00",276,366,24,28,642,"neutor",NA
"8/24/2015 16:00",361,402,23,28,763,"neutor",NA
"8/24/2015 17:00",405,496,23,20,901,"neutor",NA
"8/24/2015 18:00",317,498,24,24,815,"neutor",NA
"8/24/2015 19:00",305,337,22,24,642,"neutor",NA
"8/24/2015 20:00",212,217,21,19,429,"neutor",NA
"8/24/2015 21:00",135,151,21,26,286,"neutor",NA
"8/24/2015 22:00",73,165,20,30,238,"neutor",NA
"8/24/2015 23:00",37,84,19,24,121,"neutor",NA
"8/25/2015 0:00",24,55,19,22,79,"neutor",NA
"8/25/2015 1:00",12,16,18,13,28,"neutor",NA
"8/25/2015 2:00",3,9,17,20,12,"neutor",NA
"8/25/2015 3:00",6,4,16,17,10,"neutor",NA
"8/25/2015 4:00",9,5,17,26,14,"neutor",NA
"8/25/2015 5:00",31,13,14,19,44,"neutor",NA
"8/25/2015 6:00",95,41,14,17,136,"neutor",NA
"8/25/2015 7:00",303,144,14,19,447,"neutor",NA
"8/25/2015 8:00",327,173,16,22,500,"neutor",NA
"8/25/2015 9:00",319,190,17,20,509,"neutor",NA
"8/25/2015 10:00",241,174,17,30,415,"neutor",NA
"8/25/2015 11:00",187,217,18,30,404,"neutor",NA
"8/25/2015 12:00",190,233,19,24,423,"neutor",NA
"8/25/2015 13:00",206,225,17,30,431,"neutor",NA
"8/25/2015 14:00",261,259,17,15,520,"neutor",NA
"8/25/2015 15:00",284,313,19,22,597,"neutor",NA
"8/25/2015 16:00",352,349,19,28,701,"neutor",NA
"8/25/2015 17:00",389,448,19,20,837,"neutor",NA
"8/25/2015 18:00",346,436,19,13,782,"neutor",NA
"8/25/2015 19:00",277,312,18,9,589,"neutor",NA
"8/25/2015 20:00",170,242,15,4,412,"neutor",NA
"8/25/2015 21:00",94,181,15,9,275,"neutor",NA
"8/25/2015 22:00",95,144,14,11,239,"neutor",NA
"8/25/2015 23:00",27,101,14,11,128,"neutor",NA
"8/26/2015 0:00",23,55,15,13,78,"neutor",NA
"8/26/2015 1:00",7,26,14,9,33,"neutor",NA
"8/26/2015 2:00",11,10,15,7,21,"neutor",NA
"8/26/2015 3:00",3,6,17,13,9,"neutor",NA
"8/26/2015 4:00",12,5,17,13,17,"neutor",NA
"8/26/2015 5:00",32,16,17,11,48,"neutor",NA
"8/26/2015 6:00",112,62,17,9,174,"neutor",NA
"8/26/2015 7:00",505,241,17,9,746,"neutor",NA
"8/26/2015 8:00",490,291,18,13,781,"neutor",NA
"8/26/2015 9:00",376,204,19,19,580,"neutor",NA
"8/26/2015 10:00",337,224,21,28,561,"neutor",NA
"8/26/2015 11:00",307,268,22,24,575,"neutor",NA
"8/26/2015 12:00",368,331,23,24,699,"neutor",NA
"8/26/2015 13:00",362,380,24,24,742,"neutor",NA
"8/26/2015 14:00",297,394,25,24,691,"neutor",NA
"8/26/2015 15:00",384,399,26,24,783,"neutor",NA
"8/26/2015 16:00",509,475,26,13,984,"neutor",NA
"8/26/2015 17:00",517,504,26,19,1021,"neutor",NA
"8/26/2015 18:00",504,559,25,9,1063,"neutor",NA
"8/26/2015 19:00",388,417,24,13,805,"neutor",NA
"8/26/2015 20:00",273,305,23,15,578,"neutor",NA
"8/26/2015 21:00",156,311,23,15,467,"neutor",NA
"8/26/2015 22:00",167,244,23,19,411,"neutor",NA
"8/26/2015 23:00",104,168,22,13,272,"neutor",NA
"8/27/2015 0:00",60,86,21,7,146,"neutor",NA
"8/27/2015 1:00",32,72,19,2,104,"neutor",NA
"8/27/2015 2:00",9,71,20,7,80,"neutor",NA
"8/27/2015 3:00",11,63,20,7,74,"neutor",NA
"8/27/2015 4:00",14,43,21,11,57,"neutor",NA
"8/27/2015 5:00",36,28,19,13,64,"neutor",NA
"8/27/2015 6:00",97,58,19,15,155,"neutor",NA
"8/27/2015 7:00",393,223,19,15,616,"neutor",NA
"8/27/2015 8:00",398,212,19,17,610,"neutor",NA
"8/27/2015 9:00",290,158,19,17,448,"neutor",NA
"8/27/2015 10:00",256,141,19,17,397,"neutor",NA
"8/27/2015 11:00",273,208,20,20,481,"neutor",NA
"8/27/2015 12:00",284,239,19,19,523,"neutor",NA
"8/27/2015 13:00",251,258,18,17,509,"neutor",NA
"8/27/2015 14:00",207,246,17,17,453,"neutor",NA
"8/27/2015 15:00",204,275,16,17,479,"neutor",NA
"8/27/2015 16:00",263,277,15,17,540,"neutor",NA
"8/27/2015 17:00",301,368,15,13,669,"neutor",NA
"8/27/2015 18:00",280,326,15,11,606,"neutor",NA
"8/27/2015 19:00",227,256,14,9,483,"neutor",NA
"8/27/2015 20:00",148,196,14,9,344,"neutor",NA
"8/27/2015 21:00",91,127,14,9,218,"neutor",NA
"8/27/2015 22:00",74,109,14,9,183,"neutor",NA
"8/27/2015 23:00",31,72,14,9,103,"neutor",NA
"8/28/2015 0:00",25,49,13,9,74,"neutor",NA
"8/28/2015 1:00",8,35,13,9,43,"neutor",NA
"8/28/2015 2:00",5,14,13,6,19,"neutor",NA
"8/28/2015 3:00",5,13,13,9,18,"neutor",NA
"8/28/2015 4:00",12,15,13,9,27,"neutor",NA
"8/28/2015 5:00",36,16,13,15,52,"neutor",NA
"8/28/2015 6:00",90,45,13,9,135,"neutor",NA
"8/28/2015 7:00",419,186,14,9,605,"neutor",NA
"8/28/2015 8:00",371,201,14,11,572,"neutor",NA
"8/28/2015 9:00",303,138,15,7,441,"neutor",NA
"8/28/2015 10:00",289,203,16,15,492,"neutor",NA
"8/28/2015 11:00",280,218,17,17,498,"neutor",NA
"8/28/2015 12:00",329,286,19,13,615,"neutor",NA
"8/28/2015 13:00",319,361,20,15,680,"neutor",NA
"8/28/2015 14:00",373,373,19,11,746,"neutor",NA
"8/28/2015 15:00",408,359,21,15,767,"neutor",NA
"8/28/2015 16:00",390,360,21,13,750,"neutor",NA
"8/28/2015 17:00",401,408,21,15,809,"neutor",NA
"8/28/2015 18:00",417,419,21,15,836,"neutor",NA
"8/28/2015 19:00",325,344,19,9,669,"neutor",NA
"8/28/2015 20:00",284,268,16,4,552,"neutor",NA
"8/28/2015 21:00",169,261,14,2,430,"neutor",NA
"8/28/2015 22:00",117,176,13,6,293,"neutor",NA
"8/28/2015 23:00",80,175,12,2,255,"neutor",NA
"8/29/2015 0:00",77,153,12,2,230,"neutor",NA
"8/29/2015 1:00",65,104,11,2,169,"neutor",NA
"8/29/2015 2:00",35,89,11,0,124,"neutor",NA
"8/29/2015 3:00",20,63,10,2,83,"neutor",NA
"8/29/2015 4:00",19,33,10,6,52,"neutor",NA
"8/29/2015 5:00",19,35,11,6,54,"neutor",NA
"8/29/2015 6:00",44,39,10,4,83,"neutor",NA
"8/29/2015 7:00",67,39,12,4,106,"neutor",NA
"8/29/2015 8:00",125,49,14,6,174,"neutor",NA
"8/29/2015 9:00",296,78,16,7,374,"neutor",NA
"8/29/2015 10:00",332,155,19,6,487,"neutor",NA
"8/29/2015 11:00",441,243,20,6,684,"neutor",NA
"8/29/2015 12:00",429,239,21,9,668,"neutor",NA
"8/29/2015 13:00",360,288,22,7,648,"neutor",NA
"8/29/2015 14:00",381,353,23,4,734,"neutor",NA
"8/29/2015 15:00",352,337,23,7,689,"neutor",NA
"8/29/2015 16:00",337,345,24,4,682,"neutor",NA
"8/29/2015 17:00",369,378,24,6,747,"neutor",NA
"8/29/2015 18:00",337,338,23,4,675,"neutor",NA
"8/29/2015 19:00",300,309,21,4,609,"neutor",NA
"8/29/2015 20:00",245,244,19,6,489,"neutor",NA
"8/29/2015 21:00",220,146,18,6,366,"neutor",NA
"8/29/2015 22:00",146,215,17,6,361,"neutor",NA
"8/29/2015 23:00",104,228,16,2,332,"neutor",NA
"8/30/2015 0:00",80,148,16,4,228,"neutor",NA
"8/30/2015 1:00",95,102,15,2,197,"neutor",NA
"8/30/2015 2:00",35,100,16,4,135,"neutor",NA
"8/30/2015 3:00",24,102,16,4,126,"neutor",NA
"8/30/2015 4:00",10,59,17,7,69,"neutor",NA
"8/30/2015 5:00",19,26,18,17,45,"neutor",NA
"8/30/2015 6:00",24,23,17,6,47,"neutor",NA
"8/30/2015 7:00",37,15,17,2,52,"neutor",NA
"8/30/2015 8:00",50,39,18,4,89,"neutor",NA
"8/30/2015 9:00",129,79,20,4,208,"neutor",NA
"8/30/2015 10:00",157,90,20,9,247,"neutor",NA
"8/30/2015 11:00",187,132,22,7,319,"neutor",NA
"8/30/2015 12:00",232,157,24,9,389,"neutor",NA
"8/30/2015 13:00",306,185,26,6,491,"neutor",NA
"8/30/2015 14:00",355,241,27,4,596,"neutor",NA
"8/30/2015 15:00",327,212,28,6,539,"neutor",NA
"8/30/2015 16:00",275,223,27,13,498,"neutor",NA
"8/30/2015 17:00",270,343,27,9,613,"neutor",NA
"8/30/2015 18:00",214,206,26,11,420,"neutor",NA
"8/30/2015 19:00",181,219,25,7,400,"neutor",NA
"8/30/2015 20:00",120,173,23,9,293,"neutor",NA
"8/30/2015 21:00",82,159,22,4,241,"neutor",NA
"8/30/2015 22:00",75,146,21,2,221,"neutor",NA
"8/30/2015 23:00",24,84,21,2,108,"neutor",NA
"8/31/2015 0:00",23,47,21,4,70,"neutor",NA
"8/31/2015 1:00",10,19,20,15,29,"neutor",NA
"8/31/2015 2:00",7,5,19,7,12,"neutor",NA
"8/31/2015 3:00",4,9,19,6,13,"neutor",NA
"8/31/2015 4:00",9,8,20,13,17,"neutor",NA
"8/31/2015 5:00",40,20,19,6,60,"neutor",NA
"8/31/2015 6:00",104,48,19,4,152,"neutor",NA
"8/31/2015 7:00",451,239,20,7,690,"neutor",NA
"8/31/2015 8:00",432,262,21,13,694,"neutor",NA
"8/31/2015 9:00",366,191,22,15,557,"neutor",NA
"8/31/2015 10:00",291,227,25,7,518,"neutor",NA
"8/31/2015 11:00",279,272,26,11,551,"neutor",NA
"8/31/2015 12:00",352,333,28,9,685,"neutor",NA
"8/31/2015 13:00",292,332,29,7,624,"neutor",NA
"8/31/2015 14:00",389,349,30,11,738,"neutor",NA
"8/31/2015 15:00",368,376,31,15,744,"neutor",NA
"8/31/2015 16:00",461,465,31,15,926,"neutor",NA
"8/31/2015 17:00",452,480,30,15,932,"neutor",NA
"8/31/2015 18:00",426,490,29,9,916,"neutor",NA
"8/31/2015 19:00",364,312,27,24,676,"neutor",NA
"8/31/2015 20:00",233,312,25,19,545,"neutor",NA
"8/31/2015 21:00",144,215,23,24,359,"neutor",NA
"8/31/2015 22:00",82,169,22,15,251,"neutor",NA
"8/31/2015 23:00",40,100,21,19,140,"neutor",NA
"9/1/2015 0:00",28,72,21,20,100,"neutor",NA
"9/1/2015 1:00",12,36,20,13,48,"neutor",NA
"9/1/2015 2:00",5,10,20,19,15,"neutor",NA
"9/1/2015 3:00",6,1,20,24,7,"neutor",NA
"9/1/2015 4:00",10,3,19,20,13,"neutor",NA
"9/1/2015 5:00",34,22,19,15,56,"neutor",NA
"9/1/2015 6:00",121,55,18,15,176,"neutor",NA
"9/1/2015 7:00",469,233,17,17,702,"neutor",NA
"9/1/2015 8:00",454,267,17,11,721,"neutor",NA
"9/1/2015 9:00",291,208,17,9,499,"neutor",NA
"9/1/2015 10:00",214,188,16,11,402,"neutor",NA
"9/1/2015 11:00",125,136,16,11,261,"neutor",NA
"9/1/2015 12:00",198,204,16,9,402,"neutor",NA
"9/1/2015 13:00",205,184,16,13,389,"neutor",NA
"9/1/2015 14:00",221,193,16,13,414,"neutor",NA
"9/1/2015 15:00",234,275,16,13,509,"neutor",NA
"9/1/2015 16:00",358,286,17,11,644,"neutor",NA
"9/1/2015 17:00",410,441,17,15,851,"neutor",NA
"9/1/2015 18:00",342,393,17,9,735,"neutor",NA
"9/1/2015 19:00",317,305,16,15,622,"neutor",NA
"9/1/2015 20:00",245,253,14,7,498,"neutor",NA
"9/1/2015 21:00",118,187,13,9,305,"neutor",NA
"9/1/2015 22:00",123,207,13,9,330,"neutor",NA
"9/1/2015 23:00",34,91,12,9,125,"neutor",NA
"9/2/2015 0:00",36,72,12,13,108,"neutor",NA
"9/2/2015 1:00",9,34,12,11,43,"neutor",NA
"9/2/2015 2:00",3,19,11,9,22,"neutor",NA
"9/2/2015 3:00",5,5,12,11,10,"neutor",NA
"9/2/2015 4:00",10,8,11,7,18,"neutor",NA
"9/2/2015 5:00",30,13,11,9,43,"neutor",NA
"9/2/2015 6:00",130,54,10,9,184,"neutor",NA
"9/2/2015 7:00",512,224,11,9,736,"neutor",NA
"9/2/2015 8:00",515,266,13,13,781,"neutor",NA
"9/2/2015 9:00",441,248,15,13,689,"neutor",NA
"9/2/2015 10:00",382,216,16,17,598,"neutor",NA
"9/2/2015 11:00",332,276,17,19,608,"neutor",NA
"9/2/2015 12:00",339,314,18,19,653,"neutor",NA
"9/2/2015 13:00",350,381,18,15,731,"neutor",NA
"9/2/2015 14:00",313,366,17,13,679,"neutor",NA
"9/2/2015 15:00",334,375,17,17,709,"neutor",NA
"9/2/2015 16:00",373,437,18,13,810,"neutor",NA
"9/2/2015 17:00",453,490,18,15,943,"neutor",NA
"9/2/2015 18:00",432,451,17,13,883,"neutor",NA
"9/2/2015 19:00",364,389,15,4,753,"neutor",NA
"9/2/2015 20:00",240,283,13,2,523,"neutor",NA
"9/2/2015 21:00",153,206,12,6,359,"neutor",NA
"9/2/2015 22:00",129,208,13,6,337,"neutor",NA
"9/2/2015 23:00",99,152,12,2,251,"neutor",NA
"9/3/2015 0:00",69,81,11,2,150,"neutor",NA
"9/3/2015 1:00",29,60,11,2,89,"neutor",NA
"9/3/2015 2:00",10,61,12,0,71,"neutor",NA
"9/3/2015 3:00",8,34,12,2,42,"neutor",NA
"9/3/2015 4:00",10,20,12,2,30,"neutor",NA
"9/3/2015 5:00",36,33,12,4,69,"neutor",NA
"9/3/2015 6:00",128,39,11,7,167,"neutor",NA
"9/3/2015 7:00",459,236,11,6,695,"neutor",NA
"9/3/2015 8:00",475,276,13,6,751,"neutor",NA
"9/3/2015 9:00",371,224,14,9,595,"neutor",NA
"9/3/2015 10:00",283,192,15,11,475,"neutor",NA
"9/3/2015 11:00",254,213,16,11,467,"neutor",NA
"9/3/2015 12:00",279,277,16,13,556,"neutor",NA
"9/3/2015 13:00",293,310,17,15,603,"neutor",NA
"9/3/2015 14:00",365,354,17,11,719,"neutor",NA
"9/3/2015 15:00",321,366,17,19,687,"neutor",NA
"9/3/2015 16:00",404,463,17,15,867,"neutor",NA
"9/3/2015 17:00",427,514,16,19,941,"neutor",NA
"9/3/2015 18:00",363,458,15,11,821,"neutor",NA
"9/3/2015 19:00",329,373,15,9,702,"neutor",NA
"9/3/2015 20:00",208,236,14,9,444,"neutor",NA
"9/3/2015 21:00",146,219,13,9,365,"neutor",NA
"9/3/2015 22:00",85,213,13,9,298,"neutor",NA
"9/3/2015 23:00",50,92,13,9,142,"neutor",NA
"9/4/2015 0:00",28,73,13,11,101,"neutor",NA
"9/4/2015 1:00",26,36,12,9,62,"neutor",NA
"9/4/2015 2:00",10,18,12,9,28,"neutor",NA
"9/4/2015 3:00",5,21,11,11,26,"neutor",NA
"9/4/2015 4:00",10,11,11,11,21,"neutor",NA
"9/4/2015 5:00",31,20,11,11,51,"neutor",NA
"9/4/2015 6:00",130,54,11,11,184,"neutor",NA
"9/4/2015 7:00",476,198,11,15,674,"neutor",NA
"9/4/2015 8:00",429,229,12,17,658,"neutor",NA
"9/4/2015 9:00",363,175,13,15,538,"neutor",NA
"9/4/2015 10:00",264,168,15,22,432,"neutor",NA
"9/4/2015 11:00",277,184,16,24,461,"neutor",NA
"9/4/2015 12:00",277,274,16,26,551,"neutor",NA
"9/4/2015 13:00",329,338,16,28,667,"neutor",NA
"9/4/2015 14:00",309,344,17,26,653,"neutor",NA
"9/4/2015 15:00",345,331,17,26,676,"neutor",NA
"9/4/2015 16:00",290,347,17,30,637,"neutor",NA
"9/4/2015 17:00",328,351,16,26,679,"neutor",NA
"9/4/2015 18:00",246,330,15,26,576,"neutor",NA
"9/4/2015 19:00",281,296,15,24,577,"neutor",NA
"9/4/2015 20:00",208,189,14,26,397,"neutor",NA
"9/4/2015 21:00",114,156,13,24,270,"neutor",NA
"9/4/2015 22:00",79,136,13,26,215,"neutor",NA
"9/4/2015 23:00",93,132,13,20,225,"neutor",NA
"9/5/2015 0:00",54,109,13,22,163,"neutor",NA
"9/5/2015 1:00",71,89,13,17,160,"neutor",NA
"9/5/2015 2:00",29,66,13,13,95,"neutor",NA
"9/5/2015 3:00",9,39,12,15,48,"neutor",NA
"9/5/2015 4:00",7,26,12,13,33,"neutor",NA
"9/5/2015 5:00",12,41,13,19,53,"neutor",NA
"9/5/2015 6:00",21,24,13,13,45,"neutor",NA
"9/5/2015 7:00",60,25,13,15,85,"neutor",NA
"9/5/2015 8:00",106,55,13,24,161,"neutor",NA
"9/5/2015 9:00",202,84,14,28,286,"neutor",NA
"9/5/2015 10:00",209,129,13,24,338,"neutor",NA
"9/5/2015 11:00",165,107,15,22,272,"neutor",NA
"9/5/2015 12:00",153,111,14,24,264,"neutor",NA
"9/5/2015 13:00",210,130,16,28,340,"neutor",NA
"9/5/2015 14:00",193,145,15,22,338,"neutor",NA
"9/5/2015 15:00",179,185,15,22,364,"neutor",NA
"9/5/2015 16:00",215,171,15,22,386,"neutor",NA
"9/5/2015 17:00",158,216,15,19,374,"neutor",NA
"9/5/2015 18:00",195,220,14,19,415,"neutor",NA
"9/5/2015 19:00",215,182,13,13,397,"neutor",NA
"9/5/2015 20:00",219,149,12,15,368,"neutor",NA
"9/5/2015 21:00",174,96,11,20,270,"neutor",NA
"9/5/2015 22:00",134,130,11,15,264,"neutor",NA
"9/5/2015 23:00",85,160,10,19,245,"neutor",NA
"9/6/2015 0:00",61,129,10,19,190,"neutor",NA
"9/6/2015 1:00",52,98,10,20,150,"neutor",NA
"9/6/2015 2:00",27,102,10,20,129,"neutor",NA
"9/6/2015 3:00",13,67,10,19,80,"neutor",NA
"9/6/2015 4:00",9,49,10,20,58,"neutor",NA
"9/6/2015 5:00",11,36,10,19,47,"neutor",NA
"9/6/2015 6:00",41,25,10,22,66,"neutor",NA
"9/6/2015 7:00",49,29,11,22,78,"neutor",NA
"9/6/2015 8:00",337,51,12,24,388,"neutor",NA
"9/6/2015 9:00",244,263,13,24,507,"neutor",NA
"9/6/2015 10:00",276,268,14,22,544,"neutor",NA
"9/6/2015 11:00",316,143,15,22,459,"neutor",NA
"9/6/2015 12:00",445,126,16,22,571,"neutor",NA
"9/6/2015 13:00",249,235,16,24,484,"neutor",NA
"9/6/2015 14:00",216,333,16,24,549,"neutor",NA
"9/6/2015 15:00",194,209,15,22,403,"neutor",NA
"9/6/2015 16:00",196,178,13,28,374,"neutor",NA
"9/6/2015 17:00",186,210,15,24,396,"neutor",NA
"9/6/2015 18:00",171,179,14,19,350,"neutor",NA
"9/6/2015 19:00",152,200,14,13,352,"neutor",NA
"9/6/2015 20:00",97,114,13,15,211,"neutor",NA
"9/6/2015 21:00",61,107,13,17,168,"neutor",NA
"9/6/2015 22:00",59,96,12,17,155,"neutor",NA
"9/6/2015 23:00",42,55,12,19,97,"neutor",NA
"9/7/2015 0:00",10,27,12,19,37,"neutor",NA
"9/7/2015 1:00",15,13,12,22,28,"neutor",NA
"9/7/2015 2:00",3,4,12,20,7,"neutor",NA
"9/7/2015 3:00",3,0,12,20,3,"neutor",NA
"9/7/2015 4:00",10,5,12,17,15,"neutor",NA
"9/7/2015 5:00",35,9,12,13,44,"neutor",NA
"9/7/2015 6:00",119,40,13,13,159,"neutor",NA
"9/7/2015 7:00",455,203,13,13,658,"neutor",NA
"9/7/2015 8:00",422,269,13,9,691,"neutor",NA
"9/7/2015 9:00",317,194,14,11,511,"neutor",NA
"9/7/2015 10:00",281,176,15,13,457,"neutor",NA
"9/7/2015 11:00",210,181,16,15,391,"neutor",NA
"9/7/2015 12:00",317,237,16,13,554,"neutor",NA
"9/7/2015 13:00",235,272,15,6,507,"neutor",NA
"9/7/2015 14:00",257,253,16,13,510,"neutor",NA
"9/7/2015 15:00",285,302,17,11,587,"neutor",NA
"9/7/2015 16:00",361,367,16,7,728,"neutor",NA
"9/7/2015 17:00",400,466,16,7,866,"neutor",NA
"9/7/2015 18:00",338,485,15,7,823,"neutor",NA
"9/7/2015 19:00",286,297,15,6,583,"neutor",NA
"9/7/2015 20:00",165,208,14,7,373,"neutor",NA
"9/7/2015 21:00",109,164,12,7,273,"neutor",NA
"9/7/2015 22:00",66,134,11,6,200,"neutor",NA
"9/7/2015 23:00",35,106,12,6,141,"neutor",NA
"9/8/2015 0:00",35,49,12,6,84,"neutor",NA
"9/8/2015 1:00",15,28,10,4,43,"neutor",NA
"9/8/2015 2:00",4,4,10,4,8,"neutor",NA
"9/8/2015 3:00",4,11,11,6,15,"neutor",NA
"9/8/2015 4:00",8,7,12,6,15,"neutor",NA
"9/8/2015 5:00",40,14,12,6,54,"neutor",NA
"9/8/2015 6:00",132,45,13,6,177,"neutor",NA
"9/8/2015 7:00",461,191,13,6,652,"neutor",NA
"9/8/2015 8:00",343,255,13,7,598,"neutor",NA
"9/8/2015 9:00",284,171,14,7,455,"neutor",NA
"9/8/2015 10:00",198,138,14,9,336,"neutor",NA
"9/8/2015 11:00",236,168,15,11,404,"neutor",NA
"9/8/2015 12:00",264,206,15,4,470,"neutor",NA
"9/8/2015 13:00",239,276,16,7,515,"neutor",NA
"9/8/2015 14:00",273,246,16,9,519,"neutor",NA
"9/8/2015 15:00",275,309,16,11,584,"neutor",NA
"9/8/2015 16:00",348,363,16,7,711,"neutor",NA
"9/8/2015 17:00",371,468,17,7,839,"neutor",NA
"9/8/2015 18:00",337,423,16,6,760,"neutor",NA
"9/8/2015 19:00",290,300,15,6,590,"neutor",NA
"9/8/2015 20:00",181,212,14,2,393,"neutor",NA
"9/8/2015 21:00",110,172,13,2,282,"neutor",NA
"9/8/2015 22:00",105,168,11,2,273,"neutor",NA
"9/8/2015 23:00",58,134,10,2,192,"neutor",NA
"9/9/2015 0:00",26,49,10,0,75,"neutor",NA
"9/9/2015 1:00",9,22,9,2,31,"neutor",NA
"9/9/2015 2:00",3,12,9,2,15,"neutor",NA
"9/9/2015 3:00",6,13,8,2,19,"neutor",NA
"9/9/2015 4:00",12,6,7,2,18,"neutor",NA
"9/9/2015 5:00",26,16,6,2,42,"neutor",NA
"9/9/2015 6:00",126,55,9,2,181,"neutor",NA
"9/9/2015 7:00",492,233,11,7,725,"neutor",NA
"9/9/2015 8:00",435,255,12,7,690,"neutor",NA
"9/9/2015 9:00",385,219,13,6,604,"neutor",NA
"9/9/2015 10:00",316,194,15,7,510,"neutor",NA
"9/9/2015 11:00",277,188,15,15,465,"neutor",NA
"9/9/2015 12:00",387,318,16,11,705,"neutor",NA
"9/9/2015 13:00",370,367,17,11,737,"neutor",NA
"9/9/2015 14:00",345,389,17,9,734,"neutor",NA
"9/9/2015 15:00",361,363,18,17,724,"neutor",NA
"9/9/2015 16:00",439,458,18,11,897,"neutor",NA
"9/9/2015 17:00",469,533,18,13,1002,"neutor",NA
"9/9/2015 18:00",463,492,17,7,955,"neutor",NA
"9/9/2015 19:00",384,382,16,6,766,"neutor",NA
"9/9/2015 20:00",249,269,14,6,518,"neutor",NA
"9/9/2015 21:00",169,239,13,7,408,"neutor",NA
"9/9/2015 22:00",122,203,12,7,325,"neutor",NA
"9/9/2015 23:00",123,128,11,2,251,"neutor",NA
"9/10/2015 0:00",57,95,9,4,152,"neutor",NA
"9/10/2015 1:00",35,72,9,6,107,"neutor",NA
"9/10/2015 2:00",10,68,9,6,78,"neutor",NA
"9/10/2015 3:00",10,69,9,7,79,"neutor",NA
"9/10/2015 4:00",15,28,8,7,43,"neutor",NA
"9/10/2015 5:00",42,24,9,7,66,"neutor",NA
"9/10/2015 6:00",121,53,9,7,174,"neutor",NA
"9/10/2015 7:00",498,228,9,7,726,"neutor",NA
"9/10/2015 8:00",488,275,12,9,763,"neutor",NA
"9/10/2015 9:00",367,227,15,9,594,"neutor",NA
"9/10/2015 10:00",314,176,16,13,490,"neutor",NA
"9/10/2015 11:00",287,195,17,15,482,"neutor",NA
"9/10/2015 12:00",373,280,17,17,653,"neutor",NA
"9/10/2015 13:00",343,370,18,17,713,"neutor",NA
"9/10/2015 14:00",354,382,18,15,736,"neutor",NA
"9/10/2015 15:00",350,382,19,11,732,"neutor",NA
"9/10/2015 16:00",430,471,18,17,901,"neutor",NA
"9/10/2015 17:00",444,558,19,11,1002,"neutor",NA
"9/10/2015 18:00",374,500,18,9,874,"neutor",NA
"9/10/2015 19:00",319,377,16,7,696,"neutor",NA
"9/10/2015 20:00",203,274,14,6,477,"neutor",NA
"9/10/2015 21:00",147,209,13,7,356,"neutor",NA
"9/10/2015 22:00",116,217,13,6,333,"neutor",NA
"9/10/2015 23:00",70,126,12,6,196,"neutor",NA
"9/11/2015 0:00",37,61,11,6,98,"neutor",NA
"9/11/2015 1:00",23,40,11,7,63,"neutor",NA
"9/11/2015 2:00",9,19,10,9,28,"neutor",NA
"9/11/2015 3:00",7,11,10,7,18,"neutor",NA
"9/11/2015 4:00",9,11,10,7,20,"neutor",NA
"9/11/2015 5:00",37,15,9,6,52,"neutor",NA
"9/11/2015 6:00",116,56,9,6,172,"neutor",NA
"9/11/2015 7:00",462,194,8,4,656,"neutor",NA
"9/11/2015 8:00",397,240,11,7,637,"neutor",NA
"9/11/2015 9:00",339,178,13,7,517,"neutor",NA
"9/11/2015 10:00",284,227,15,7,511,"neutor",NA
"9/11/2015 11:00",260,200,16,9,460,"neutor",NA
"9/11/2015 12:00",320,254,16,15,574,"neutor",NA
"9/11/2015 13:00",327,349,18,9,676,"neutor",NA
"9/11/2015 14:00",355,407,19,11,762,"neutor",NA
"9/11/2015 15:00",364,352,19,11,716,"neutor",NA
"9/11/2015 16:00",367,389,19,13,756,"neutor",NA
"9/11/2015 17:00",387,363,19,7,750,"neutor",NA
"9/11/2015 18:00",348,385,18,6,733,"neutor",NA
"9/11/2015 19:00",293,367,16,6,660,"neutor",NA
"9/11/2015 20:00",238,272,15,7,510,"neutor",NA
"9/11/2015 21:00",178,201,14,7,379,"neutor",NA
"9/11/2015 22:00",120,158,14,7,278,"neutor",NA
"9/11/2015 23:00",120,133,13,6,253,"neutor",NA
"9/12/2015 0:00",96,129,12,6,225,"neutor",NA
"9/12/2015 1:00",80,118,12,6,198,"neutor",NA
"9/12/2015 2:00",21,131,11,6,152,"neutor",NA
"9/12/2015 3:00",21,66,11,4,87,"neutor",NA
"9/12/2015 4:00",13,55,11,4,68,"neutor",NA
"9/12/2015 5:00",24,30,11,6,54,"neutor",NA
"9/12/2015 6:00",26,14,11,4,40,"neutor",NA
"9/12/2015 7:00",71,35,12,7,106,"neutor",NA
"9/12/2015 8:00",137,52,13,11,189,"neutor",NA
"9/12/2015 9:00",247,81,14,7,328,"neutor",NA
"9/12/2015 10:00",321,122,16,9,443,"neutor",NA
"9/12/2015 11:00",396,174,19,11,570,"neutor",NA
"9/12/2015 12:00",376,220,19,9,596,"neutor",NA
"9/12/2015 13:00",273,241,20,11,514,"neutor",NA
"9/12/2015 14:00",229,273,19,7,502,"neutor",NA
"9/12/2015 15:00",264,282,20,11,546,"neutor",NA
"9/12/2015 16:00",212,289,20,7,501,"neutor",NA
"9/12/2015 17:00",245,290,19,4,535,"neutor",NA
"9/12/2015 18:00",127,250,17,4,377,"neutor",NA
"9/12/2015 19:00",151,183,16,4,334,"neutor",NA
"9/12/2015 20:00",144,115,16,6,259,"neutor",NA
"9/12/2015 21:00",77,77,16,7,154,"neutor",NA
"9/12/2015 22:00",60,86,16,6,146,"neutor",NA
"9/12/2015 23:00",69,80,16,4,149,"neutor",NA
"9/13/2015 0:00",61,82,16,6,143,"neutor",NA
"9/13/2015 1:00",51,49,16,6,100,"neutor",NA
"9/13/2015 2:00",24,62,16,7,86,"neutor",NA
"9/13/2015 3:00",22,67,16,6,89,"neutor",NA
"9/13/2015 4:00",6,52,16,6,58,"neutor",NA
"9/13/2015 5:00",17,27,15,6,44,"neutor",NA
"9/13/2015 6:00",19,18,16,6,37,"neutor",NA
"9/13/2015 7:00",37,22,16,6,59,"neutor",NA
"9/13/2015 8:00",33,26,16,9,59,"neutor",NA
"9/13/2015 9:00",105,34,17,9,139,"neutor",NA
"9/13/2015 10:00",162,84,18,11,246,"neutor",NA
"9/13/2015 11:00",178,119,18,9,297,"neutor",NA
"9/13/2015 12:00",163,134,19,9,297,"neutor",NA
"9/13/2015 13:00",205,155,20,6,360,"neutor",NA
"9/13/2015 14:00",203,208,20,7,411,"neutor",NA
"9/13/2015 15:00",188,195,20,13,383,"neutor",NA
"9/13/2015 16:00",128,166,19,11,294,"neutor",NA
"9/13/2015 17:00",163,203,18,9,366,"neutor",NA
"9/13/2015 18:00",137,147,17,11,284,"neutor",NA
"9/13/2015 19:00",120,184,17,9,304,"neutor",NA
"9/13/2015 20:00",87,120,17,11,207,"neutor",NA
"9/13/2015 21:00",50,86,17,9,136,"neutor",NA
"9/13/2015 22:00",42,90,17,11,132,"neutor",NA
"9/13/2015 23:00",25,56,16,9,81,"neutor",NA
"9/14/2015 0:00",8,25,16,9,33,"neutor",NA
"9/14/2015 1:00",4,4,16,6,8,"neutor",NA
"9/14/2015 2:00",4,11,15,7,15,"neutor",NA
"9/14/2015 3:00",1,1,16,6,2,"neutor",NA
"9/14/2015 4:00",8,4,16,7,12,"neutor",NA
"9/14/2015 5:00",35,20,16,7,55,"neutor",NA
"9/14/2015 6:00",100,50,16,7,150,"neutor",NA
"9/14/2015 7:00",370,174,16,7,544,"neutor",NA
"9/14/2015 8:00",367,245,16,7,612,"neutor",NA
"9/14/2015 9:00",309,204,16,7,513,"neutor",NA
"9/14/2015 10:00",256,154,17,11,410,"neutor",NA
"9/14/2015 11:00",222,161,17,11,383,"neutor",NA
"9/14/2015 12:00",273,244,18,15,517,"neutor",NA
"9/14/2015 13:00",271,277,19,19,548,"neutor",NA
"9/14/2015 14:00",280,276,20,15,556,"neutor",NA
"9/14/2015 15:00",294,331,21,22,625,"neutor",NA
"9/14/2015 16:00",367,388,21,22,755,"neutor",NA
"9/14/2015 17:00",434,544,20,20,978,"neutor",NA
"9/14/2015 18:00",285,368,16,11,653,"neutor",NA
"9/14/2015 19:00",294,340,15,9,634,"neutor",NA
"9/14/2015 20:00",166,199,16,15,365,"neutor",NA
"9/14/2015 21:00",124,152,15,20,276,"neutor",NA
"9/14/2015 22:00",64,155,14,22,219,"neutor",NA
"9/14/2015 23:00",30,99,13,20,129,"neutor",NA
"9/15/2015 0:00",26,54,13,19,80,"neutor",NA
"9/15/2015 1:00",13,43,13,24,56,"neutor",NA
"9/15/2015 2:00",6,7,12,17,13,"neutor",NA
"9/15/2015 3:00",4,5,11,15,9,"neutor",NA
"9/15/2015 4:00",14,7,11,15,21,"neutor",NA
"9/15/2015 5:00",38,16,11,13,54,"neutor",NA
"9/15/2015 6:00",125,42,10,13,167,"neutor",NA
"9/15/2015 7:00",485,208,11,15,693,"neutor",NA
"9/15/2015 8:00",455,286,12,15,741,"neutor",NA
"9/15/2015 9:00",285,190,12,19,475,"neutor",NA
"9/15/2015 10:00",240,196,13,13,436,"neutor",NA
"9/15/2015 11:00",228,197,14,28,425,"neutor",NA
"9/15/2015 12:00",253,206,13,24,459,"neutor",NA
"9/15/2015 13:00",266,257,14,19,523,"neutor",NA
"9/15/2015 14:00",299,309,16,22,608,"neutor",NA
"9/15/2015 15:00",331,330,16,28,661,"neutor",NA
"9/15/2015 16:00",379,405,17,24,784,"neutor",NA
"9/15/2015 17:00",430,514,17,20,944,"neutor",NA
"9/15/2015 18:00",336,439,16,13,775,"neutor",NA
"9/15/2015 19:00",373,334,16,13,707,"neutor",NA
"9/15/2015 20:00",222,232,16,13,454,"neutor",NA
"9/15/2015 21:00",146,144,14,13,290,"neutor",NA
"9/15/2015 22:00",118,196,13,11,314,"neutor",NA
"9/15/2015 23:00",45,123,12,9,168,"neutor",NA
"9/16/2015 0:00",31,100,11,6,131,"neutor",NA
"9/16/2015 1:00",12,52,11,7,64,"neutor",NA
"9/16/2015 2:00",10,14,11,9,24,"neutor",NA
"9/16/2015 3:00",9,5,12,6,14,"neutor",NA
"9/16/2015 4:00",12,6,11,9,18,"neutor",NA
"9/16/2015 5:00",24,13,11,7,37,"neutor",NA
"9/16/2015 6:00",106,41,12,7,147,"neutor",NA
"9/16/2015 7:00",393,171,12,9,564,"neutor",NA
"9/16/2015 8:00",415,231,13,11,646,"neutor",NA
"9/16/2015 9:00",345,215,14,13,560,"neutor",NA
"9/16/2015 10:00",231,172,15,17,403,"neutor",NA
"9/16/2015 11:00",272,200,17,19,472,"neutor",NA
"9/16/2015 12:00",331,256,18,22,587,"neutor",NA
"9/16/2015 13:00",278,293,17,19,571,"neutor",NA
"9/16/2015 14:00",261,274,17,17,535,"neutor",NA
"9/16/2015 15:00",238,284,17,17,522,"neutor",NA
"9/16/2015 16:00",227,291,16,15,518,"neutor",NA
"9/16/2015 17:00",350,385,17,17,735,"neutor",NA
"9/16/2015 18:00",360,356,17,9,716,"neutor",NA
"9/16/2015 19:00",236,266,17,15,502,"neutor",NA
"9/16/2015 20:00",136,170,17,13,306,"neutor",NA
"9/16/2015 21:00",142,150,17,19,292,"neutor",NA
"9/16/2015 22:00",89,144,17,19,233,"neutor",NA
"9/16/2015 23:00",72,89,18,19,161,"neutor",NA
"9/17/2015 0:00",81,79,18,26,160,"neutor",NA
"9/17/2015 1:00",34,54,18,26,88,"neutor",NA
"9/17/2015 2:00",11,39,17,22,50,"neutor",NA
"9/17/2015 3:00",6,35,16,20,41,"neutor",NA
"9/17/2015 4:00",10,31,17,28,41,"neutor",NA
"9/17/2015 5:00",37,30,16,24,67,"neutor",NA
"9/17/2015 6:00",102,43,16,20,145,"neutor",NA
"9/17/2015 7:00",420,181,16,22,601,"neutor",NA
"9/17/2015 8:00",372,254,17,22,626,"neutor",NA
"9/17/2015 9:00",353,170,17,17,523,"neutor",NA
"9/17/2015 10:00",234,151,17,19,385,"neutor",NA
"9/17/2015 11:00",258,212,18,24,470,"neutor",NA
"9/17/2015 12:00",302,239,18,30,541,"neutor",NA
"9/17/2015 13:00",267,334,18,30,601,"neutor",NA
"9/17/2015 14:00",329,286,18,26,615,"neutor",NA
"9/17/2015 15:00",364,317,18,33,681,"neutor",NA
"9/17/2015 16:00",377,352,17,28,729,"neutor",NA
"9/17/2015 17:00",361,433,15,26,794,"neutor",NA
"9/17/2015 18:00",235,312,14,22,547,"neutor",NA
"9/17/2015 19:00",231,304,14,15,535,"neutor",NA
"9/17/2015 20:00",122,170,14,19,292,"neutor",NA
"9/17/2015 21:00",100,139,14,17,239,"neutor",NA
"9/17/2015 22:00",80,138,13,15,218,"neutor",NA
"9/17/2015 23:00",48,113,13,11,161,"neutor",NA
"9/18/2015 0:00",33,65,12,11,98,"neutor",NA
"9/18/2015 1:00",19,42,12,13,61,"neutor",NA
"9/18/2015 2:00",2,18,12,13,20,"neutor",NA
"9/18/2015 3:00",6,5,11,11,11,"neutor",NA
"9/18/2015 4:00",14,10,11,11,24,"neutor",NA
"9/18/2015 5:00",27,15,11,11,42,"neutor",NA
"9/18/2015 6:00",104,42,11,11,146,"neutor",NA
"9/18/2015 7:00",415,182,11,9,597,"neutor",NA
"9/18/2015 8:00",383,221,12,13,604,"neutor",NA
"9/18/2015 9:00",325,194,14,15,519,"neutor",NA
"9/18/2015 10:00",269,171,15,17,440,"neutor",NA
"9/18/2015 11:00",298,183,16,17,481,"neutor",NA
"9/18/2015 12:00",351,257,18,17,608,"neutor",NA
"9/18/2015 13:00",361,367,18,19,728,"neutor",NA
"9/18/2015 14:00",348,382,18,13,730,"neutor",NA
"9/18/2015 15:00",362,346,19,13,708,"neutor",NA
"9/18/2015 16:00",342,348,19,17,690,"neutor",NA
"9/18/2015 17:00",373,368,17,7,741,"neutor",NA
"9/18/2015 18:00",281,358,17,7,639,"neutor",NA
"9/18/2015 19:00",289,332,16,6,621,"neutor",NA
"9/18/2015 20:00",264,221,15,9,485,"neutor",NA
"9/18/2015 21:00",156,170,15,7,326,"neutor",NA
"9/18/2015 22:00",152,167,13,7,319,"neutor",NA
"9/18/2015 23:00",93,133,13,7,226,"neutor",NA
"9/19/2015 0:00",95,143,12,6,238,"neutor",NA
"9/19/2015 1:00",69,137,12,6,206,"neutor",NA
"9/19/2015 2:00",30,91,12,6,121,"neutor",NA
"9/19/2015 3:00",41,88,12,6,129,"neutor",NA
"9/19/2015 4:00",37,49,12,6,86,"neutor",NA
"9/19/2015 5:00",29,27,12,4,56,"neutor",NA
"9/19/2015 6:00",40,17,13,7,57,"neutor",NA
"9/19/2015 7:00",85,28,13,7,113,"neutor",NA
"9/19/2015 8:00",185,67,13,9,252,"neutor",NA
"9/19/2015 9:00",471,94,14,9,565,"neutor",NA
"9/19/2015 10:00",659,154,14,13,813,"neutor",NA
"9/19/2015 11:00",718,161,15,15,879,"neutor",NA
"9/19/2015 12:00",636,243,16,13,879,"neutor",NA
"9/19/2015 13:00",612,251,15,13,863,"neutor",NA
"9/19/2015 14:00",424,301,14,6,725,"neutor",NA
"9/19/2015 15:00",372,280,16,7,652,"neutor",NA
"9/19/2015 16:00",353,271,14,19,624,"neutor",NA
"9/19/2015 17:00",228,237,14,7,465,"neutor",NA
"9/19/2015 18:00",197,238,14,6,435,"neutor",NA
"9/19/2015 19:00",193,220,13,4,413,"neutor",NA
"9/19/2015 20:00",200,160,12,0,360,"neutor",NA
"9/19/2015 21:00",142,109,12,4,251,"neutor",NA
"9/19/2015 22:00",110,122,12,6,232,"neutor",NA
"9/19/2015 23:00",84,101,12,6,185,"neutor",NA
"9/20/2015 0:00",75,130,12,6,205,"neutor",NA
"9/20/2015 1:00",67,103,11,7,170,"neutor",NA
"9/20/2015 2:00",29,57,11,9,86,"neutor",NA
"9/20/2015 3:00",23,69,11,9,92,"neutor",NA
"9/20/2015 4:00",14,35,10,7,49,"neutor",NA
"9/20/2015 5:00",12,22,10,7,34,"neutor",NA
"9/20/2015 6:00",17,26,10,9,43,"neutor",NA
"9/20/2015 7:00",20,13,10,7,33,"neutor",NA
"9/20/2015 8:00",55,30,11,9,85,"neutor",NA
"9/20/2015 9:00",128,53,13,13,181,"neutor",NA
"9/20/2015 10:00",219,84,14,17,303,"neutor",NA
"9/20/2015 11:00",166,111,15,19,277,"neutor",NA
"9/20/2015 12:00",165,135,15,19,300,"neutor",NA
"9/20/2015 13:00",163,162,14,17,325,"neutor",NA
"9/20/2015 14:00",202,151,17,22,353,"neutor",NA
"9/20/2015 15:00",190,134,16,24,324,"neutor",NA
"9/20/2015 16:00",192,170,16,20,362,"neutor",NA
"9/20/2015 17:00",168,211,17,30,379,"neutor",NA
"9/20/2015 18:00",172,178,16,19,350,"neutor",NA
"9/20/2015 19:00",154,201,15,11,355,"neutor",NA
"9/20/2015 20:00",86,127,14,11,213,"neutor",NA
"9/20/2015 21:00",70,108,14,9,178,"neutor",NA
"9/20/2015 22:00",52,101,14,9,153,"neutor",NA
"9/20/2015 23:00",23,41,14,7,64,"neutor",NA
"9/21/2015 0:00",14,18,13,11,32,"neutor",NA
"9/21/2015 1:00",9,15,13,9,24,"neutor",NA
"9/21/2015 2:00",1,2,12,6,3,"neutor",NA
"9/21/2015 3:00",3,2,13,6,5,"neutor",NA
"9/21/2015 4:00",5,6,12,7,11,"neutor",NA
"9/21/2015 5:00",39,16,12,7,55,"neutor",NA
"9/21/2015 6:00",125,42,12,7,167,"neutor",NA
"9/21/2015 7:00",483,199,12,7,682,"neutor",NA
"9/21/2015 8:00",403,352,12,9,755,"neutor",NA
"9/21/2015 9:00",358,261,13,6,619,"neutor",NA
"9/21/2015 10:00",282,188,15,11,470,"neutor",NA
"9/21/2015 11:00",320,226,17,17,546,"neutor",NA
"9/21/2015 12:00",378,296,17,19,674,"neutor",NA
"9/21/2015 13:00",316,326,18,20,642,"neutor",NA
"9/21/2015 14:00",366,359,18,17,725,"neutor",NA
"9/21/2015 15:00",378,387,18,19,765,"neutor",NA
"9/21/2015 16:00",411,447,18,15,858,"neutor",NA
"9/21/2015 17:00",451,502,17,9,953,"neutor",NA
"9/21/2015 18:00",373,457,16,6,830,"neutor",NA
"9/21/2015 19:00",348,343,13,4,691,"neutor",NA
"9/21/2015 20:00",187,226,13,6,413,"neutor",NA
"9/21/2015 21:00",122,177,13,6,299,"neutor",NA
"9/21/2015 22:00",94,182,13,6,276,"neutor",NA
"9/21/2015 23:00",43,125,13,6,168,"neutor",NA
"9/22/2015 0:00",21,51,13,7,72,"neutor",NA
"9/22/2015 1:00",19,31,13,9,50,"neutor",NA
"9/22/2015 2:00",4,13,13,7,17,"neutor",NA
"9/22/2015 3:00",3,2,12,11,5,"neutor",NA
"9/22/2015 4:00",6,3,12,7,9,"neutor",NA
"9/22/2015 5:00",33,13,12,11,46,"neutor",NA
"9/22/2015 6:00",124,47,12,13,171,"neutor",NA
"9/22/2015 7:00",410,185,12,15,595,"neutor",NA
"9/22/2015 8:00",413,340,13,13,753,"neutor",NA
"9/22/2015 9:00",352,232,13,13,584,"neutor",NA
"9/22/2015 10:00",288,192,14,11,480,"neutor",NA
"9/22/2015 11:00",243,222,15,13,465,"neutor",NA
"9/22/2015 12:00",268,232,15,13,500,"neutor",NA
"9/22/2015 13:00",279,246,14,9,525,"neutor",NA
"9/22/2015 14:00",270,253,14,9,523,"neutor",NA
"9/22/2015 15:00",299,314,15,13,613,"neutor",NA
"9/22/2015 16:00",356,392,14,13,748,"neutor",NA
"9/22/2015 17:00",384,423,15,9,807,"neutor",NA
"9/22/2015 18:00",414,390,14,6,804,"neutor",NA
"9/22/2015 19:00",368,329,13,4,697,"neutor",NA
"9/22/2015 20:00",177,188,13,6,365,"neutor",NA
"9/22/2015 21:00",137,200,12,4,337,"neutor",NA
"9/22/2015 22:00",76,160,12,11,236,"neutor",NA
"9/22/2015 23:00",53,116,12,11,169,"neutor",NA
"9/23/2015 0:00",21,54,12,11,75,"neutor",NA
"9/23/2015 1:00",18,51,12,11,69,"neutor",NA
"9/23/2015 2:00",5,23,12,13,28,"neutor",NA
"9/23/2015 3:00",2,9,11,15,11,"neutor",NA
"9/23/2015 4:00",9,4,11,11,13,"neutor",NA
"9/23/2015 5:00",30,14,11,11,44,"neutor",NA
"9/23/2015 6:00",113,37,11,9,150,"neutor",NA
"9/23/2015 7:00",404,160,11,11,564,"neutor",NA
"9/23/2015 8:00",339,243,11,19,582,"neutor",NA
"9/23/2015 9:00",364,254,12,13,618,"neutor",NA
"9/23/2015 10:00",263,174,12,6,437,"neutor",NA
"9/23/2015 11:00",289,197,14,15,486,"neutor",NA
"9/23/2015 12:00",318,279,15,11,597,"neutor",NA
"9/23/2015 13:00",300,278,15,11,578,"neutor",NA
"9/23/2015 14:00",297,301,16,11,598,"neutor",NA
"9/23/2015 15:00",346,304,16,7,650,"neutor",NA
"9/23/2015 16:00",400,379,16,6,779,"neutor",NA
"9/23/2015 17:00",487,406,17,4,893,"neutor",NA
"9/23/2015 18:00",397,414,16,6,811,"neutor",NA
"9/23/2015 19:00",392,370,13,4,762,"neutor",NA
"9/23/2015 20:00",235,224,11,6,459,"neutor",NA
"9/23/2015 21:00",156,247,12,7,403,"neutor",NA
"9/23/2015 22:00",146,206,13,7,352,"neutor",NA
"9/23/2015 23:00",109,151,13,15,260,"neutor",NA
"9/24/2015 0:00",62,88,13,11,150,"neutor",NA
"9/24/2015 1:00",59,63,12,7,122,"neutor",NA
"9/24/2015 2:00",12,74,12,11,86,"neutor",NA
"9/24/2015 3:00",10,63,11,11,73,"neutor",NA
"9/24/2015 4:00",6,43,11,11,49,"neutor",NA
"9/24/2015 5:00",40,39,11,13,79,"neutor",NA
"9/24/2015 6:00",107,45,11,13,152,"neutor",NA
"9/24/2015 7:00",459,229,11,11,688,"neutor",NA
"9/24/2015 8:00",436,310,12,17,746,"neutor",NA
"9/24/2015 9:00",347,261,13,19,608,"neutor",NA
"9/24/2015 10:00",327,210,14,19,537,"neutor",NA
"9/24/2015 11:00",372,235,15,19,607,"neutor",NA
"9/24/2015 12:00",335,285,15,20,620,"neutor",NA
"9/24/2015 13:00",312,391,15,17,703,"neutor",NA
"9/24/2015 14:00",378,301,16,17,679,"neutor",NA
"9/24/2015 15:00",395,366,17,19,761,"neutor",NA
"9/24/2015 16:00",404,390,17,19,794,"neutor",NA
"9/24/2015 17:00",476,492,16,13,968,"neutor",NA
"9/24/2015 18:00",386,429,17,15,815,"neutor",NA
"9/24/2015 19:00",320,329,16,15,649,"neutor",NA
"9/24/2015 20:00",196,220,16,13,416,"neutor",NA
"9/24/2015 21:00",123,224,15,20,347,"neutor",NA
"9/24/2015 22:00",111,169,13,13,280,"neutor",NA
"9/24/2015 23:00",74,133,13,7,207,"neutor",NA
"9/25/2015 0:00",34,91,13,9,125,"neutor",NA
"9/25/2015 1:00",24,67,11,7,91,"neutor",NA
"9/25/2015 2:00",6,21,10,7,27,"neutor",NA
"9/25/2015 3:00",5,19,10,6,24,"neutor",NA
"9/25/2015 4:00",16,18,11,7,34,"neutor",NA
"9/25/2015 5:00",39,13,11,7,52,"neutor",NA
"9/25/2015 6:00",120,47,12,7,167,"neutor",NA
"9/25/2015 7:00",395,189,12,11,584,"neutor",NA
"9/25/2015 8:00",370,255,12,11,625,"neutor",NA
"9/25/2015 9:00",328,195,12,13,523,"neutor",NA
"9/25/2015 10:00",281,168,12,11,449,"neutor",NA
"9/25/2015 11:00",250,229,13,13,479,"neutor",NA
"9/25/2015 12:00",337,303,15,11,640,"neutor",NA
"9/25/2015 13:00",316,346,17,15,662,"neutor",NA
"9/25/2015 14:00",377,392,16,9,769,"neutor",NA
"9/25/2015 15:00",425,334,16,20,759,"neutor",NA
"9/25/2015 16:00",355,331,15,6,686,"neutor",NA
"9/25/2015 17:00",367,369,15,6,736,"neutor",NA
"9/25/2015 18:00",313,354,15,4,667,"neutor",NA
"9/25/2015 19:00",315,310,11,4,625,"neutor",NA
"9/25/2015 20:00",255,199,13,6,454,"neutor",NA
"9/25/2015 21:00",162,138,13,4,300,"neutor",NA
"9/25/2015 22:00",112,153,13,6,265,"neutor",NA
"9/25/2015 23:00",74,161,12,4,235,"neutor",NA
"9/26/2015 0:00",102,150,11,6,252,"neutor",NA
"9/26/2015 1:00",64,131,10,0,195,"neutor",NA
"9/26/2015 2:00",59,82,9,2,141,"neutor",NA
"9/26/2015 3:00",33,95,9,6,128,"neutor",NA
"9/26/2015 4:00",19,54,8,4,73,"neutor",NA
"9/26/2015 5:00",32,34,6,4,66,"neutor",NA
"9/26/2015 6:00",36,21,6,0,57,"neutor",NA
"9/26/2015 7:00",62,30,5,2,92,"neutor",NA
"9/26/2015 8:00",138,50,8,2,188,"neutor",NA
"9/26/2015 9:00",250,111,11,2,361,"neutor",NA
"9/26/2015 10:00",284,132,14,7,416,"neutor",NA
"9/26/2015 11:00",369,159,15,7,528,"neutor",NA
"9/26/2015 12:00",426,248,15,9,674,"neutor",NA
"9/26/2015 13:00",386,233,17,7,619,"neutor",NA
"9/26/2015 14:00",308,271,16,7,579,"neutor",NA
"9/26/2015 15:00",266,299,16,13,565,"neutor",NA
"9/26/2015 16:00",235,322,15,13,557,"neutor",NA
"9/26/2015 17:00",265,278,15,7,543,"neutor",NA
"9/26/2015 18:00",214,327,13,6,541,"neutor",NA
"9/26/2015 19:00",199,270,11,2,469,"neutor",NA
"9/26/2015 20:00",181,172,10,2,353,"neutor",NA
"9/26/2015 21:00",142,130,9,0,272,"neutor",NA
"9/26/2015 22:00",102,135,8,2,237,"neutor",NA
"9/26/2015 23:00",102,112,7,2,214,"neutor",NA
"9/27/2015 0:00",66,132,7,4,198,"neutor",NA
"9/27/2015 1:00",67,100,6,2,167,"neutor",NA
"9/27/2015 2:00",51,79,5,4,130,"neutor",NA
"9/27/2015 3:00",30,81,5,4,111,"neutor",NA
"9/27/2015 4:00",17,48,5,2,65,"neutor",NA
"9/27/2015 5:00",13,23,4,0,36,"neutor",NA
"9/27/2015 6:00",24,25,4,2,49,"neutor",NA
"9/27/2015 7:00",21,8,4,2,29,"neutor",NA
"9/27/2015 8:00",51,25,7,0,76,"neutor",NA
"9/27/2015 9:00",124,55,11,4,179,"neutor",NA
"9/27/2015 10:00",177,77,14,7,254,"neutor",NA
"9/27/2015 11:00",258,185,15,13,443,"neutor",NA
"9/27/2015 12:00",279,276,16,9,555,"neutor",NA
"9/27/2015 13:00",260,193,15,11,453,"neutor",NA
"9/27/2015 14:00",348,271,15,11,619,"neutor",NA
"9/27/2015 15:00",309,243,16,17,552,"neutor",NA
"9/27/2015 16:00",248,231,15,13,479,"neutor",NA
"9/27/2015 17:00",242,221,15,11,463,"neutor",NA
"9/27/2015 18:00",181,211,14,4,392,"neutor",NA
"9/27/2015 19:00",168,193,11,4,361,"neutor",NA
"9/27/2015 20:00",89,138,10,4,227,"neutor",NA
"9/27/2015 21:00",48,98,9,6,146,"neutor",NA
"9/27/2015 22:00",54,82,9,6,136,"neutor",NA
"9/27/2015 23:00",19,59,10,2,78,"neutor",NA
"9/28/2015 0:00",12,17,10,2,29,"neutor",NA
"9/28/2015 1:00",8,6,11,7,14,"neutor",NA
"9/28/2015 2:00",7,3,11,9,10,"neutor",NA
"9/28/2015 3:00",5,1,9,2,6,"neutor",NA
"9/28/2015 4:00",10,9,8,0,19,"neutor",NA
"9/28/2015 5:00",24,11,7,2,35,"neutor",NA
"9/28/2015 6:00",114,47,6,2,161,"neutor",NA
"9/28/2015 7:00",444,210,6,2,654,"neutor",NA
"9/28/2015 8:00",423,354,8,2,777,"neutor",NA
"9/28/2015 9:00",346,264,11,2,610,"neutor",NA
"9/28/2015 10:00",298,213,14,4,511,"neutor",NA
"9/28/2015 11:00",275,227,15,7,502,"neutor",NA
"9/28/2015 12:00",326,298,15,7,624,"neutor",NA
"9/28/2015 13:00",341,341,17,9,682,"neutor",NA
"9/28/2015 14:00",357,338,17,15,695,"neutor",NA
"9/28/2015 15:00",363,374,16,15,737,"neutor",NA
"9/28/2015 16:00",512,423,17,7,935,"neutor",NA
"9/28/2015 17:00",488,494,15,13,982,"neutor",NA
"9/28/2015 18:00",449,526,13,6,975,"neutor",NA
"9/28/2015 19:00",336,369,11,4,705,"neutor",NA
"9/28/2015 20:00",227,201,10,6,428,"neutor",NA
"9/28/2015 21:00",152,170,9,4,322,"neutor",NA
"9/28/2015 22:00",90,185,8,2,275,"neutor",NA
"9/28/2015 23:00",40,144,7,2,184,"neutor",NA
"9/29/2015 0:00",22,77,7,6,99,"neutor",NA
"9/29/2015 1:00",6,62,8,4,68,"neutor",NA
"9/29/2015 2:00",1,15,6,4,16,"neutor",NA
"9/29/2015 3:00",5,3,7,4,8,"neutor",NA
"9/29/2015 4:00",7,5,5,2,12,"neutor",NA
"9/29/2015 5:00",29,14,6,4,43,"neutor",NA
"9/29/2015 6:00",127,52,6,6,179,"neutor",NA
"9/29/2015 7:00",459,256,6,4,715,"neutor",NA
"9/29/2015 8:00",466,326,9,7,792,"neutor",NA
"9/29/2015 9:00",388,249,12,7,637,"neutor",NA
"9/29/2015 10:00",290,213,14,11,503,"neutor",NA
"9/29/2015 11:00",318,266,15,15,584,"neutor",NA
"9/29/2015 12:00",392,319,16,19,711,"neutor",NA
"9/29/2015 13:00",361,361,16,15,722,"neutor",NA
"9/29/2015 14:00",419,366,16,13,785,"neutor",NA
"9/29/2015 15:00",430,389,16,15,819,"neutor",NA
"9/29/2015 16:00",477,482,16,15,959,"neutor",NA
"9/29/2015 17:00",570,553,15,13,1123,"neutor",NA
"9/29/2015 18:00",465,496,14,11,961,"neutor",NA
"9/29/2015 19:00",335,378,12,6,713,"neutor",NA
"9/29/2015 20:00",227,271,11,7,498,"neutor",NA
"9/29/2015 21:00",134,233,10,7,367,"neutor",NA
"9/29/2015 22:00",151,230,10,7,381,"neutor",NA
"9/29/2015 23:00",72,116,10,7,188,"neutor",NA
"9/30/2015 0:00",21,102,10,7,123,"neutor",NA
"9/30/2015 1:00",13,60,9,6,73,"neutor",NA
"9/30/2015 2:00",15,19,9,7,34,"neutor",NA
"9/30/2015 3:00",4,9,8,9,13,"neutor",NA
"9/30/2015 4:00",7,3,8,7,10,"neutor",NA
"9/30/2015 5:00",34,12,7,7,46,"neutor",NA
"9/30/2015 6:00",120,38,7,7,158,"neutor",NA
"9/30/2015 7:00",488,232,6,9,720,"neutor",NA
"9/30/2015 8:00",465,321,9,9,786,"neutor",NA
"9/30/2015 9:00",429,292,11,9,721,"neutor",NA
"9/30/2015 10:00",358,235,14,9,593,"neutor",NA
"9/30/2015 11:00",382,276,15,13,658,"neutor",NA
"9/30/2015 12:00",420,319,16,13,739,"neutor",NA
"9/30/2015 13:00",422,397,17,15,819,"neutor",NA
"9/30/2015 14:00",406,428,17,15,834,"neutor",NA
"9/30/2015 15:00",440,421,17,19,861,"neutor",NA
"9/30/2015 16:00",503,424,16,17,927,"neutor",NA
"9/30/2015 17:00",526,566,15,13,1092,"neutor",NA
"9/30/2015 18:00",430,525,14,9,955,"neutor",NA
"9/30/2015 19:00",432,360,12,6,792,"neutor",NA
"9/30/2015 20:00",308,248,11,7,556,"neutor",NA
"9/30/2015 21:00",187,200,10,7,387,"neutor",NA
"9/30/2015 22:00",155,195,9,7,350,"neutor",NA
"9/30/2015 23:00",110,140,9,7,250,"neutor",NA
"10/1/2015 0:00",77,113,8,6,190,"neutor",NA
"10/1/2015 1:00",63,84,8,6,147,"neutor",NA
"10/1/2015 2:00",4,87,7,6,91,"neutor",NA
"10/1/2015 3:00",8,95,7,7,103,"neutor",NA
"10/1/2015 4:00",24,60,7,7,84,"neutor",NA
"10/1/2015 5:00",39,32,5,6,71,"neutor",NA
"10/1/2015 6:00",108,48,5,6,156,"neutor",NA
"10/1/2015 7:00",462,232,5,4,694,"neutor",NA
"10/1/2015 8:00",416,326,7,6,742,"neutor",NA
"10/1/2015 9:00",444,333,11,11,777,"neutor",NA
"10/1/2015 10:00",290,194,13,13,484,"neutor",NA
"10/1/2015 11:00",288,245,14,19,533,"neutor",NA
"10/1/2015 12:00",347,338,15,15,685,"neutor",NA
"10/1/2015 13:00",372,362,16,17,734,"neutor",NA
"10/1/2015 14:00",381,403,16,11,784,"neutor",NA
"10/1/2015 15:00",482,397,16,11,879,"neutor",NA
"10/1/2015 16:00",567,484,16,17,1051,"neutor",NA
"10/1/2015 17:00",512,545,15,7,1057,"neutor",NA
"10/1/2015 18:00",451,486,13,4,937,"neutor",NA
"10/1/2015 19:00",353,371,10,6,724,"neutor",NA
"10/1/2015 20:00",244,246,7,6,490,"neutor",NA
"10/1/2015 21:00",112,155,8,6,267,"neutor",NA
"10/1/2015 22:00",110,182,6,4,292,"neutor",NA
"10/1/2015 23:00",87,160,5,4,247,"neutor",NA
"10/2/2015 0:00",41,74,4,4,115,"neutor",NA
"10/2/2015 1:00",18,37,3,2,55,"neutor",NA
"10/2/2015 2:00",4,25,3,4,29,"neutor",NA
"10/2/2015 3:00",4,20,3,4,24,"neutor",NA
"10/2/2015 4:00",6,19,3,4,25,"neutor",NA
"10/2/2015 5:00",31,20,2,6,51,"neutor",NA
"10/2/2015 6:00",109,53,2,4,162,"neutor",NA
"10/2/2015 7:00",434,198,2,2,632,"neutor",NA
"10/2/2015 8:00",374,302,4,2,676,"neutor",NA
"10/2/2015 9:00",383,256,10,0,639,"neutor",NA
"10/2/2015 10:00",343,197,13,6,540,"neutor",NA
"10/2/2015 11:00",366,216,15,9,582,"neutor",NA
"10/2/2015 12:00",362,346,16,9,708,"neutor",NA
"10/2/2015 13:00",399,434,17,9,833,"neutor",NA
"10/2/2015 14:00",420,407,18,13,827,"neutor",NA
"10/2/2015 15:00",495,392,18,9,887,"neutor",NA
"10/2/2015 16:00",450,396,18,9,846,"neutor",NA
"10/2/2015 17:00",498,429,17,13,927,"neutor",NA
"10/2/2015 18:00",401,400,14,9,801,"neutor",NA
"10/2/2015 19:00",396,288,12,9,684,"neutor",NA
"10/2/2015 20:00",246,215,11,4,461,"neutor",NA
"10/2/2015 21:00",182,145,9,6,327,"neutor",NA
"10/2/2015 22:00",151,159,10,9,310,"neutor",NA
"10/2/2015 23:00",118,131,10,7,249,"neutor",NA
"10/3/2015 0:00",77,132,9,6,209,"neutor",NA
"10/3/2015 1:00",52,120,10,9,172,"neutor",NA
"10/3/2015 2:00",34,115,7,6,149,"neutor",NA
"10/3/2015 3:00",11,81,6,6,92,"neutor",NA
"10/3/2015 4:00",19,69,4,4,88,"neutor",NA
"10/3/2015 5:00",24,39,4,2,63,"neutor",NA
"10/3/2015 6:00",36,19,4,2,55,"neutor",NA
"10/3/2015 7:00",95,42,4,4,137,"neutor",NA
"10/3/2015 8:00",184,99,7,4,283,"neutor",NA
"10/3/2015 9:00",159,105,9,2,264,"neutor",NA
"10/3/2015 10:00",268,163,13,6,431,"neutor",NA
"10/3/2015 11:00",514,227,14,4,741,"neutor",NA
"10/3/2015 12:00",556,309,15,2,865,"neutor",NA
"10/3/2015 13:00",494,341,16,2,835,"neutor",NA
"10/3/2015 14:00",505,286,17,4,791,"neutor",NA
"10/3/2015 15:00",427,323,18,4,750,"neutor",NA
"10/3/2015 16:00",324,354,19,2,678,"neutor",NA
"10/3/2015 17:00",338,369,18,2,707,"neutor",NA
"10/3/2015 18:00",251,299,15,2,550,"neutor",NA
"10/3/2015 19:00",237,225,12,0,462,"neutor",NA
"10/3/2015 20:00",252,132,11,2,384,"neutor",NA
"10/3/2015 21:00",131,126,11,4,257,"neutor",NA
"10/3/2015 22:00",109,110,11,0,219,"neutor",NA
"10/3/2015 23:00",79,101,9,2,180,"neutor",NA
"10/4/2015 0:00",71,106,8,2,177,"neutor",NA
"10/4/2015 1:00",49,100,7,0,149,"neutor",NA
"10/4/2015 2:00",31,90,7,0,121,"neutor",NA
"10/4/2015 3:00",24,60,7,0,84,"neutor",NA
"10/4/2015 4:00",13,36,7,2,49,"neutor",NA
"10/4/2015 5:00",5,32,7,2,37,"neutor",NA
"10/4/2015 6:00",9,18,8,2,27,"neutor",NA
"10/4/2015 7:00",15,12,7,0,27,"neutor",NA
"10/4/2015 8:00",47,27,9,2,74,"neutor",NA
"10/4/2015 9:00",115,53,11,2,168,"neutor",NA
"10/4/2015 10:00",171,75,13,4,246,"neutor",NA
"10/4/2015 11:00",164,143,15,4,307,"neutor",NA
"10/4/2015 12:00",187,170,16,6,357,"neutor",NA
"10/4/2015 13:00",262,177,18,7,439,"neutor",NA
"10/4/2015 14:00",270,224,18,9,494,"neutor",NA
"10/4/2015 15:00",314,227,19,11,541,"neutor",NA
"10/4/2015 16:00",320,287,19,11,607,"neutor",NA
"10/4/2015 17:00",288,261,18,7,549,"neutor",NA
"10/4/2015 18:00",177,260,14,4,437,"neutor",NA
"10/4/2015 19:00",176,306,12,2,482,"neutor",NA
"10/4/2015 20:00",92,201,12,2,293,"neutor",NA
"10/4/2015 21:00",64,123,13,6,187,"neutor",NA
"10/4/2015 22:00",53,100,13,7,153,"neutor",NA
"10/4/2015 23:00",35,65,11,4,100,"neutor",NA
"10/5/2015 0:00",16,30,10,4,46,"neutor",NA
"10/5/2015 1:00",10,15,9,2,25,"neutor",NA
"10/5/2015 2:00",8,8,9,4,16,"neutor",NA
"10/5/2015 3:00",6,1,9,6,7,"neutor",NA
"10/5/2015 4:00",6,7,9,6,13,"neutor",NA
"10/5/2015 5:00",32,14,9,4,46,"neutor",NA
"10/5/2015 6:00",107,37,9,6,144,"neutor",NA
"10/5/2015 7:00",264,204,9,7,468,"neutor",NA
"10/5/2015 8:00",381,297,10,9,678,"neutor",NA
"10/5/2015 9:00",403,278,12,9,681,"neutor",NA
"10/5/2015 10:00",322,199,14,9,521,"neutor",NA
"10/5/2015 11:00",328,215,15,13,543,"neutor",NA
"10/5/2015 12:00",396,280,17,13,676,"neutor",NA
"10/5/2015 13:00",381,355,17,9,736,"neutor",NA
"10/5/2015 14:00",456,426,17,15,882,"neutor",NA
"10/5/2015 15:00",489,564,18,9,1053,"neutor",NA
"10/5/2015 16:00",521,628,18,7,1149,"neutor",NA
"10/5/2015 17:00",586,562,18,7,1148,"neutor",NA
"10/5/2015 18:00",451,432,16,6,883,"neutor",NA
"10/5/2015 19:00",404,311,16,6,715,"neutor",NA
"10/5/2015 20:00",211,208,15,7,419,"neutor",NA
"10/5/2015 21:00",116,160,15,7,276,"neutor",NA
"10/5/2015 22:00",87,158,15,7,245,"neutor",NA
"10/5/2015 23:00",43,142,15,9,185,"neutor",NA
"10/6/2015 0:00",30,91,15,7,121,"neutor",NA
"10/6/2015 1:00",20,91,14,7,111,"neutor",NA
"10/6/2015 2:00",8,22,13,7,30,"neutor",NA
"10/6/2015 3:00",2,3,13,9,5,"neutor",NA
"10/6/2015 4:00",8,10,13,9,18,"neutor",NA
"10/6/2015 5:00",25,16,13,11,41,"neutor",NA
"10/6/2015 6:00",75,37,13,13,112,"neutor",NA
"10/6/2015 7:00",207,192,13,11,399,"neutor",NA
"10/6/2015 8:00",323,283,13,11,606,"neutor",NA
"10/6/2015 9:00",327,364,14,13,691,"neutor",NA
"10/6/2015 10:00",247,201,15,15,448,"neutor",NA
"10/6/2015 11:00",259,184,15,15,443,"neutor",NA
"10/6/2015 12:00",291,224,16,17,515,"neutor",NA
"10/6/2015 13:00",345,258,16,13,603,"neutor",NA
"10/6/2015 14:00",369,290,17,9,659,"neutor",NA
"10/6/2015 15:00",423,288,17,4,711,"neutor",NA
"10/6/2015 16:00",420,360,19,7,780,"neutor",NA
"10/6/2015 17:00",496,415,18,4,911,"neutor",NA
"10/6/2015 18:00",470,403,17,6,873,"neutor",NA
"10/6/2015 19:00",448,357,17,6,805,"neutor",NA
"10/6/2015 20:00",250,196,17,6,446,"neutor",NA
"10/6/2015 21:00",153,155,16,6,308,"neutor",NA
"10/6/2015 22:00",153,202,16,7,355,"neutor",NA
"10/6/2015 23:00",137,187,16,6,324,"neutor",NA
"10/7/2015 0:00",48,103,15,6,151,"neutor",NA
"10/7/2015 1:00",19,153,15,6,172,"neutor",NA
"10/7/2015 2:00",12,80,14,6,92,"neutor",NA
"10/7/2015 3:00",12,49,14,6,61,"neutor",NA
"10/7/2015 4:00",8,25,14,6,33,"neutor",NA
"10/7/2015 5:00",36,15,15,6,51,"neutor",NA
"10/7/2015 6:00",89,37,14,7,126,"neutor",NA
"10/7/2015 7:00",298,235,14,6,533,"neutor",NA
"10/7/2015 8:00",409,333,14,6,742,"neutor",NA
"10/7/2015 9:00",477,327,16,9,804,"neutor",NA
"10/7/2015 10:00",337,245,17,9,582,"neutor",NA
"10/7/2015 11:00",404,350,17,13,754,"neutor",NA
"10/7/2015 12:00",398,331,17,13,729,"neutor",NA
"10/7/2015 13:00",374,310,16,9,684,"neutor",NA
"10/7/2015 14:00",402,343,18,11,745,"neutor",NA
"10/7/2015 15:00",503,355,18,13,858,"neutor",NA
"10/7/2015 16:00",447,414,17,17,861,"neutor",NA
"10/7/2015 17:00",534,473,17,15,1007,"neutor",NA
"10/7/2015 18:00",402,452,16,7,854,"neutor",NA
"10/7/2015 19:00",438,332,15,7,770,"neutor",NA
"10/7/2015 20:00",229,239,15,7,468,"neutor",NA
"10/7/2015 21:00",241,158,14,13,399,"neutor",NA
"10/7/2015 22:00",124,238,14,13,362,"neutor",NA
"10/7/2015 23:00",147,126,14,13,273,"neutor",NA
"10/8/2015 0:00",98,114,14,11,212,"neutor",NA
"10/8/2015 1:00",36,122,14,13,158,"neutor",NA
"10/8/2015 2:00",12,90,14,11,102,"neutor",NA
"10/8/2015 3:00",8,90,13,11,98,"neutor",NA
"10/8/2015 4:00",12,74,13,11,86,"neutor",NA
"10/8/2015 5:00",41,44,13,13,85,"neutor",NA
"10/8/2015 6:00",97,57,13,13,154,"neutor",NA
"10/8/2015 7:00",233,188,13,9,421,"neutor",NA
"10/8/2015 8:00",358,282,13,9,640,"neutor",NA
"10/8/2015 9:00",294,357,13,7,651,"neutor",NA
"10/8/2015 10:00",268,256,13,11,524,"neutor",NA
"10/8/2015 11:00",272,204,14,9,476,"neutor",NA
"10/8/2015 12:00",237,222,14,9,459,"neutor",NA
"10/8/2015 13:00",225,214,14,7,439,"neutor",NA
"10/8/2015 14:00",361,246,14,9,607,"neutor",NA
"10/8/2015 15:00",366,289,14,9,655,"neutor",NA
"10/8/2015 16:00",471,300,14,9,771,"neutor",NA
"10/8/2015 17:00",452,339,14,11,791,"neutor",NA
"10/8/2015 18:00",357,339,14,6,696,"neutor",NA
"10/8/2015 19:00",307,261,13,6,568,"neutor",NA
"10/8/2015 20:00",189,146,13,11,335,"neutor",NA
"10/8/2015 21:00",95,137,13,9,232,"neutor",NA
"10/8/2015 22:00",92,145,13,7,237,"neutor",NA
"10/8/2015 23:00",71,134,12,6,205,"neutor",NA
"10/9/2015 0:00",41,125,12,4,166,"neutor",NA
"10/9/2015 1:00",10,95,12,7,105,"neutor",NA
"10/9/2015 2:00",8,38,12,9,46,"neutor",NA
"10/9/2015 3:00",9,19,12,6,28,"neutor",NA
"10/9/2015 4:00",15,14,12,4,29,"neutor",NA
"10/9/2015 5:00",30,13,12,6,43,"neutor",NA
"10/9/2015 6:00",83,33,12,6,116,"neutor",NA
"10/9/2015 7:00",222,148,12,9,370,"neutor",NA
"10/9/2015 8:00",330,232,12,7,562,"neutor",NA
"10/9/2015 9:00",266,209,12,6,475,"neutor",NA
"10/9/2015 10:00",205,130,13,9,335,"neutor",NA
"10/9/2015 11:00",244,168,14,11,412,"neutor",NA
"10/9/2015 12:00",323,246,14,11,569,"neutor",NA
"10/9/2015 13:00",302,281,14,13,583,"neutor",NA
"10/9/2015 14:00",344,255,14,13,599,"neutor",NA
"10/9/2015 15:00",308,277,15,13,585,"neutor",NA
"10/9/2015 16:00",293,260,15,11,553,"neutor",NA
"10/9/2015 17:00",336,298,14,11,634,"neutor",NA
"10/9/2015 18:00",246,324,14,9,570,"neutor",NA
"10/9/2015 19:00",259,233,14,11,492,"neutor",NA
"10/9/2015 20:00",171,157,13,4,328,"neutor",NA
"10/9/2015 21:00",162,158,13,6,320,"neutor",NA
"10/9/2015 22:00",108,154,13,7,262,"neutor",NA
"10/9/2015 23:00",98,124,12,7,222,"neutor",NA
"10/10/2015 0:00",89,111,12,9,200,"neutor",NA
"10/10/2015 1:00",68,100,11,11,168,"neutor",NA
"10/10/2015 2:00",27,86,11,7,113,"neutor",NA
"10/10/2015 3:00",45,73,11,4,118,"neutor",NA
"10/10/2015 4:00",11,33,10,7,44,"neutor",NA
"10/10/2015 5:00",27,34,10,7,61,"neutor",NA
"10/10/2015 6:00",25,32,10,7,57,"neutor",NA
"10/10/2015 7:00",41,31,9,11,72,"neutor",NA
"10/10/2015 8:00",97,59,9,9,156,"neutor",NA
"10/10/2015 9:00",221,68,8,15,289,"neutor",NA
"10/10/2015 10:00",285,111,10,13,396,"neutor",NA
"10/10/2015 11:00",292,154,11,13,446,"neutor",NA
"10/10/2015 12:00",353,185,12,13,538,"neutor",NA
"10/10/2015 13:00",297,224,13,11,521,"neutor",NA
"10/10/2015 14:00",329,260,13,19,589,"neutor",NA
"10/10/2015 15:00",285,285,13,17,570,"neutor",NA
"10/10/2015 16:00",284,318,12,19,602,"neutor",NA
"10/10/2015 17:00",199,292,11,9,491,"neutor",NA
"10/10/2015 18:00",198,318,9,9,516,"neutor",NA
"10/10/2015 19:00",233,260,8,9,493,"neutor",NA
"10/10/2015 20:00",211,162,8,9,373,"neutor",NA
"10/10/2015 21:00",164,107,7,9,271,"neutor",NA
"10/10/2015 22:00",135,93,7,9,228,"neutor",NA
"10/10/2015 23:00",102,106,6,9,208,"neutor",NA
"10/11/2015 0:00",95,121,5,6,216,"neutor",NA
"10/11/2015 1:00",46,106,4,7,152,"neutor",NA
"10/11/2015 2:00",40,108,4,7,148,"neutor",NA
"10/11/2015 3:00",22,87,4,11,109,"neutor",NA
"10/11/2015 4:00",14,68,3,11,82,"neutor",NA
"10/11/2015 5:00",11,40,3,9,51,"neutor",NA
"10/11/2015 6:00",17,23,3,11,40,"neutor",NA
"10/11/2015 7:00",12,14,2,11,26,"neutor",NA
"10/11/2015 8:00",45,18,3,13,63,"neutor",NA
"10/11/2015 9:00",122,37,4,13,159,"neutor",NA
"10/11/2015 10:00",137,78,6,13,215,"neutor",NA
"10/11/2015 11:00",152,95,8,11,247,"neutor",NA
"10/11/2015 12:00",169,102,9,17,271,"neutor",NA
"10/11/2015 13:00",221,186,10,13,407,"neutor",NA
"10/11/2015 14:00",247,292,10,17,539,"neutor",NA
"10/11/2015 15:00",264,214,10,13,478,"neutor",NA
"10/11/2015 16:00",209,214,10,13,423,"neutor",NA
"10/11/2015 17:00",196,241,9,15,437,"neutor",NA
"10/11/2015 18:00",233,225,7,7,458,"neutor",NA
"10/11/2015 19:00",172,169,7,9,341,"neutor",NA
"10/11/2015 20:00",116,173,6,9,289,"neutor",NA
"10/11/2015 21:00",50,89,6,11,139,"neutor",NA
"10/11/2015 22:00",46,150,5,13,196,"neutor",NA
"10/11/2015 23:00",43,66,5,9,109,"neutor",NA
"10/12/2015 0:00",17,33,5,9,50,"neutor",NA
"10/12/2015 1:00",8,21,4,7,29,"neutor",NA
"10/12/2015 2:00",6,7,4,9,13,"neutor",NA
"10/12/2015 3:00",3,2,3,7,5,"neutor",NA
"10/12/2015 4:00",6,7,3,9,13,"neutor",NA
"10/12/2015 5:00",29,12,2,9,41,"neutor",NA
"10/12/2015 6:00",83,44,2,9,127,"neutor",NA
"10/12/2015 7:00",306,168,2,9,474,"neutor",NA
"10/12/2015 8:00",481,302,3,9,783,"neutor",NA
"10/12/2015 9:00",528,388,4,11,916,"neutor",NA
"10/12/2015 10:00",399,253,6,15,652,"neutor",NA
"10/12/2015 11:00",332,254,7,13,586,"neutor",NA
"10/12/2015 12:00",426,307,8,9,733,"neutor",NA
"10/12/2015 13:00",403,410,8,13,813,"neutor",NA
"10/12/2015 14:00",491,362,9,9,853,"neutor",NA
"10/12/2015 15:00",471,464,9,11,935,"neutor",NA
"10/12/2015 16:00",480,515,8,11,995,"neutor",NA
"10/12/2015 17:00",561,559,7,9,1120,"neutor",NA
"10/12/2015 18:00",484,461,7,7,945,"neutor",NA
"10/12/2015 19:00",516,333,6,6,849,"neutor",NA
"10/12/2015 20:00",305,244,5,9,549,"neutor",NA
"10/12/2015 21:00",164,174,4,9,338,"neutor",NA
"10/12/2015 22:00",118,171,4,7,289,"neutor",NA
"10/12/2015 23:00",88,192,4,7,280,"neutor",NA
"10/13/2015 0:00",73,165,3,7,238,"neutor",NA
"10/13/2015 1:00",67,149,2,6,216,"neutor",NA
"10/13/2015 2:00",22,93,2,7,115,"neutor",NA
"10/13/2015 3:00",10,56,2,11,66,"neutor",NA
"10/13/2015 4:00",6,37,2,11,43,"neutor",NA
"10/13/2015 5:00",39,14,2,11,53,"neutor",NA
"10/13/2015 6:00",101,44,1,11,145,"neutor",NA
"10/13/2015 7:00",286,232,1,13,518,"neutor",NA
"10/13/2015 8:00",406,348,2,11,754,"neutor",NA
"10/13/2015 9:00",426,288,3,17,714,"neutor",NA
"10/13/2015 10:00",414,242,4,17,656,"neutor",NA
"10/13/2015 11:00",451,295,4,13,746,"neutor",NA
"10/13/2015 12:00",471,348,4,15,819,"neutor",NA
"10/13/2015 13:00",422,307,5,19,729,"neutor",NA
"10/13/2015 14:00",470,390,5,19,860,"neutor",NA
"10/13/2015 15:00",423,380,5,13,803,"neutor",NA
"10/13/2015 16:00",472,474,4,19,946,"neutor",NA
"10/13/2015 17:00",542,584,5,15,1126,"neutor",NA
"10/13/2015 18:00",505,407,5,15,912,"neutor",NA
"10/13/2015 19:00",496,332,4,13,828,"neutor",NA
"10/13/2015 20:00",322,304,5,7,626,"neutor",NA
"10/13/2015 21:00",156,253,4,7,409,"neutor",NA
"10/13/2015 22:00",116,367,4,6,483,"neutor",NA
"10/13/2015 23:00",100,305,4,2,405,"neutor",NA
"10/14/2015 0:00",130,186,4,4,316,"neutor",NA
"10/14/2015 1:00",89,125,4,4,214,"neutor",NA
"10/14/2015 2:00",151,76,4,9,227,"neutor",NA
"10/14/2015 3:00",151,52,4,6,203,"neutor",NA
"10/14/2015 4:00",78,48,4,2,126,"neutor",NA
"10/14/2015 5:00",41,30,4,2,71,"neutor",NA
"10/14/2015 6:00",96,34,4,4,130,"neutor",NA
"10/14/2015 7:00",182,155,3,2,337,"neutor",NA
"10/14/2015 8:00",277,207,3,6,484,"neutor",NA
"10/14/2015 9:00",248,161,2,7,409,"neutor",NA
"10/14/2015 10:00",169,127,3,7,296,"neutor",NA
"10/14/2015 11:00",241,157,4,6,398,"neutor",NA
"10/14/2015 12:00",265,192,4,9,457,"neutor",NA
"10/14/2015 13:00",283,263,4,9,546,"neutor",NA
"10/14/2015 14:00",239,294,4,9,533,"neutor",NA
"10/14/2015 15:00",252,253,4,9,505,"neutor",NA
"10/14/2015 16:00",349,272,4,9,621,"neutor",NA
"10/14/2015 17:00",395,347,4,9,742,"neutor",NA
"10/14/2015 18:00",381,334,4,6,715,"neutor",NA
"10/14/2015 19:00",340,265,4,9,605,"neutor",NA
"10/14/2015 20:00",295,208,4,7,503,"neutor",NA
"10/14/2015 21:00",174,141,4,7,315,"neutor",NA
"10/14/2015 22:00",148,126,4,7,274,"neutor",NA
"10/14/2015 23:00",133,115,4,7,248,"neutor",NA
"10/15/2015 0:00",155,108,4,4,263,"neutor",NA
"10/15/2015 1:00",66,118,4,4,184,"neutor",NA
"10/15/2015 2:00",18,112,4,4,130,"neutor",NA
"10/15/2015 3:00",15,119,4,4,134,"neutor",NA
"10/15/2015 4:00",21,82,4,6,103,"neutor",NA
"10/15/2015 5:00",41,50,5,7,91,"neutor",NA
"10/15/2015 6:00",78,37,5,9,115,"neutor",NA
"10/15/2015 7:00",254,161,5,7,415,"neutor",NA
"10/15/2015 8:00",373,239,5,9,612,"neutor",NA
"10/15/2015 9:00",360,210,6,9,570,"neutor",NA
"10/15/2015 10:00",197,172,6,9,369,"neutor",NA
"10/15/2015 11:00",260,197,6,11,457,"neutor",NA
"10/15/2015 12:00",266,244,7,15,510,"neutor",NA
"10/15/2015 13:00",263,225,7,11,488,"neutor",NA
"10/15/2015 14:00",241,225,7,13,466,"neutor",NA
"10/15/2015 15:00",264,263,7,11,527,"neutor",NA
"10/15/2015 16:00",345,311,7,7,656,"neutor",NA
"10/15/2015 17:00",391,338,7,9,729,"neutor",NA
"10/15/2015 18:00",372,362,7,6,734,"neutor",NA
"10/15/2015 19:00",371,223,7,9,594,"neutor",NA
"10/15/2015 20:00",277,197,7,7,474,"neutor",NA
"10/15/2015 21:00",144,127,7,2,271,"neutor",NA
"10/15/2015 22:00",155,143,7,4,298,"neutor",NA
"10/15/2015 23:00",65,133,7,7,198,"neutor",NA
"10/16/2015 0:00",63,109,6,7,172,"neutor",NA
"10/16/2015 1:00",30,99,6,4,129,"neutor",NA
"10/16/2015 2:00",19,90,6,4,109,"neutor",NA
"10/16/2015 3:00",18,90,6,6,108,"neutor",NA
"10/16/2015 4:00",22,91,6,4,113,"neutor",NA
"10/16/2015 5:00",39,41,6,4,80,"neutor",NA
"10/16/2015 6:00",73,32,6,6,105,"neutor",NA
"10/16/2015 7:00",222,133,6,2,355,"neutor",NA
"10/16/2015 8:00",334,242,6,4,576,"neutor",NA
"10/16/2015 9:00",316,202,7,2,518,"neutor",NA
"10/16/2015 10:00",259,173,7,0,432,"neutor",NA
"10/16/2015 11:00",352,189,7,6,541,"neutor",NA
"10/16/2015 12:00",324,234,7,7,558,"neutor",NA
"10/16/2015 13:00",251,265,7,7,516,"neutor",NA
"10/16/2015 14:00",238,215,7,7,453,"neutor",NA
"10/16/2015 15:00",255,190,7,6,445,"neutor",NA
"10/16/2015 16:00",286,212,7,7,498,"neutor",NA
"10/16/2015 17:00",243,216,7,6,459,"neutor",NA
"10/16/2015 18:00",212,182,7,6,394,"neutor",NA
"10/16/2015 19:00",188,164,7,7,352,"neutor",NA
"10/16/2015 20:00",158,98,7,6,256,"neutor",NA
"10/16/2015 21:00",107,123,7,7,230,"neutor",NA
"10/16/2015 22:00",82,84,7,7,166,"neutor",NA
"10/16/2015 23:00",67,68,7,6,135,"neutor",NA
"10/17/2015 0:00",60,64,6,6,124,"neutor",NA
"10/17/2015 1:00",36,64,6,6,100,"neutor",NA
"10/17/2015 2:00",34,68,6,4,102,"neutor",NA
"10/17/2015 3:00",13,67,6,4,80,"neutor",NA
"10/17/2015 4:00",12,34,5,7,46,"neutor",NA
"10/17/2015 5:00",23,38,6,6,61,"neutor",NA
"10/17/2015 6:00",35,16,6,4,51,"neutor",NA
"10/17/2015 7:00",38,14,6,6,52,"neutor",NA
"10/17/2015 8:00",89,48,6,7,137,"neutor",NA
"10/17/2015 9:00",192,60,7,9,252,"neutor",NA
"10/17/2015 10:00",245,85,7,7,330,"neutor",NA
"10/17/2015 11:00",248,101,7,9,349,"neutor",NA
"10/17/2015 12:00",285,150,8,7,435,"neutor",NA
"10/17/2015 13:00",236,173,8,9,409,"neutor",NA
"10/17/2015 14:00",191,192,8,6,383,"neutor",NA
"10/17/2015 15:00",139,181,8,6,320,"neutor",NA
"10/17/2015 16:00",197,167,8,2,364,"neutor",NA
"10/17/2015 17:00",210,188,8,2,398,"neutor",NA
"10/17/2015 18:00",178,212,8,2,390,"neutor",NA
"10/17/2015 19:00",194,163,7,4,357,"neutor",NA
"10/17/2015 20:00",193,180,7,4,373,"neutor",NA
"10/17/2015 21:00",139,116,7,4,255,"neutor",NA
"10/17/2015 22:00",94,110,7,4,204,"neutor",NA
"10/17/2015 23:00",119,105,7,2,224,"neutor",NA
"10/18/2015 0:00",114,101,7,2,215,"neutor",NA
"10/18/2015 1:00",61,117,6,4,178,"neutor",NA
"10/18/2015 2:00",70,95,4,2,165,"neutor",NA
"10/18/2015 3:00",41,87,4,4,128,"neutor",NA
"10/18/2015 4:00",36,43,4,4,79,"neutor",NA
"10/18/2015 5:00",15,30,4,2,45,"neutor",NA
"10/18/2015 6:00",22,19,4,0,41,"neutor",NA
"10/18/2015 7:00",18,9,4,4,27,"neutor",NA
"10/18/2015 8:00",41,14,5,2,55,"neutor",NA
"10/18/2015 9:00",98,44,5,4,142,"neutor",NA
"10/18/2015 10:00",120,51,6,4,171,"neutor",NA
"10/18/2015 11:00",133,73,7,7,206,"neutor",NA
"10/18/2015 12:00",142,110,7,9,252,"neutor",NA
"10/18/2015 13:00",160,102,7,7,262,"neutor",NA
"10/18/2015 14:00",178,105,8,9,283,"neutor",NA
"10/18/2015 15:00",182,127,8,9,309,"neutor",NA
"10/18/2015 16:00",147,140,8,9,287,"neutor",NA
"10/18/2015 17:00",162,180,7,7,342,"neutor",NA
"10/18/2015 18:00",163,173,7,6,336,"neutor",NA
"10/18/2015 19:00",131,154,7,7,285,"neutor",NA
"10/18/2015 20:00",91,137,7,4,228,"neutor",NA
"10/18/2015 21:00",38,105,7,4,143,"neutor",NA
"10/18/2015 22:00",62,121,7,6,183,"neutor",NA
"10/18/2015 23:00",30,45,7,4,75,"neutor",NA
"10/19/2015 0:00",12,18,7,4,30,"neutor",NA
"10/19/2015 1:00",13,10,7,2,23,"neutor",NA
"10/19/2015 2:00",9,2,7,0,11,"neutor",NA
"10/19/2015 3:00",6,0,7,2,6,"neutor",NA
"10/19/2015 4:00",13,3,7,2,16,"neutor",NA
"10/19/2015 5:00",41,17,7,4,58,"neutor",NA
"10/19/2015 6:00",110,38,7,4,148,"neutor",NA
"10/19/2015 7:00",705,282,7,2,987,"neutor",NA
"10/19/2015 8:00",590,429,7,2,1019,"neutor",NA
"10/19/2015 9:00",690,473,8,4,1163,"neutor",NA
"10/19/2015 10:00",531,357,8,6,888,"neutor",NA
"10/19/2015 11:00",560,472,9,6,1032,"neutor",NA
"10/19/2015 12:00",585,482,9,4,1067,"neutor",NA
"10/19/2015 13:00",690,668,10,6,1358,"neutor",NA
"10/19/2015 14:00",600,598,11,4,1198,"neutor",NA
"10/19/2015 15:00",830,701,11,6,1531,"neutor",NA
"10/19/2015 16:00",692,541,12,6,1233,"neutor",NA
"10/19/2015 17:00",852,877,11,6,1729,"neutor",NA
"10/19/2015 18:00",549,658,10,4,1207,"neutor",NA
"10/19/2015 19:00",564,446,9,0,1010,"neutor",NA
"10/19/2015 20:00",272,300,7,2,572,"neutor",NA
"10/19/2015 21:00",180,255,6,2,435,"neutor",NA
"10/19/2015 22:00",114,246,6,2,360,"neutor",NA
"10/19/2015 23:00",72,142,6,2,214,"neutor",NA
"10/20/2015 0:00",48,73,6,2,121,"neutor",NA
"10/20/2015 1:00",24,60,6,4,84,"neutor",NA
"10/20/2015 2:00",10,13,6,4,23,"neutor",NA
"10/20/2015 3:00",3,4,6,2,7,"neutor",NA
"10/20/2015 4:00",13,1,7,4,14,"neutor",NA
"10/20/2015 5:00",43,20,7,4,63,"neutor",NA
"10/20/2015 6:00",112,42,7,4,154,"neutor",NA
"10/20/2015 7:00",670,504,7,4,1174,"neutor",NA
"10/20/2015 8:00",723,533,7,4,1256,"neutor",NA
"10/20/2015 9:00",676,607,7,7,1283,"neutor",NA
"10/20/2015 10:00",579,457,7,7,1036,"neutor",NA
"10/20/2015 11:00",765,551,8,4,1316,"neutor",NA
"10/20/2015 12:00",696,439,8,2,1135,"neutor",NA
"10/20/2015 13:00",760,710,9,6,1470,"neutor",NA
"10/20/2015 14:00",624,532,10,6,1156,"neutor",NA
"10/20/2015 15:00",849,660,10,11,1509,"neutor",NA
"10/20/2015 16:00",744,653,10,7,1397,"neutor",NA
"10/20/2015 17:00",748,799,9,4,1547,"neutor",NA
"10/20/2015 18:00",608,592,9,2,1200,"neutor",NA
"10/20/2015 19:00",515,539,8,2,1054,"neutor",NA
"10/20/2015 20:00",451,354,8,4,805,"neutor",NA
"10/20/2015 21:00",292,253,8,2,545,"neutor",NA
"10/20/2015 22:00",185,304,8,2,489,"neutor",NA
"10/20/2015 23:00",102,198,9,6,300,"neutor",NA
"10/21/2015 0:00",137,107,8,2,244,"neutor",NA
"10/21/2015 1:00",41,68,9,2,109,"neutor",NA
"10/21/2015 2:00",14,60,9,2,74,"neutor",NA
"10/21/2015 3:00",11,95,9,2,106,"neutor",NA
"10/21/2015 4:00",20,84,9,6,104,"neutor",NA
"10/21/2015 5:00",45,28,9,4,73,"neutor",NA
"10/21/2015 6:00",131,47,9,6,178,"neutor",NA
"10/21/2015 7:00",659,367,9,6,1026,"neutor",NA
"10/21/2015 8:00",693,477,8,6,1170,"neutor",NA
"10/21/2015 9:00",809,525,9,9,1334,"neutor",NA
"10/21/2015 10:00",610,337,10,11,947,"neutor",NA
"10/21/2015 11:00",665,671,10,13,1336,"neutor",NA
"10/21/2015 12:00",658,472,11,17,1130,"neutor",NA
"10/21/2015 13:00",1112,623,11,15,1735,"neutor",NA
"10/21/2015 14:00",618,515,12,15,1133,"neutor",NA
"10/21/2015 15:00",607,842,12,20,1449,"neutor",NA
"10/21/2015 16:00",660,649,12,13,1309,"neutor",NA
"10/21/2015 17:00",769,830,12,11,1599,"neutor",NA
"10/21/2015 18:00",614,646,11,9,1260,"neutor",NA
"10/21/2015 19:00",645,535,11,11,1180,"neutor",NA
"10/21/2015 20:00",417,318,11,9,735,"neutor",NA
"10/21/2015 21:00",270,273,11,11,543,"neutor",NA
"10/21/2015 22:00",355,260,11,17,615,"neutor",NA
"10/21/2015 23:00",227,234,11,19,461,"neutor",NA
"10/22/2015 0:00",259,195,10,13,454,"neutor",NA
"10/22/2015 1:00",78,220,10,17,298,"neutor",NA
"10/22/2015 2:00",39,203,10,15,242,"neutor",NA
"10/22/2015 3:00",18,194,10,13,212,"neutor",NA
"10/22/2015 4:00",26,93,10,15,119,"neutor",NA
"10/22/2015 5:00",49,50,10,15,99,"neutor",NA
"10/22/2015 6:00",118,59,10,15,177,"neutor",NA
"10/22/2015 7:00",554,440,10,17,994,"neutor",NA
"10/22/2015 8:00",559,440,10,15,999,"neutor",NA
"10/22/2015 9:00",672,405,10,13,1077,"neutor",NA
"10/22/2015 10:00",574,319,11,15,893,"neutor",NA
"10/22/2015 11:00",636,589,11,15,1225,"neutor",NA
"10/22/2015 12:00",502,438,12,15,940,"neutor",NA
"10/22/2015 13:00",640,562,12,15,1202,"neutor",NA
"10/22/2015 14:00",542,490,12,15,1032,"neutor",NA
"10/22/2015 15:00",650,643,13,17,1293,"neutor",NA
"10/22/2015 16:00",572,572,13,13,1144,"neutor",NA
"10/22/2015 17:00",595,570,13,15,1165,"neutor",NA
"10/22/2015 18:00",451,435,12,17,886,"neutor",NA
"10/22/2015 19:00",390,396,12,11,786,"neutor",NA
"10/22/2015 20:00",229,277,12,17,506,"neutor",NA
"10/22/2015 21:00",165,203,11,11,368,"neutor",NA
"10/22/2015 22:00",147,185,11,13,332,"neutor",NA
"10/22/2015 23:00",65,158,11,9,223,"neutor",NA
"10/23/2015 0:00",36,98,10,9,134,"neutor",NA
"10/23/2015 1:00",41,72,10,9,113,"neutor",NA
"10/23/2015 2:00",21,43,8,9,64,"neutor",NA
"10/23/2015 3:00",13,26,6,7,39,"neutor",NA
"10/23/2015 4:00",9,16,6,6,25,"neutor",NA
"10/23/2015 5:00",31,11,6,2,42,"neutor",NA
"10/23/2015 6:00",105,42,7,2,147,"neutor",NA
"10/23/2015 7:00",638,395,7,4,1033,"neutor",NA
"10/23/2015 8:00",534,412,7,2,946,"neutor",NA
"10/23/2015 9:00",652,458,8,4,1110,"neutor",NA
"10/23/2015 10:00",648,327,11,6,975,"neutor",NA
"10/23/2015 11:00",482,445,13,13,927,"neutor",NA
"10/23/2015 12:00",576,444,14,17,1020,"neutor",NA
"10/23/2015 13:00",589,626,14,20,1215,"neutor",NA
"10/23/2015 14:00",535,478,15,17,1013,"neutor",NA
"10/23/2015 15:00",501,439,14,9,940,"neutor",NA
"10/23/2015 16:00",483,489,14,6,972,"neutor",NA
"10/23/2015 17:00",494,444,11,4,938,"neutor",NA
"10/23/2015 18:00",437,425,9,4,862,"neutor",NA
"10/23/2015 19:00",392,372,8,2,764,"neutor",NA
"10/23/2015 20:00",339,262,8,2,601,"neutor",NA
"10/23/2015 21:00",205,221,10,7,426,"neutor",NA
"10/23/2015 22:00",182,219,10,6,401,"neutor",NA
"10/23/2015 23:00",154,240,10,7,394,"neutor",NA
"10/24/2015 0:00",108,191,10,6,299,"neutor",NA
"10/24/2015 1:00",111,204,10,6,315,"neutor",NA
"10/24/2015 2:00",64,191,9,6,255,"neutor",NA
"10/24/2015 3:00",61,87,9,6,148,"neutor",NA
"10/24/2015 4:00",37,69,9,6,106,"neutor",NA
"10/24/2015 5:00",44,60,9,7,104,"neutor",NA
"10/24/2015 6:00",38,13,9,9,51,"neutor",NA
"10/24/2015 7:00",76,32,9,7,108,"neutor",NA
"10/24/2015 8:00",141,101,9,7,242,"neutor",NA
"10/24/2015 9:00",278,85,10,7,363,"neutor",NA
"10/24/2015 10:00",319,138,11,11,457,"neutor",NA
"10/24/2015 11:00",369,215,12,11,584,"neutor",NA
"10/24/2015 12:00",413,277,12,11,690,"neutor",NA
"10/24/2015 13:00",441,297,13,13,738,"neutor",NA
"10/24/2015 14:00",393,374,13,13,767,"neutor",NA
"10/24/2015 15:00",393,323,13,9,716,"neutor",NA
"10/24/2015 16:00",381,280,13,7,661,"neutor",NA
"10/24/2015 17:00",337,360,12,7,697,"neutor",NA
"10/24/2015 18:00",329,339,11,7,668,"neutor",NA
"10/24/2015 19:00",370,305,10,7,675,"neutor",NA
"10/24/2015 20:00",283,262,10,7,545,"neutor",NA
"10/24/2015 21:00",240,171,9,6,411,"neutor",NA
"10/24/2015 22:00",152,198,10,6,350,"neutor",NA
"10/24/2015 23:00",134,159,10,6,293,"neutor",NA
"10/25/2015 0:00",123,179,10,6,302,"neutor",NA
"10/25/2015 1:00",88,144,9,6,232,"neutor",NA
"10/25/2015 2:00",95,243,10,6,338,"neutor",NA
"10/25/2015 3:00",13,76,10,6,89,"neutor",NA
"10/25/2015 4:00",5,60,10,4,65,"neutor",NA
"10/25/2015 5:00",17,28,10,2,45,"neutor",NA
"10/25/2015 6:00",21,16,10,6,37,"neutor",NA
"10/25/2015 7:00",31,20,10,7,51,"neutor",NA
"10/25/2015 8:00",50,31,11,7,81,"neutor",NA
"10/25/2015 9:00",125,44,11,6,169,"neutor",NA
"10/25/2015 10:00",202,97,12,7,299,"neutor",NA
"10/25/2015 11:00",189,131,13,7,320,"neutor",NA
"10/25/2015 12:00",260,167,14,11,427,"neutor",NA
"10/25/2015 13:00",337,247,13,11,584,"neutor",NA
"10/25/2015 14:00",392,263,14,6,655,"neutor",NA
"10/25/2015 15:00",464,345,13,7,809,"neutor",NA
"10/25/2015 16:00",417,373,11,4,790,"neutor",NA
"10/25/2015 17:00",338,406,9,0,744,"neutor",NA
"10/25/2015 18:00",337,240,7,2,577,"neutor",NA
"10/25/2015 19:00",226,297,6,0,523,"neutor",NA
"10/25/2015 20:00",122,169,6,4,291,"neutor",NA
"10/25/2015 21:00",75,192,5,2,267,"neutor",NA
"10/25/2015 22:00",75,166,6,6,241,"neutor",NA
"10/25/2015 23:00",35,61,NA,NA,96,"neutor",NA
"10/26/2015 0:00",13,26,7,2,39,"neutor",NA
"10/26/2015 1:00",0,8,7,6,8,"neutor",NA
"10/26/2015 2:00",4,3,8,6,7,"neutor",NA
"10/26/2015 3:00",3,2,6,2,5,"neutor",NA
"10/26/2015 4:00",12,6,6,4,18,"neutor",NA
"10/26/2015 5:00",40,9,8,6,49,"neutor",NA
"10/26/2015 6:00",130,49,8,7,179,"neutor",NA
"10/26/2015 7:00",711,412,8,9,1123,"neutor",NA
"10/26/2015 8:00",741,459,9,7,1200,"neutor",NA
"10/26/2015 9:00",774,550,10,6,1324,"neutor",NA
"10/26/2015 10:00",646,389,11,11,1035,"neutor",NA
"10/26/2015 11:00",627,727,13,11,1354,"neutor",NA
"10/26/2015 12:00",704,657,13,11,1361,"neutor",NA
"10/26/2015 13:00",950,865,13,9,1815,"neutor",NA
"10/26/2015 14:00",718,609,13,7,1327,"neutor",NA
"10/26/2015 15:00",939,822,13,11,1761,"neutor",NA
"10/26/2015 16:00",895,711,13,9,1606,"neutor",NA
"10/26/2015 17:00",981,1004,12,7,1985,"neutor",NA
"10/26/2015 18:00",865,686,11,7,1551,"neutor",NA
"10/26/2015 19:00",746,657,11,7,1403,"neutor",NA
"10/26/2015 20:00",393,370,10,7,763,"neutor",NA
"10/26/2015 21:00",299,343,10,9,642,"neutor",NA
"10/26/2015 22:00",169,268,9,9,437,"neutor",NA
"10/26/2015 23:00",79,198,9,7,277,"neutor",NA
"10/27/2015 0:00",40,161,9,7,201,"neutor",NA
"10/27/2015 1:00",13,127,8,4,140,"neutor",NA
"10/27/2015 2:00",3,70,8,6,73,"neutor",NA
"10/27/2015 3:00",5,20,8,6,25,"neutor",NA
"10/27/2015 4:00",16,13,8,6,29,"neutor",NA
"10/27/2015 5:00",39,10,8,6,49,"neutor",NA
"10/27/2015 6:00",123,47,7,4,170,"neutor",NA
"10/27/2015 7:00",678,561,7,6,1239,"neutor",NA
"10/27/2015 8:00",937,615,9,7,1552,"neutor",NA
"10/27/2015 9:00",801,748,10,7,1549,"neutor",NA
"10/27/2015 10:00",770,456,12,7,1226,"neutor",NA
"10/27/2015 11:00",760,701,13,7,1461,"neutor",NA
"10/27/2015 12:00",742,601,15,9,1343,"neutor",NA
"10/27/2015 13:00",883,828,15,7,1711,"neutor",NA
"10/27/2015 14:00",725,668,15,7,1393,"neutor",NA
"10/27/2015 15:00",1013,897,15,6,1910,"neutor",NA
"10/27/2015 16:00",873,726,14,6,1599,"neutor",NA
"10/27/2015 17:00",982,988,11,6,1970,"neutor",NA
"10/27/2015 18:00",740,723,10,6,1463,"neutor",NA
"10/27/2015 19:00",733,685,10,4,1418,"neutor",NA
"10/27/2015 20:00",442,453,9,4,895,"neutor",NA
"10/27/2015 21:00",299,343,10,7,642,"neutor",NA
"10/27/2015 22:00",223,351,9,4,574,"neutor",NA
"10/27/2015 23:00",115,223,8,4,338,"neutor",NA
"10/28/2015 0:00",78,107,8,4,185,"neutor",NA
"10/28/2015 1:00",17,75,8,4,92,"neutor",NA
"10/28/2015 2:00",18,46,6,2,64,"neutor",NA
"10/28/2015 3:00",8,57,5,4,65,"neutor",NA
"10/28/2015 4:00",14,11,6,2,25,"neutor",NA
"10/28/2015 5:00",39,10,7,4,49,"neutor",NA
"10/28/2015 6:00",148,48,7,9,196,"neutor",NA
"10/28/2015 7:00",791,467,7,6,1258,"neutor",NA
"10/28/2015 8:00",808,567,8,4,1375,"neutor",NA
"10/28/2015 9:00",804,652,9,7,1456,"neutor",NA
"10/28/2015 10:00",749,480,10,7,1229,"neutor",NA
"10/28/2015 11:00",722,660,12,6,1382,"neutor",NA
"10/28/2015 12:00",802,507,13,7,1309,"neutor",NA
"10/28/2015 13:00",911,701,13,9,1612,"neutor",NA
"10/28/2015 14:00",769,569,13,7,1338,"neutor",NA
"10/28/2015 15:00",761,756,13,4,1517,"neutor",NA
"10/28/2015 16:00",771,695,12,4,1466,"neutor",NA
"10/28/2015 17:00",891,912,12,4,1803,"neutor",NA
"10/28/2015 18:00",878,635,11,6,1513,"neutor",NA
"10/28/2015 19:00",943,643,10,4,1586,"neutor",NA
"10/28/2015 20:00",517,468,10,4,985,"neutor",NA
"10/28/2015 21:00",319,423,9,4,742,"neutor",NA
"10/28/2015 22:00",247,451,9,4,698,"neutor",NA
"10/28/2015 23:00",157,276,8,6,433,"neutor",NA
"10/29/2015 0:00",92,171,8,4,263,"neutor",NA
"10/29/2015 1:00",56,101,9,6,157,"neutor",NA
"10/29/2015 2:00",18,78,9,4,96,"neutor",NA
"10/29/2015 3:00",20,42,9,2,62,"neutor",NA
"10/29/2015 4:00",19,32,10,4,51,"neutor",NA
"10/29/2015 5:00",46,27,10,4,73,"neutor",NA
"10/29/2015 6:00",115,39,10,6,154,"neutor",NA
"10/29/2015 7:00",611,471,10,4,1082,"neutor",NA
"10/29/2015 8:00",760,601,11,4,1361,"neutor",NA
"10/29/2015 9:00",699,622,12,7,1321,"neutor",NA
"10/29/2015 10:00",736,428,13,9,1164,"neutor",NA
"10/29/2015 11:00",680,717,13,13,1397,"neutor",NA
"10/29/2015 12:00",695,527,14,9,1222,"neutor",NA
"10/29/2015 13:00",748,666,14,11,1414,"neutor",NA
"10/29/2015 14:00",631,540,14,9,1171,"neutor",NA
"10/29/2015 15:00",825,746,15,2,1571,"neutor",NA
"10/29/2015 16:00",815,705,12,4,1520,"neutor",NA
"10/29/2015 17:00",947,762,12,2,1709,"neutor",NA
"10/29/2015 18:00",705,593,12,4,1298,"neutor",NA
"10/29/2015 19:00",546,713,12,6,1259,"neutor",NA
"10/29/2015 20:00",365,367,9,2,732,"neutor",NA
"10/29/2015 21:00",357,304,8,2,661,"neutor",NA
"10/29/2015 22:00",215,311,8,2,526,"neutor",NA
"10/29/2015 23:00",201,222,8,6,423,"neutor",NA
"10/30/2015 0:00",178,112,7,2,290,"neutor",NA
"10/30/2015 1:00",43,102,8,4,145,"neutor",NA
"10/30/2015 2:00",11,108,8,6,119,"neutor",NA
"10/30/2015 3:00",12,83,7,4,95,"neutor",NA
"10/30/2015 4:00",12,48,6,2,60,"neutor",NA
"10/30/2015 5:00",38,20,5,2,58,"neutor",NA
"10/30/2015 6:00",117,44,4,2,161,"neutor",NA
"10/30/2015 7:00",605,471,5,6,1076,"neutor",NA
"10/30/2015 8:00",578,522,8,11,1100,"neutor",NA
"10/30/2015 9:00",668,463,9,7,1131,"neutor",NA
"10/30/2015 10:00",662,346,10,6,1008,"neutor",NA
"10/30/2015 11:00",611,582,11,6,1193,"neutor",NA
"10/30/2015 12:00",628,447,13,6,1075,"neutor",NA
"10/30/2015 13:00",693,592,14,7,1285,"neutor",NA
"10/30/2015 14:00",627,525,15,6,1152,"neutor",NA
"10/30/2015 15:00",668,568,14,4,1236,"neutor",NA
"10/30/2015 16:00",607,483,13,6,1090,"neutor",NA
"10/30/2015 17:00",582,510,12,6,1092,"neutor",NA
"10/30/2015 18:00",512,485,11,7,997,"neutor",NA
"10/30/2015 19:00",577,377,10,4,954,"neutor",NA
"10/30/2015 20:00",628,311,10,6,939,"neutor",NA
"10/30/2015 21:00",275,450,10,9,725,"neutor",NA
"10/30/2015 22:00",183,292,10,4,475,"neutor",NA
"10/30/2015 23:00",140,294,10,6,434,"neutor",NA
"10/31/2015 0:00",109,189,9,7,298,"neutor",NA
"10/31/2015 1:00",74,155,9,9,229,"neutor",NA
"10/31/2015 2:00",50,126,9,11,176,"neutor",NA
"10/31/2015 3:00",26,85,9,9,111,"neutor",NA
"10/31/2015 4:00",22,59,9,9,81,"neutor",NA
"10/31/2015 5:00",25,27,9,7,52,"neutor",NA
"10/31/2015 6:00",32,21,8,6,53,"neutor",NA
"10/31/2015 7:00",94,31,8,7,125,"neutor",NA
"10/31/2015 8:00",145,69,9,9,214,"neutor",NA
"10/31/2015 9:00",278,124,10,11,402,"neutor",NA
"10/31/2015 10:00",360,117,12,13,477,"neutor",NA
"10/31/2015 11:00",439,192,13,13,631,"neutor",NA
"10/31/2015 12:00",599,251,14,11,850,"neutor",NA
"10/31/2015 13:00",484,348,15,7,832,"neutor",NA
"10/31/2015 14:00",443,359,15,9,802,"neutor",NA
"10/31/2015 15:00",397,390,15,6,787,"neutor",NA
"10/31/2015 16:00",339,449,14,4,788,"neutor",NA
"10/31/2015 17:00",354,448,13,7,802,"neutor",NA
"10/31/2015 18:00",301,356,12,7,657,"neutor",NA
"10/31/2015 19:00",295,295,11,9,590,"neutor",NA
"10/31/2015 20:00",330,315,9,6,645,"neutor",NA
"10/31/2015 21:00",281,271,7,0,552,"neutor",NA
"10/31/2015 22:00",169,188,5,0,357,"neutor",NA
"10/31/2015 23:00",180,160,5,2,340,"neutor",NA
"11/1/2015 0:00",195,161,4,2,356,"neutor",NA
"11/1/2015 1:00",145,146,4,2,291,"neutor",NA
"11/1/2015 2:00",118,170,4,2,288,"neutor",NA
"11/1/2015 3:00",93,173,3,0,266,"neutor",NA
"11/1/2015 4:00",41,100,3,2,141,"neutor",NA
"11/1/2015 5:00",18,85,3,2,103,"neutor",NA
"11/1/2015 6:00",20,45,2,2,65,"neutor",NA
"11/1/2015 7:00",28,24,3,7,52,"neutor",NA
"11/1/2015 8:00",38,25,5,9,63,"neutor",NA
"11/1/2015 9:00",94,52,8,4,146,"neutor",NA
"11/1/2015 10:00",165,85,10,7,250,"neutor",NA
"11/1/2015 11:00",180,116,12,6,296,"neutor",NA
"11/1/2015 12:00",223,145,13,2,368,"neutor",NA
"11/1/2015 13:00",334,245,14,4,579,"neutor",NA
"11/1/2015 14:00",382,244,15,4,626,"neutor",NA
"11/1/2015 15:00",363,289,14,4,652,"neutor",NA
"11/1/2015 16:00",271,302,12,4,573,"neutor",NA
"11/1/2015 17:00",365,263,9,2,628,"neutor",NA
"11/1/2015 18:00",335,280,7,2,615,"neutor",NA
"11/1/2015 19:00",230,272,6,4,502,"neutor",NA
"11/1/2015 20:00",138,237,5,0,375,"neutor",NA
"11/1/2015 21:00",98,142,4,2,240,"neutor",NA
"11/1/2015 22:00",70,149,4,4,219,"neutor",NA
"11/1/2015 23:00",38,72,3,2,110,"neutor",NA
"11/2/2015 0:00",19,37,2,2,56,"neutor",NA
"11/2/2015 1:00",9,18,2,0,27,"neutor",NA
"11/2/2015 2:00",3,8,2,4,11,"neutor",NA
"11/2/2015 3:00",5,2,2,0,7,"neutor",NA
"11/2/2015 4:00",7,5,2,0,12,"neutor",NA
"11/2/2015 5:00",35,10,2,2,45,"neutor",NA
"11/2/2015 6:00",113,43,2,2,156,"neutor",NA
"11/2/2015 7:00",596,366,2,2,962,"neutor",NA
"11/2/2015 8:00",729,522,2,0,1251,"neutor",NA
"11/2/2015 9:00",618,615,4,6,1233,"neutor",NA
"11/2/2015 10:00",627,368,6,2,995,"neutor",NA
"11/2/2015 11:00",515,718,8,4,1233,"neutor",NA
"11/2/2015 12:00",582,443,11,2,1025,"neutor",NA
"11/2/2015 13:00",769,730,13,4,1499,"neutor",NA
"11/2/2015 14:00",628,493,14,4,1121,"neutor",NA
"11/2/2015 15:00",902,764,14,2,1666,"neutor",NA
"11/2/2015 16:00",912,634,12,2,1546,"neutor",NA
"11/2/2015 17:00",975,949,8,4,1924,"neutor",NA
"11/2/2015 18:00",762,734,6,2,1496,"neutor",NA
"11/2/2015 19:00",625,595,4,0,1220,"neutor",NA
"11/2/2015 20:00",319,354,4,2,673,"neutor",NA
"11/2/2015 21:00",224,339,2,4,563,"neutor",NA
"11/2/2015 22:00",149,301,2,2,450,"neutor",NA
"11/2/2015 23:00",92,128,2,2,220,"neutor",NA
"11/3/2015 0:00",27,65,1,2,92,"neutor",NA
"11/3/2015 1:00",14,20,0,2,34,"neutor",NA
"11/3/2015 2:00",6,7,1,4,13,"neutor",NA
"11/3/2015 3:00",3,9,0,2,12,"neutor",NA
"11/3/2015 4:00",10,5,1,2,15,"neutor",NA
"11/3/2015 5:00",44,9,2,4,53,"neutor",NA
"11/3/2015 6:00",131,49,1,2,180,"neutor",NA
"11/3/2015 7:00",628,561,1,2,1189,"neutor",NA
"11/3/2015 8:00",928,646,2,0,1574,"neutor",NA
"11/3/2015 9:00",699,723,5,4,1422,"neutor",NA
"11/3/2015 10:00",688,473,8,4,1161,"neutor",NA
"11/3/2015 11:00",621,656,11,6,1277,"neutor",NA
"11/3/2015 12:00",734,530,13,6,1264,"neutor",NA
"11/3/2015 13:00",906,746,14,6,1652,"neutor",NA
"11/3/2015 14:00",673,673,15,4,1346,"neutor",NA
"11/3/2015 15:00",892,814,13,4,1706,"neutor",NA
"11/3/2015 16:00",869,698,10,2,1567,"neutor",NA
"11/3/2015 17:00",902,883,7,2,1785,"neutor",NA
"11/3/2015 18:00",725,626,6,2,1351,"neutor",NA
"11/3/2015 19:00",658,529,5,2,1187,"neutor",NA
"11/3/2015 20:00",384,382,4,2,766,"neutor",NA
"11/3/2015 21:00",226,378,4,2,604,"neutor",NA
"11/3/2015 22:00",165,315,5,2,480,"neutor",NA
"11/3/2015 23:00",71,179,5,2,250,"neutor",NA
"11/4/2015 0:00",47,80,6,6,127,"neutor",NA
"11/4/2015 1:00",33,32,6,6,65,"neutor",NA
"11/4/2015 2:00",5,11,7,4,16,"neutor",NA
"11/4/2015 3:00",8,3,6,7,11,"neutor",NA
"11/4/2015 4:00",15,6,4,4,21,"neutor",NA
"11/4/2015 5:00",43,17,4,6,60,"neutor",NA
"11/4/2015 6:00",148,39,5,6,187,"neutor",NA
"11/4/2015 7:00",698,493,5,7,1191,"neutor",NA
"11/4/2015 8:00",857,631,7,6,1488,"neutor",NA
"11/4/2015 9:00",709,681,10,7,1390,"neutor",NA
"11/4/2015 10:00",757,430,12,9,1187,"neutor",NA
"11/4/2015 11:00",700,586,15,11,1286,"neutor",NA
"11/4/2015 12:00",793,524,15,9,1317,"neutor",NA
"11/4/2015 13:00",752,727,16,7,1479,"neutor",NA
"11/4/2015 14:00",695,592,17,13,1287,"neutor",NA
"11/4/2015 15:00",770,753,16,9,1523,"neutor",NA
"11/4/2015 16:00",760,597,14,4,1357,"neutor",NA
"11/4/2015 17:00",943,840,12,6,1783,"neutor",NA
"11/4/2015 18:00",715,621,12,7,1336,"neutor",NA
"11/4/2015 19:00",749,600,13,9,1349,"neutor",NA
"11/4/2015 20:00",525,463,13,9,988,"neutor",NA
"11/4/2015 21:00",317,343,13,7,660,"neutor",NA
"11/4/2015 22:00",288,271,13,9,559,"neutor",NA
"11/4/2015 23:00",252,168,13,9,420,"neutor",NA
"11/5/2015 0:00",262,174,13,7,436,"neutor",NA
"11/5/2015 1:00",42,139,12,6,181,"neutor",NA
"11/5/2015 2:00",15,177,12,6,192,"neutor",NA
"11/5/2015 3:00",14,171,12,7,185,"neutor",NA
"11/5/2015 4:00",19,113,12,7,132,"neutor",NA
"11/5/2015 5:00",40,83,11,4,123,"neutor",NA
"11/5/2015 6:00",146,59,11,6,205,"neutor",NA
"11/5/2015 7:00",583,415,9,4,998,"neutor",NA
"11/5/2015 8:00",739,539,11,6,1278,"neutor",NA
"11/5/2015 9:00",751,546,13,7,1297,"neutor",NA
"11/5/2015 10:00",657,452,14,11,1109,"neutor",NA
"11/5/2015 11:00",781,696,15,11,1477,"neutor",NA
"11/5/2015 12:00",701,601,15,13,1302,"neutor",NA
"11/5/2015 13:00",689,699,16,11,1388,"neutor",NA
"11/5/2015 14:00",609,558,16,9,1167,"neutor",NA
"11/5/2015 15:00",738,670,16,6,1408,"neutor",NA
"11/5/2015 16:00",713,672,15,6,1385,"neutor",NA
"11/5/2015 17:00",747,638,14,7,1385,"neutor",NA
"11/5/2015 18:00",665,569,14,11,1234,"neutor",NA
"11/5/2015 19:00",477,594,14,9,1071,"neutor",NA
"11/5/2015 20:00",284,391,14,9,675,"neutor",NA
"11/5/2015 21:00",256,251,14,7,507,"neutor",NA
"11/5/2015 22:00",185,297,13,9,482,"neutor",NA
"11/5/2015 23:00",103,189,13,6,292,"neutor",NA
"11/6/2015 0:00",38,118,13,4,156,"neutor",NA
"11/6/2015 1:00",31,70,13,7,101,"neutor",NA
"11/6/2015 2:00",13,43,13,11,56,"neutor",NA
"11/6/2015 3:00",3,11,13,13,14,"neutor",NA
"11/6/2015 4:00",12,10,14,11,22,"neutor",NA
"11/6/2015 5:00",30,15,14,11,45,"neutor",NA
"11/6/2015 6:00",100,42,14,15,142,"neutor",NA
"11/6/2015 7:00",498,371,14,13,869,"neutor",NA
"11/6/2015 8:00",576,497,14,15,1073,"neutor",NA
"11/6/2015 9:00",497,387,14,13,884,"neutor",NA
"11/6/2015 10:00",521,296,14,13,817,"neutor",NA
"11/6/2015 11:00",457,482,15,13,939,"neutor",NA
"11/6/2015 12:00",561,430,15,13,991,"neutor",NA
"11/6/2015 13:00",612,518,16,11,1130,"neutor",NA
"11/6/2015 14:00",539,461,16,9,1000,"neutor",NA
"11/6/2015 15:00",559,431,16,9,990,"neutor",NA
"11/6/2015 16:00",455,366,16,6,821,"neutor",NA
"11/6/2015 17:00",462,411,15,7,873,"neutor",NA
"11/6/2015 18:00",354,404,15,9,758,"neutor",NA
"11/6/2015 19:00",354,344,15,11,698,"neutor",NA
"11/6/2015 20:00",272,231,15,17,503,"neutor",NA
"11/6/2015 21:00",212,175,15,17,387,"neutor",NA
"11/6/2015 22:00",130,167,15,15,297,"neutor",NA
"11/6/2015 23:00",117,147,15,15,264,"neutor",NA
"11/7/2015 0:00",98,143,16,17,241,"neutor",NA
"11/7/2015 1:00",77,136,16,17,213,"neutor",NA
"11/7/2015 2:00",40,132,16,17,172,"neutor",NA
"11/7/2015 3:00",18,86,16,13,104,"neutor",NA
"11/7/2015 4:00",17,44,16,15,61,"neutor",NA
"11/7/2015 5:00",22,39,16,13,61,"neutor",NA
"11/7/2015 6:00",29,23,16,15,52,"neutor",NA
"11/7/2015 7:00",119,31,16,11,150,"neutor",NA
"11/7/2015 8:00",178,107,15,13,285,"neutor",NA
"11/7/2015 9:00",277,103,16,11,380,"neutor",NA
"11/7/2015 10:00",345,155,17,13,500,"neutor",NA
"11/7/2015 11:00",371,169,17,13,540,"neutor",NA
"11/7/2015 12:00",356,260,18,15,616,"neutor",NA
"11/7/2015 13:00",340,257,18,13,597,"neutor",NA
"11/7/2015 14:00",295,348,18,13,643,"neutor",NA
"11/7/2015 15:00",251,261,18,17,512,"neutor",NA
"11/7/2015 16:00",278,306,18,15,584,"neutor",NA
"11/7/2015 17:00",238,299,18,19,537,"neutor",NA
"11/7/2015 18:00",242,297,18,20,539,"neutor",NA
"11/7/2015 19:00",236,222,18,20,458,"neutor",NA
"11/7/2015 20:00",226,196,19,24,422,"neutor",NA
"11/7/2015 21:00",126,121,17,39,247,"neutor",NA
"11/7/2015 22:00",111,163,16,35,274,"neutor",NA
"11/7/2015 23:00",105,172,16,28,277,"neutor",NA
"11/8/2015 0:00",119,149,15,28,268,"neutor",NA
"11/8/2015 1:00",62,152,14,26,214,"neutor",NA
"11/8/2015 2:00",52,108,14,20,160,"neutor",NA
"11/8/2015 3:00",34,87,14,20,121,"neutor",NA
"11/8/2015 4:00",30,67,13,11,97,"neutor",NA
"11/8/2015 5:00",18,46,13,13,64,"neutor",NA
"11/8/2015 6:00",18,15,13,9,33,"neutor",NA
"11/8/2015 7:00",32,17,11,2,49,"neutor",NA
"11/8/2015 8:00",45,31,11,7,76,"neutor",NA
"11/8/2015 9:00",133,65,12,9,198,"neutor",NA
"11/8/2015 10:00",255,89,13,15,344,"neutor",NA
"11/8/2015 11:00",142,121,13,11,263,"neutor",NA
"11/8/2015 12:00",204,198,14,17,402,"neutor",NA
"11/8/2015 13:00",233,185,15,13,418,"neutor",NA
"11/8/2015 14:00",292,217,15,11,509,"neutor",NA
"11/8/2015 15:00",306,246,14,9,552,"neutor",NA
"11/8/2015 16:00",259,215,13,9,474,"neutor",NA
"11/8/2015 17:00",199,307,13,9,506,"neutor",NA
"11/8/2015 18:00",217,248,13,9,465,"neutor",NA
"11/8/2015 19:00",247,269,13,9,516,"neutor",NA
"11/8/2015 20:00",104,179,13,9,283,"neutor",NA
"11/8/2015 21:00",62,140,13,11,202,"neutor",NA
"11/8/2015 22:00",129,172,13,7,301,"neutor",NA
"11/8/2015 23:00",47,137,15,9,184,"neutor",NA
"11/9/2015 0:00",14,59,17,20,73,"neutor",NA
"11/9/2015 1:00",10,8,17,22,18,"neutor",NA
"11/9/2015 2:00",3,3,16,22,6,"neutor",NA
"11/9/2015 3:00",4,3,16,22,7,"neutor",NA
"11/9/2015 4:00",5,5,16,24,10,"neutor",NA
"11/9/2015 5:00",39,19,15,26,58,"neutor",NA
"11/9/2015 6:00",119,46,14,19,165,"neutor",NA
"11/9/2015 7:00",531,349,15,26,880,"neutor",NA
"11/9/2015 8:00",694,527,15,22,1221,"neutor",NA
"11/9/2015 9:00",595,491,14,30,1086,"neutor",NA
"11/9/2015 10:00",600,381,15,33,981,"neutor",NA
"11/9/2015 11:00",491,639,15,28,1130,"neutor",NA
"11/9/2015 12:00",478,517,14,30,995,"neutor",NA
"11/9/2015 13:00",654,629,14,37,1283,"neutor",NA
"11/9/2015 14:00",572,524,13,33,1096,"neutor",NA
"11/9/2015 15:00",740,707,13,28,1447,"neutor",NA
"11/9/2015 16:00",735,597,13,28,1332,"neutor",NA
"11/9/2015 17:00",802,842,13,22,1644,"neutor",NA
"11/9/2015 18:00",644,693,13,24,1337,"neutor",NA
"11/9/2015 19:00",521,559,13,32,1080,"neutor",NA
"11/9/2015 20:00",305,342,13,28,647,"neutor",NA
"11/9/2015 21:00",182,271,13,28,453,"neutor",NA
"11/9/2015 22:00",143,214,13,32,357,"neutor",NA
"11/9/2015 23:00",81,166,13,32,247,"neutor",NA
"11/10/2015 0:00",17,86,13,28,103,"neutor",NA
"11/10/2015 1:00",19,21,14,30,40,"neutor",NA
"11/10/2015 2:00",7,9,14,30,16,"neutor",NA
"11/10/2015 3:00",6,4,14,35,10,"neutor",NA
"11/10/2015 4:00",8,4,14,32,12,"neutor",NA
"11/10/2015 5:00",31,19,14,26,50,"neutor",NA
"11/10/2015 6:00",107,40,14,30,147,"neutor",NA
"11/10/2015 7:00",554,425,14,32,979,"neutor",NA
"11/10/2015 8:00",888,595,13,28,1483,"neutor",NA
"11/10/2015 9:00",584,653,13,22,1237,"neutor",NA
"11/10/2015 10:00",591,396,13,22,987,"neutor",NA
"11/10/2015 11:00",496,609,13,24,1105,"neutor",NA
"11/10/2015 12:00",570,509,13,26,1079,"neutor",NA
"11/10/2015 13:00",598,653,13,22,1251,"neutor",NA
"11/10/2015 14:00",526,491,13,24,1017,"neutor",NA
"11/10/2015 15:00",652,708,13,22,1360,"neutor",NA
"11/10/2015 16:00",689,571,13,20,1260,"neutor",NA
"11/10/2015 17:00",818,715,14,24,1533,"neutor",NA
"11/10/2015 18:00",658,592,14,22,1250,"neutor",NA
"11/10/2015 19:00",571,557,14,24,1128,"neutor",NA
"11/10/2015 20:00",333,340,14,22,673,"neutor",NA
"11/10/2015 21:00",226,301,14,20,527,"neutor",NA
"11/10/2015 22:00",121,242,14,22,363,"neutor",NA
"11/10/2015 23:00",74,207,14,24,281,"neutor",NA
"11/11/2015 0:00",48,100,14,32,148,"neutor",NA
"11/11/2015 1:00",40,37,14,24,77,"neutor",NA
"11/11/2015 2:00",49,8,13,24,57,"neutor",NA
"11/11/2015 3:00",31,3,13,20,34,"neutor",NA
"11/11/2015 4:00",21,7,13,17,28,"neutor",NA
"11/11/2015 5:00",41,16,13,22,57,"neutor",NA
"11/11/2015 6:00",136,50,12,20,186,"neutor",NA
"11/11/2015 7:00",568,400,12,19,968,"neutor",NA
"11/11/2015 8:00",749,565,12,17,1314,"neutor",NA
"11/11/2015 9:00",630,561,12,22,1191,"neutor",NA
"11/11/2015 10:00",645,349,13,20,994,"neutor",NA
"11/11/2015 11:00",564,563,13,20,1127,"neutor",NA
"11/11/2015 12:00",644,515,13,20,1159,"neutor",NA
"11/11/2015 13:00",625,603,13,15,1228,"neutor",NA
"11/11/2015 14:00",572,504,13,17,1076,"neutor",NA
"11/11/2015 15:00",651,670,13,17,1321,"neutor",NA
"11/11/2015 16:00",658,574,12,15,1232,"neutor",NA
"11/11/2015 17:00",749,720,12,17,1469,"neutor",NA
"11/11/2015 18:00",734,593,12,17,1327,"neutor",NA
"11/11/2015 19:00",577,574,12,17,1151,"neutor",NA
"11/11/2015 20:00",313,443,12,20,756,"neutor",NA
"11/11/2015 21:00",267,375,12,22,642,"neutor",NA
"11/11/2015 22:00",170,305,12,20,475,"neutor",NA
"11/11/2015 23:00",115,225,12,20,340,"neutor",NA
"11/12/2015 0:00",97,146,12,17,243,"neutor",NA
"11/12/2015 1:00",36,103,12,19,139,"neutor",NA
"11/12/2015 2:00",15,65,12,15,80,"neutor",NA
"11/12/2015 3:00",8,49,13,17,57,"neutor",NA
"11/12/2015 4:00",13,21,13,17,34,"neutor",NA
"11/12/2015 5:00",38,37,13,19,75,"neutor",NA
"11/12/2015 6:00",113,56,13,19,169,"neutor",NA
"11/12/2015 7:00",555,402,12,17,957,"neutor",NA
"11/12/2015 8:00",641,564,13,19,1205,"neutor",NA
"11/12/2015 9:00",610,525,13,15,1135,"neutor",NA
"11/12/2015 10:00",611,416,13,17,1027,"neutor",NA
"11/12/2015 11:00",648,677,14,19,1325,"neutor",NA
"11/12/2015 12:00",596,518,14,17,1114,"neutor",NA
"11/12/2015 13:00",655,635,14,15,1290,"neutor",NA
"11/12/2015 14:00",600,558,14,15,1158,"neutor",NA
"11/12/2015 15:00",683,610,14,11,1293,"neutor",NA
"11/12/2015 16:00",716,633,13,7,1349,"neutor",NA
"11/12/2015 17:00",799,712,12,6,1511,"neutor",NA
"11/12/2015 18:00",663,605,13,9,1268,"neutor",NA
"11/12/2015 19:00",581,635,12,7,1216,"neutor",NA
"11/12/2015 20:00",353,423,13,9,776,"neutor",NA
"11/12/2015 21:00",361,276,13,7,637,"neutor",NA
"11/12/2015 22:00",218,307,13,9,525,"neutor",NA
"11/12/2015 23:00",174,189,13,13,363,"neutor",NA
"11/13/2015 0:00",103,139,13,15,242,"neutor",NA
"11/13/2015 1:00",33,84,13,11,117,"neutor",NA
"11/13/2015 2:00",14,111,13,11,125,"neutor",NA
"11/13/2015 3:00",10,115,13,13,125,"neutor",NA
"11/13/2015 4:00",16,88,13,15,104,"neutor",NA
"11/13/2015 5:00",40,61,14,19,101,"neutor",NA
"11/13/2015 6:00",90,51,13,19,141,"neutor",NA
"11/13/2015 7:00",495,372,13,22,867,"neutor",NA
"11/13/2015 8:00",587,464,14,19,1051,"neutor",NA
"11/13/2015 9:00",477,386,13,22,863,"neutor",NA
"11/13/2015 10:00",517,317,14,30,834,"neutor",NA
"11/13/2015 11:00",492,508,14,33,1000,"neutor",NA
"11/13/2015 12:00",520,420,14,28,940,"neutor",NA
"11/13/2015 13:00",586,523,14,37,1109,"neutor",NA
"11/13/2015 14:00",465,425,14,35,890,"neutor",NA
"11/13/2015 15:00",557,465,13,22,1022,"neutor",NA
"11/13/2015 16:00",455,416,12,15,871,"neutor",NA
"11/13/2015 17:00",415,433,12,19,848,"neutor",NA
"11/13/2015 18:00",265,325,9,22,590,"neutor",NA
"11/13/2015 19:00",290,274,9,30,564,"neutor",NA
"11/13/2015 20:00",259,230,8,24,489,"neutor",NA
"11/13/2015 21:00",192,160,8,24,352,"neutor",NA
"11/13/2015 22:00",127,145,8,20,272,"neutor",NA
"11/13/2015 23:00",113,126,6,24,239,"neutor",NA
"11/14/2015 0:00",122,148,7,24,270,"neutor",NA
"11/14/2015 1:00",87,109,7,19,196,"neutor",NA
"11/14/2015 2:00",47,88,7,24,135,"neutor",NA
"11/14/2015 3:00",23,98,7,26,121,"neutor",NA
"11/14/2015 4:00",24,37,7,24,61,"neutor",NA
"11/14/2015 5:00",16,40,7,30,56,"neutor",NA
"11/14/2015 6:00",28,18,7,28,46,"neutor",NA
"11/14/2015 7:00",111,24,7,22,135,"neutor",NA
"11/14/2015 8:00",155,61,7,22,216,"neutor",NA
"11/14/2015 9:00",262,73,8,24,335,"neutor",NA
"11/14/2015 10:00",325,109,9,24,434,"neutor",NA
"11/14/2015 11:00",291,175,9,28,466,"neutor",NA
"11/14/2015 12:00",336,204,10,30,540,"neutor",NA
"11/14/2015 13:00",304,310,9,22,614,"neutor",NA
"11/14/2015 14:00",283,278,9,28,561,"neutor",NA
"11/14/2015 15:00",326,302,9,24,628,"neutor",NA
"11/14/2015 16:00",266,262,9,20,528,"neutor",NA
"11/14/2015 17:00",252,250,9,20,502,"neutor",NA
"11/14/2015 18:00",173,228,8,20,401,"neutor",NA
"11/14/2015 19:00",166,173,7,13,339,"neutor",NA
"11/14/2015 20:00",149,133,8,15,282,"neutor",NA
"11/14/2015 21:00",156,143,8,15,299,"neutor",NA
"11/14/2015 22:00",87,141,9,20,228,"neutor",NA
"11/14/2015 23:00",59,114,8,19,173,"neutor",NA
"11/15/2015 0:00",86,152,9,24,238,"neutor",NA
"11/15/2015 1:00",67,87,10,26,154,"neutor",NA
"11/15/2015 2:00",64,103,11,35,167,"neutor",NA
"11/15/2015 3:00",38,76,12,28,114,"neutor",NA
"11/15/2015 4:00",23,53,11,32,76,"neutor",NA
"11/15/2015 5:00",23,26,12,33,49,"neutor",NA
"11/15/2015 6:00",27,16,12,33,43,"neutor",NA
"11/15/2015 7:00",23,8,13,32,31,"neutor",NA
"11/15/2015 8:00",28,18,13,41,46,"neutor",NA
"11/15/2015 9:00",76,30,14,44,106,"neutor",NA
"11/15/2015 10:00",128,65,14,43,193,"neutor",NA
"11/15/2015 11:00",88,65,14,39,153,"neutor",NA
"11/15/2015 12:00",70,82,13,43,152,"neutor",NA
"11/15/2015 13:00",106,85,13,43,191,"neutor",NA
"11/15/2015 14:00",89,101,13,39,190,"neutor",NA
"11/15/2015 15:00",113,89,13,39,202,"neutor",NA
"11/15/2015 16:00",114,105,13,39,219,"neutor",NA
"11/15/2015 17:00",115,129,13,32,244,"neutor",NA
"11/15/2015 18:00",121,124,13,30,245,"neutor",NA
"11/15/2015 19:00",84,127,13,30,211,"neutor",NA
"11/15/2015 20:00",45,104,13,32,149,"neutor",NA
"11/15/2015 21:00",39,62,13,32,101,"neutor",NA
"11/15/2015 22:00",48,67,13,28,115,"neutor",NA
"11/15/2015 23:00",23,68,13,17,91,"neutor",NA
"11/16/2015 0:00",10,30,13,20,40,"neutor",NA
"11/16/2015 1:00",8,9,13,22,17,"neutor",NA
"11/16/2015 2:00",3,4,13,22,7,"neutor",NA
"11/16/2015 3:00",3,2,13,19,5,"neutor",NA
"11/16/2015 4:00",7,3,12,19,10,"neutor",NA
"11/16/2015 5:00",27,14,12,20,41,"neutor",NA
"11/16/2015 6:00",109,41,13,24,150,"neutor",NA
"11/16/2015 7:00",502,298,12,22,800,"neutor",NA
"11/16/2015 8:00",642,454,12,22,1096,"neutor",NA
"11/16/2015 9:00",589,435,12,28,1024,"neutor",NA
"11/16/2015 10:00",604,381,12,24,985,"neutor",NA
"11/16/2015 11:00",445,587,12,28,1032,"neutor",NA
"11/16/2015 12:00",517,471,12,24,988,"neutor",NA
"11/16/2015 13:00",664,670,12,24,1334,"neutor",NA
"11/16/2015 14:00",515,467,13,20,982,"neutor",NA
"11/16/2015 15:00",769,652,13,22,1421,"neutor",NA
"11/16/2015 16:00",658,567,12,20,1225,"neutor",NA
"11/16/2015 17:00",716,845,12,20,1561,"neutor",NA
"11/16/2015 18:00",586,561,12,19,1147,"neutor",NA
"11/16/2015 19:00",445,483,12,17,928,"neutor",NA
"11/16/2015 20:00",209,302,12,22,511,"neutor",NA
"11/16/2015 21:00",172,249,12,20,421,"neutor",NA
"11/16/2015 22:00",148,159,12,17,307,"neutor",NA
"11/16/2015 23:00",57,147,12,17,204,"neutor",NA
"11/17/2015 0:00",35,78,12,17,113,"neutor",NA
"11/17/2015 1:00",17,34,12,20,51,"neutor",NA
"11/17/2015 2:00",3,13,12,17,16,"neutor",NA
"11/17/2015 3:00",6,9,12,17,15,"neutor",NA
"11/17/2015 4:00",7,5,12,13,12,"neutor",NA
"11/17/2015 5:00",29,16,12,15,45,"neutor",NA
"11/17/2015 6:00",105,43,12,13,148,"neutor",NA
"11/17/2015 7:00",363,355,12,13,718,"neutor",NA
"11/17/2015 8:00",732,492,12,11,1224,"neutor",NA
"11/17/2015 9:00",433,479,13,17,912,"neutor",NA
"11/17/2015 10:00",461,324,14,24,785,"neutor",NA
"11/17/2015 11:00",418,486,14,28,904,"neutor",NA
"11/17/2015 12:00",523,409,14,30,932,"neutor",NA
"11/17/2015 13:00",587,570,14,24,1157,"neutor",NA
"11/17/2015 14:00",533,444,14,28,977,"neutor",NA
"11/17/2015 15:00",563,669,14,26,1232,"neutor",NA
"11/17/2015 16:00",718,506,14,22,1224,"neutor",NA
"11/17/2015 17:00",650,680,14,28,1330,"neutor",NA
"11/17/2015 18:00",595,513,14,22,1108,"neutor",NA
"11/17/2015 19:00",455,486,14,26,941,"neutor",NA
"11/17/2015 20:00",296,313,14,30,609,"neutor",NA
"11/17/2015 21:00",195,242,16,39,437,"neutor",NA
"11/17/2015 22:00",165,278,16,48,443,"neutor",NA
"11/17/2015 23:00",58,151,15,59,209,"neutor",NA
"11/18/2015 0:00",26,79,15,39,105,"neutor",NA
"11/18/2015 1:00",10,44,12,54,54,"neutor",NA
"11/18/2015 2:00",4,15,12,44,19,"neutor",NA
"11/18/2015 3:00",9,1,12,54,10,"neutor",NA
"11/18/2015 4:00",8,7,12,48,15,"neutor",NA
"11/18/2015 5:00",23,11,11,50,34,"neutor",NA
"11/18/2015 6:00",93,36,11,50,129,"neutor",NA
"11/18/2015 7:00",462,334,10,30,796,"neutor",NA
"11/18/2015 8:00",645,516,10,32,1161,"neutor",NA
"11/18/2015 9:00",604,540,11,39,1144,"neutor",NA
"11/18/2015 10:00",600,359,12,33,959,"neutor",NA
"11/18/2015 11:00",529,547,12,28,1076,"neutor",NA
"11/18/2015 12:00",577,479,13,32,1056,"neutor",NA
"11/18/2015 13:00",628,543,13,22,1171,"neutor",NA
"11/18/2015 14:00",563,441,13,24,1004,"neutor",NA
"11/18/2015 15:00",577,576,13,20,1153,"neutor",NA
"11/18/2015 16:00",622,552,13,26,1174,"neutor",NA
"11/18/2015 17:00",737,698,13,33,1435,"neutor",NA
"11/18/2015 18:00",597,589,13,32,1186,"neutor",NA
"11/18/2015 19:00",565,568,13,33,1133,"neutor",NA
"11/18/2015 20:00",379,347,13,35,726,"neutor",NA
"11/18/2015 21:00",288,317,13,35,605,"neutor",NA
"11/18/2015 22:00",226,256,13,41,482,"neutor",NA
"11/18/2015 23:00",197,194,13,35,391,"neutor",NA
"11/19/2015 0:00",168,173,13,37,341,"neutor",NA
"11/19/2015 1:00",63,114,13,33,177,"neutor",NA
"11/19/2015 2:00",34,81,13,39,115,"neutor",NA
"11/19/2015 3:00",42,104,12,32,146,"neutor",NA
"11/19/2015 4:00",43,100,13,39,143,"neutor",NA
"11/19/2015 5:00",34,84,12,37,118,"neutor",NA
"11/19/2015 6:00",114,46,12,41,160,"neutor",NA
"11/19/2015 7:00",451,307,12,39,758,"neutor",NA
"11/19/2015 8:00",586,460,12,35,1046,"neutor",NA
"11/19/2015 9:00",554,431,12,37,985,"neutor",NA
"11/19/2015 10:00",539,374,13,41,913,"neutor",NA
"11/19/2015 11:00",538,550,12,39,1088,"neutor",NA
"11/19/2015 12:00",606,436,13,37,1042,"neutor",NA
"11/19/2015 13:00",555,609,12,37,1164,"neutor",NA
"11/19/2015 14:00",513,491,12,30,1004,"neutor",NA
"11/19/2015 15:00",715,552,12,30,1267,"neutor",NA
"11/19/2015 16:00",542,482,11,22,1024,"neutor",NA
"11/19/2015 17:00",580,518,9,28,1098,"neutor",NA
"11/19/2015 18:00",466,417,8,17,883,"neutor",NA
"11/19/2015 19:00",324,361,8,17,685,"neutor",NA
"11/19/2015 20:00",283,267,8,15,550,"neutor",NA
"11/19/2015 21:00",170,190,8,17,360,"neutor",NA
"11/19/2015 22:00",163,173,8,20,336,"neutor",NA
"11/19/2015 23:00",89,136,8,22,225,"neutor",NA
"11/20/2015 0:00",38,78,9,20,116,"neutor",NA
"11/20/2015 1:00",20,54,9,20,74,"neutor",NA
"11/20/2015 2:00",16,25,8,17,41,"neutor",NA
"11/20/2015 3:00",9,26,9,19,35,"neutor",NA
"11/20/2015 4:00",11,9,9,22,20,"neutor",NA
"11/20/2015 5:00",29,22,8,19,51,"neutor",NA
"11/20/2015 6:00",103,45,8,20,148,"neutor",NA
"11/20/2015 7:00",473,257,8,19,730,"neutor",NA
"11/20/2015 8:00",586,406,8,17,992,"neutor",NA
"11/20/2015 9:00",531,375,8,22,906,"neutor",NA
"11/20/2015 10:00",555,305,8,20,860,"neutor",NA
"11/20/2015 11:00",524,482,8,22,1006,"neutor",NA
"11/20/2015 12:00",555,381,8,24,936,"neutor",NA
"11/20/2015 13:00",553,506,8,20,1059,"neutor",NA
"11/20/2015 14:00",470,433,8,20,903,"neutor",NA
"11/20/2015 15:00",476,380,7,15,856,"neutor",NA
"11/20/2015 16:00",473,373,6,13,846,"neutor",NA
"11/20/2015 17:00",427,437,7,15,864,"neutor",NA
"11/20/2015 18:00",399,371,6,19,770,"neutor",NA
"11/20/2015 19:00",322,301,6,17,623,"neutor",NA
"11/20/2015 20:00",256,256,6,15,512,"neutor",NA
"11/20/2015 21:00",248,220,5,15,468,"neutor",NA
"11/20/2015 22:00",160,177,5,24,337,"neutor",NA
"11/20/2015 23:00",142,183,5,11,325,"neutor",NA
"11/21/2015 0:00",131,174,5,13,305,"neutor",NA
"11/21/2015 1:00",105,158,5,15,263,"neutor",NA
"11/21/2015 2:00",54,130,5,20,184,"neutor",NA
"11/21/2015 3:00",66,109,5,17,175,"neutor",NA
"11/21/2015 4:00",26,71,5,15,97,"neutor",NA
"11/21/2015 5:00",35,19,5,19,54,"neutor",NA
"11/21/2015 6:00",43,22,5,19,65,"neutor",NA
"11/21/2015 7:00",109,23,4,15,132,"neutor",NA
"11/21/2015 8:00",170,68,4,13,238,"neutor",NA
"11/21/2015 9:00",254,91,5,17,345,"neutor",NA
"11/21/2015 10:00",349,119,5,17,468,"neutor",NA
"11/21/2015 11:00",354,128,5,20,482,"neutor",NA
"11/21/2015 12:00",342,197,6,17,539,"neutor",NA
"11/21/2015 13:00",277,220,5,15,497,"neutor",NA
"11/21/2015 14:00",230,252,4,11,482,"neutor",NA
"11/21/2015 15:00",201,231,4,9,432,"neutor",NA
"11/21/2015 16:00",205,204,4,9,409,"neutor",NA
"11/21/2015 17:00",177,217,4,9,394,"neutor",NA
"11/21/2015 18:00",179,235,4,9,414,"neutor",NA
"11/21/2015 19:00",185,171,4,11,356,"neutor",NA
"11/21/2015 20:00",164,128,4,13,292,"neutor",NA
"11/21/2015 21:00",141,109,3,11,250,"neutor",NA
"11/21/2015 22:00",100,139,3,9,239,"neutor",NA
"11/21/2015 23:00",84,127,2,9,211,"neutor",NA
"11/22/2015 0:00",76,112,1,7,188,"neutor",NA
"11/22/2015 1:00",61,107,1,11,168,"neutor",NA
"11/22/2015 2:00",43,113,1,13,156,"neutor",NA
"11/22/2015 3:00",56,100,1,11,156,"neutor",NA
"11/22/2015 4:00",25,55,0,9,80,"neutor",NA
"11/22/2015 5:00",12,55,-1,13,67,"neutor",NA
"11/22/2015 6:00",28,28,0,9,56,"neutor",NA
"11/22/2015 7:00",19,13,0,17,32,"neutor",NA
"11/22/2015 8:00",25,25,0,7,50,"neutor",NA
"11/22/2015 9:00",137,36,1,11,173,"neutor",NA
"11/22/2015 10:00",152,65,3,15,217,"neutor",NA
"11/22/2015 11:00",98,89,3,19,187,"neutor",NA
"11/22/2015 12:00",132,110,3,19,242,"neutor",NA
"11/22/2015 13:00",186,134,4,26,320,"neutor",NA
"11/22/2015 14:00",183,148,2,11,331,"neutor",NA
"11/22/2015 15:00",173,136,2,13,309,"neutor",NA
"11/22/2015 16:00",178,171,1,17,349,"neutor",NA
"11/22/2015 17:00",183,157,2,20,340,"neutor",NA
"11/22/2015 18:00",193,175,2,24,368,"neutor",NA
"11/22/2015 19:00",122,181,2,24,303,"neutor",NA
"11/22/2015 20:00",83,149,2,24,232,"neutor",NA
"11/22/2015 21:00",63,120,2,19,183,"neutor",NA
"11/22/2015 22:00",56,102,3,17,158,"neutor",NA
"11/22/2015 23:00",39,76,3,13,115,"neutor",NA
"11/23/2015 0:00",13,30,3,15,43,"neutor",NA
"11/23/2015 1:00",7,10,3,11,17,"neutor",NA
"11/23/2015 2:00",3,0,3,13,3,"neutor",NA
"11/23/2015 3:00",3,0,3,13,3,"neutor",NA
"11/23/2015 4:00",9,3,3,11,12,"neutor",NA
"11/23/2015 5:00",40,10,2,7,50,"neutor",NA
"11/23/2015 6:00",101,45,1,7,146,"neutor",NA
"11/23/2015 7:00",513,272,0,7,785,"neutor",NA
"11/23/2015 8:00",663,477,0,7,1140,"neutor",NA
"11/23/2015 9:00",545,426,2,7,971,"neutor",NA
"11/23/2015 10:00",525,357,3,4,882,"neutor",NA
"11/23/2015 11:00",459,542,4,6,1001,"neutor",NA
"11/23/2015 12:00",509,441,5,6,950,"neutor",NA
"11/23/2015 13:00",649,601,5,9,1250,"neutor",NA
"11/23/2015 14:00",588,476,5,13,1064,"neutor",NA
"11/23/2015 15:00",763,609,4,9,1372,"neutor",NA
"11/23/2015 16:00",762,553,4,9,1315,"neutor",NA
"11/23/2015 17:00",918,738,4,7,1656,"neutor",NA
"11/23/2015 18:00",809,580,4,9,1389,"neutor",NA
"11/23/2015 19:00",576,623,4,9,1199,"neutor",NA
"11/23/2015 20:00",241,447,3,9,688,"neutor",NA
"11/23/2015 21:00",163,310,3,11,473,"neutor",NA
"11/23/2015 22:00",145,237,4,13,382,"neutor",NA
"11/23/2015 23:00",60,155,4,13,215,"neutor",NA
"11/24/2015 0:00",45,71,3,13,116,"neutor",NA
"11/24/2015 1:00",9,41,3,17,50,"neutor",NA
"11/24/2015 2:00",2,10,3,17,12,"neutor",NA
"11/24/2015 3:00",5,5,3,15,10,"neutor",NA
"11/24/2015 4:00",13,10,3,19,23,"neutor",NA
"11/24/2015 5:00",34,12,3,15,46,"neutor",NA
"11/24/2015 6:00",124,58,3,19,182,"neutor",NA
"11/24/2015 7:00",478,367,3,20,845,"neutor",NA
"11/24/2015 8:00",865,562,3,19,1427,"neutor",NA
"11/24/2015 9:00",576,524,4,19,1100,"neutor",NA
"11/24/2015 10:00",569,430,4,22,999,"neutor",NA
"11/24/2015 11:00",497,583,4,24,1080,"neutor",NA
"11/24/2015 12:00",596,425,4,26,1021,"neutor",NA
"11/24/2015 13:00",631,600,4,28,1231,"neutor",NA
"11/24/2015 14:00",515,440,3,20,955,"neutor",NA
"11/24/2015 15:00",669,612,3,26,1281,"neutor",NA
"11/24/2015 16:00",663,495,3,20,1158,"neutor",NA
"11/24/2015 17:00",764,626,2,17,1390,"neutor",NA
"11/24/2015 18:00",650,445,1,17,1095,"neutor",NA
"11/24/2015 19:00",443,478,1,15,921,"neutor",NA
"11/24/2015 20:00",236,354,1,17,590,"neutor",NA
"11/24/2015 21:00",162,277,2,17,439,"neutor",NA
"11/24/2015 22:00",85,224,2,15,309,"neutor",NA
"11/24/2015 23:00",75,154,3,15,229,"neutor",NA
"11/25/2015 0:00",21,68,3,17,89,"neutor",NA
"11/25/2015 1:00",22,45,3,15,67,"neutor",NA
"11/25/2015 2:00",4,16,3,15,20,"neutor",NA
"11/25/2015 3:00",11,0,4,13,11,"neutor",NA
"11/25/2015 4:00",7,4,4,13,11,"neutor",NA
"11/25/2015 5:00",32,11,4,13,43,"neutor",NA
"11/25/2015 6:00",130,48,4,15,178,"neutor",NA
"11/25/2015 7:00",427,294,5,15,721,"neutor",NA
"11/25/2015 8:00",677,492,5,13,1169,"neutor",NA
"11/25/2015 9:00",500,563,6,11,1063,"neutor",NA
"11/25/2015 10:00",506,342,6,7,848,"neutor",NA
"11/25/2015 11:00",510,417,7,15,927,"neutor",NA
"11/25/2015 12:00",555,387,7,19,942,"neutor",NA
"11/25/2015 13:00",603,545,7,17,1148,"neutor",NA
"11/25/2015 14:00",506,456,7,11,962,"neutor",NA
"11/25/2015 15:00",593,583,6,11,1176,"neutor",NA
"11/25/2015 16:00",661,511,6,4,1172,"neutor",NA
"11/25/2015 17:00",751,687,6,11,1438,"neutor",NA
"11/25/2015 18:00",650,527,5,13,1177,"neutor",NA
"11/25/2015 19:00",579,558,4,11,1137,"neutor",NA
"11/25/2015 20:00",346,454,5,11,800,"neutor",NA
"11/25/2015 21:00",237,319,5,13,556,"neutor",NA
"11/25/2015 22:00",216,238,4,9,454,"neutor",NA
"11/25/2015 23:00",146,247,3,9,393,"neutor",NA
"11/26/2015 0:00",171,157,3,11,328,"neutor",NA
"11/26/2015 1:00",34,103,3,6,137,"neutor",NA
"11/26/2015 2:00",24,85,3,13,109,"neutor",NA
"11/26/2015 3:00",16,92,3,9,108,"neutor",NA
"11/26/2015 4:00",27,65,3,9,92,"neutor",NA
"11/26/2015 5:00",36,46,3,7,82,"neutor",NA
"11/26/2015 6:00",125,59,2,4,184,"neutor",NA
"11/26/2015 7:00",459,337,1,4,796,"neutor",NA
"11/26/2015 8:00",628,507,1,6,1135,"neutor",NA
"11/26/2015 9:00",580,439,2,6,1019,"neutor",NA
"11/26/2015 10:00",593,370,5,7,963,"neutor",NA
"11/26/2015 11:00",547,558,6,6,1105,"neutor",NA
"11/26/2015 12:00",567,475,7,7,1042,"neutor",NA
"11/26/2015 13:00",662,586,8,7,1248,"neutor",NA
"11/26/2015 14:00",576,455,8,11,1031,"neutor",NA
"11/26/2015 15:00",773,549,6,9,1322,"neutor",NA
"11/26/2015 16:00",743,537,4,4,1280,"neutor",NA
"11/26/2015 17:00",880,641,3,4,1521,"neutor",NA
"11/26/2015 18:00",714,569,2,2,1283,"neutor",NA
"11/26/2015 19:00",435,606,1,4,1041,"neutor",NA
"11/26/2015 20:00",310,502,1,2,812,"neutor",NA
"11/26/2015 21:00",235,296,0,4,531,"neutor",NA
"11/26/2015 22:00",152,228,-1,2,380,"neutor",NA
"11/26/2015 23:00",99,204,-1,2,303,"neutor",NA
"11/27/2015 0:00",57,118,-2,2,175,"neutor",NA
"11/27/2015 1:00",26,51,-1,4,77,"neutor",NA
"11/27/2015 2:00",33,52,-1,6,85,"neutor",NA
"11/27/2015 3:00",23,51,-1,6,74,"neutor",NA
"11/27/2015 4:00",20,33,0,6,53,"neutor",NA
"11/27/2015 5:00",37,29,0,6,66,"neutor",NA
"11/27/2015 6:00",99,58,0,7,157,"neutor",NA
"11/27/2015 7:00",426,276,1,9,702,"neutor",NA
"11/27/2015 8:00",643,433,1,11,1076,"neutor",NA
"11/27/2015 9:00",508,396,2,11,904,"neutor",NA
"11/27/2015 10:00",559,310,4,11,869,"neutor",NA
"11/27/2015 11:00",469,408,5,15,877,"neutor",NA
"11/27/2015 12:00",520,388,6,17,908,"neutor",NA
"11/27/2015 13:00",552,464,7,17,1016,"neutor",NA
"11/27/2015 14:00",500,399,7,17,899,"neutor",NA
"11/27/2015 15:00",537,461,6,13,998,"neutor",NA
"11/27/2015 16:00",565,376,5,13,941,"neutor",NA
"11/27/2015 17:00",497,378,5,20,875,"neutor",NA
"11/27/2015 18:00",475,347,5,20,822,"neutor",NA
"11/27/2015 19:00",420,335,5,19,755,"neutor",NA
"11/27/2015 20:00",242,288,5,17,530,"neutor",NA
"11/27/2015 21:00",160,281,5,22,441,"neutor",NA
"11/27/2015 22:00",139,186,4,22,325,"neutor",NA
"11/27/2015 23:00",91,187,4,20,278,"neutor",NA
"11/28/2015 0:00",71,174,4,20,245,"neutor",NA
"11/28/2015 1:00",58,147,4,19,205,"neutor",NA
"11/28/2015 2:00",48,91,4,20,139,"neutor",NA
"11/28/2015 3:00",34,57,4,22,91,"neutor",NA
"11/28/2015 4:00",21,42,4,19,63,"neutor",NA
"11/28/2015 5:00",36,34,4,22,70,"neutor",NA
"11/28/2015 6:00",31,13,5,22,44,"neutor",NA
"11/28/2015 7:00",88,21,6,20,109,"neutor",NA
"11/28/2015 8:00",150,68,5,19,218,"neutor",NA
"11/28/2015 9:00",255,84,5,22,339,"neutor",NA
"11/28/2015 10:00",354,124,7,24,478,"neutor",NA
"11/28/2015 11:00",377,146,7,28,523,"neutor",NA
"11/28/2015 12:00",385,225,7,32,610,"neutor",NA
"11/28/2015 13:00",391,260,7,30,651,"neutor",NA
"11/28/2015 14:00",282,260,7,22,542,"neutor",NA
"11/28/2015 15:00",275,250,6,19,525,"neutor",NA
"11/28/2015 16:00",252,244,6,19,496,"neutor",NA
"11/28/2015 17:00",251,265,6,24,516,"neutor",NA
"11/28/2015 18:00",270,224,6,20,494,"neutor",NA
"11/28/2015 19:00",223,220,6,20,443,"neutor",NA
"11/28/2015 20:00",139,193,6,26,332,"neutor",NA
"11/28/2015 21:00",120,190,6,24,310,"neutor",NA
"11/28/2015 22:00",113,142,6,32,255,"neutor",NA
"11/28/2015 23:00",83,162,6,26,245,"neutor",NA
"11/29/2015 0:00",66,122,6,33,188,"neutor",NA
"11/29/2015 1:00",70,113,7,33,183,"neutor",NA
"11/29/2015 2:00",56,81,7,35,137,"neutor",NA
"11/29/2015 3:00",48,76,7,28,124,"neutor",NA
"11/29/2015 4:00",38,51,7,17,89,"neutor",NA
"11/29/2015 5:00",13,47,8,22,60,"neutor",NA
"11/29/2015 6:00",19,27,8,22,46,"neutor",NA
"11/29/2015 7:00",9,13,8,22,22,"neutor",NA
"11/29/2015 8:00",39,19,8,22,58,"neutor",NA
"11/29/2015 9:00",111,38,9,24,149,"neutor",NA
"11/29/2015 10:00",148,58,9,32,206,"neutor",NA
"11/29/2015 11:00",154,65,10,33,219,"neutor",NA
"11/29/2015 12:00",134,93,10,30,227,"neutor",NA
"11/29/2015 13:00",129,118,10,24,247,"neutor",NA
"11/29/2015 14:00",128,114,9,22,242,"neutor",NA
"11/29/2015 15:00",119,112,10,33,231,"neutor",NA
"11/29/2015 16:00",135,114,10,33,249,"neutor",NA
"11/29/2015 17:00",180,127,11,35,307,"neutor",NA
"11/29/2015 18:00",183,175,11,39,358,"neutor",NA
"11/29/2015 19:00",113,193,11,35,306,"neutor",NA
"11/29/2015 20:00",56,159,11,46,215,"neutor",NA
"11/29/2015 21:00",36,66,9,39,102,"neutor",NA
"11/29/2015 22:00",34,98,9,37,132,"neutor",NA
"11/29/2015 23:00",23,55,9,35,78,"neutor",NA
"11/30/2015 0:00",20,27,9,33,47,"neutor",NA
"11/30/2015 1:00",1,6,9,37,7,"neutor",NA
"11/30/2015 2:00",1,8,8,39,9,"neutor",NA
"11/30/2015 3:00",1,0,8,41,1,"neutor",NA
"11/30/2015 4:00",6,4,7,43,10,"neutor",NA
"11/30/2015 5:00",12,8,7,32,20,"neutor",NA
"11/30/2015 6:00",66,28,7,30,94,"neutor",NA
"11/30/2015 7:00",196,231,7,30,427,"neutor",NA
"11/30/2015 8:00",662,388,7,26,1050,"neutor",NA
"11/30/2015 9:00",437,392,7,22,829,"neutor",NA
"11/30/2015 10:00",667,312,7,22,979,"neutor",NA
"11/30/2015 11:00",283,503,7,15,786,"neutor",NA
"11/30/2015 12:00",600,390,7,26,990,"neutor",NA
"11/30/2015 13:00",292,478,6,7,770,"neutor",NA
"11/30/2015 14:00",654,394,6,11,1048,"neutor",NA
"11/30/2015 15:00",308,517,8,17,825,"neutor",NA
"11/30/2015 16:00",891,453,10,26,1344,"neutor",NA
"11/30/2015 17:00",349,507,10,28,856,"neutor",NA
"11/30/2015 18:00",603,370,10,33,973,"neutor",NA
"11/30/2015 19:00",286,360,11,35,646,"neutor",NA
"11/30/2015 20:00",256,262,11,37,518,"neutor",NA
"11/30/2015 21:00",107,168,11,44,275,"neutor",NA
"11/30/2015 22:00",79,229,11,39,308,"neutor",NA
"11/30/2015 23:00",58,77,12,39,135,"neutor",NA
"12/1/2015 0:00",29,48,10,28,77,"neutor",NA
"12/1/2015 1:00",18,14,8,15,32,"neutor",NA
"12/1/2015 2:00",7,1,8,20,8,"neutor",NA
"12/1/2015 3:00",4,2,8,13,6,"neutor",NA
"12/1/2015 4:00",8,4,7,13,12,"neutor",NA
"12/1/2015 5:00",23,6,7,11,29,"neutor",NA
"12/1/2015 6:00",86,42,6,11,128,"neutor",NA
"12/1/2015 7:00",419,314,5,7,733,"neutor",NA
"12/1/2015 8:00",767,456,6,7,1223,"neutor",NA
"12/1/2015 9:00",508,503,6,7,1011,"neutor",NA
"12/1/2015 10:00",556,420,7,11,976,"neutor",NA
"12/1/2015 11:00",555,524,8,11,1079,"neutor",NA
"12/1/2015 12:00",639,420,8,13,1059,"neutor",NA
"12/1/2015 13:00",589,612,8,15,1201,"neutor",NA
"12/1/2015 14:00",528,503,9,11,1031,"neutor",NA
"12/1/2015 15:00",578,584,8,7,1162,"neutor",NA
"12/1/2015 16:00",704,500,8,13,1204,"neutor",NA
"12/1/2015 17:00",793,607,8,11,1400,"neutor",NA
"12/1/2015 18:00",653,488,9,15,1141,"neutor",NA
"12/1/2015 19:00",520,508,11,19,1028,"neutor",NA
"12/1/2015 20:00",339,346,12,20,685,"neutor",NA
"12/1/2015 21:00",205,335,11,22,540,"neutor",NA
"12/1/2015 22:00",152,270,11,24,422,"neutor",NA
"12/1/2015 23:00",83,169,11,24,252,"neutor",NA
"12/2/2015 0:00",27,86,11,24,113,"neutor",NA
"12/2/2015 1:00",24,24,11,24,48,"neutor",NA
"12/2/2015 2:00",13,6,11,24,19,"neutor",NA
"12/2/2015 3:00",8,8,11,24,16,"neutor",NA
"12/2/2015 4:00",16,6,11,20,22,"neutor",NA
"12/2/2015 5:00",42,5,11,19,47,"neutor",NA
"12/2/2015 6:00",121,36,11,17,157,"neutor",NA
"12/2/2015 7:00",516,315,11,19,831,"neutor",NA
"12/2/2015 8:00",718,532,10,17,1250,"neutor",NA
"12/2/2015 9:00",669,482,11,17,1151,"neutor",NA
"12/2/2015 10:00",700,385,11,20,1085,"neutor",NA
"12/2/2015 11:00",593,520,11,20,1113,"neutor",NA
"12/2/2015 12:00",642,448,11,17,1090,"neutor",NA
"12/2/2015 13:00",603,582,11,17,1185,"neutor",NA
"12/2/2015 14:00",649,516,11,15,1165,"neutor",NA
"12/2/2015 15:00",664,633,11,15,1297,"neutor",NA
"12/2/2015 16:00",711,552,11,19,1263,"neutor",NA
"12/2/2015 17:00",923,728,11,17,1651,"neutor",NA
"12/2/2015 18:00",763,570,10,15,1333,"neutor",NA
"12/2/2015 19:00",713,558,10,19,1271,"neutor",NA
"12/2/2015 20:00",381,477,10,17,858,"neutor",NA
"12/2/2015 21:00",215,366,10,17,581,"neutor",NA
"12/2/2015 22:00",167,319,10,15,486,"neutor",NA
"12/2/2015 23:00",164,211,9,15,375,"neutor",NA
"12/3/2015 0:00",68,138,9,13,206,"neutor",NA
"12/3/2015 1:00",30,135,9,11,165,"neutor",NA
"12/3/2015 2:00",31,83,9,13,114,"neutor",NA
"12/3/2015 3:00",6,52,9,11,58,"neutor",NA
"12/3/2015 4:00",13,27,9,13,40,"neutor",NA
"12/3/2015 5:00",45,17,9,13,62,"neutor",NA
"12/3/2015 6:00",124,42,9,11,166,"neutor",NA
"12/3/2015 7:00",495,357,8,9,852,"neutor",NA
"12/3/2015 8:00",713,498,9,11,1211,"neutor",NA
"12/3/2015 9:00",586,472,9,9,1058,"neutor",NA
"12/3/2015 10:00",650,327,10,13,977,"neutor",NA
"12/3/2015 11:00",579,517,10,17,1096,"neutor",NA
"12/3/2015 12:00",574,470,11,17,1044,"neutor",NA
"12/3/2015 13:00",656,583,11,11,1239,"neutor",NA
"12/3/2015 14:00",600,520,11,11,1120,"neutor",NA
"12/3/2015 15:00",681,641,10,6,1322,"neutor",NA
"12/3/2015 16:00",704,552,9,9,1256,"neutor",NA
"12/3/2015 17:00",955,637,9,15,1592,"neutor",NA
"12/3/2015 18:00",801,589,9,13,1390,"neutor",NA
"12/3/2015 19:00",506,571,8,13,1077,"neutor",NA
"12/3/2015 20:00",306,543,8,11,849,"neutor",NA
"12/3/2015 21:00",251,324,7,13,575,"neutor",NA
"12/3/2015 22:00",200,273,7,15,473,"neutor",NA
"12/3/2015 23:00",106,203,7,13,309,"neutor",NA
"12/4/2015 0:00",76,117,7,11,193,"neutor",NA
"12/4/2015 1:00",21,82,7,11,103,"neutor",NA
"12/4/2015 2:00",20,56,7,11,76,"neutor",NA
"12/4/2015 3:00",10,42,9,19,52,"neutor",NA
"12/4/2015 4:00",11,35,9,19,46,"neutor",NA
"12/4/2015 5:00",28,17,9,26,45,"neutor",NA
"12/4/2015 6:00",66,34,9,24,100,"neutor",NA
"12/4/2015 7:00",305,223,9,24,528,"neutor",NA
"12/4/2015 8:00",464,362,9,28,826,"neutor",NA
"12/4/2015 9:00",421,324,9,20,745,"neutor",NA
"12/4/2015 10:00",518,252,9,19,770,"neutor",NA
"12/4/2015 11:00",493,360,9,20,853,"neutor",NA
"12/4/2015 12:00",544,358,10,30,902,"neutor",NA
"12/4/2015 13:00",565,467,10,22,1032,"neutor",NA
"12/4/2015 14:00",508,423,10,24,931,"neutor",NA
"12/4/2015 15:00",509,378,9,20,887,"neutor",NA
"12/4/2015 16:00",448,361,8,20,809,"neutor",NA
"12/4/2015 17:00",491,357,9,20,848,"neutor",NA
"12/4/2015 18:00",434,376,9,22,810,"neutor",NA
"12/4/2015 19:00",329,318,8,20,647,"neutor",NA
"12/4/2015 20:00",262,328,8,20,590,"neutor",NA
"12/4/2015 21:00",172,286,8,19,458,"neutor",NA
"12/4/2015 22:00",124,259,8,24,383,"neutor",NA
"12/4/2015 23:00",133,270,8,22,403,"neutor",NA
"12/5/2015 0:00",129,213,8,20,342,"neutor",NA
"12/5/2015 1:00",130,152,8,20,282,"neutor",NA
"12/5/2015 2:00",121,103,7,20,224,"neutor",NA
"12/5/2015 3:00",98,69,8,22,167,"neutor",NA
"12/5/2015 4:00",85,52,8,22,137,"neutor",NA
"12/5/2015 5:00",49,38,7,19,87,"neutor",NA
"12/5/2015 6:00",30,31,7,20,61,"neutor",NA
"12/5/2015 7:00",87,35,7,26,122,"neutor",NA
"12/5/2015 8:00",187,76,7,30,263,"neutor",NA
"12/5/2015 9:00",239,106,7,28,345,"neutor",NA
"12/5/2015 10:00",343,108,7,26,451,"neutor",NA
"12/5/2015 11:00",340,153,8,28,493,"neutor",NA
"12/5/2015 12:00",382,204,8,28,586,"neutor",NA
"12/5/2015 13:00",357,201,9,26,558,"neutor",NA
"12/5/2015 14:00",275,228,9,24,503,"neutor",NA
"12/5/2015 15:00",288,288,9,22,576,"neutor",NA
"12/5/2015 16:00",269,270,9,24,539,"neutor",NA
"12/5/2015 17:00",299,259,9,20,558,"neutor",NA
"12/5/2015 18:00",242,236,9,20,478,"neutor",NA
"12/5/2015 19:00",229,224,9,24,453,"neutor",NA
"12/5/2015 20:00",170,221,8,24,391,"neutor",NA
"12/5/2015 21:00",119,232,8,22,351,"neutor",NA
"12/5/2015 22:00",112,121,7,22,233,"neutor",NA
"12/5/2015 23:00",111,136,7,19,247,"neutor",NA
"12/6/2015 0:00",93,152,7,24,245,"neutor",NA
"12/6/2015 1:00",111,105,8,26,216,"neutor",NA
"12/6/2015 2:00",39,107,8,22,146,"neutor",NA
"12/6/2015 3:00",39,77,8,24,116,"neutor",NA
"12/6/2015 4:00",31,48,8,28,79,"neutor",NA
"12/6/2015 5:00",19,32,8,24,51,"neutor",NA
"12/6/2015 6:00",14,18,8,30,32,"neutor",NA
"12/6/2015 7:00",21,15,8,30,36,"neutor",NA
"12/6/2015 8:00",43,17,8,28,60,"neutor",NA
"12/6/2015 9:00",122,47,9,28,169,"neutor",NA
"12/6/2015 10:00",196,81,9,20,277,"neutor",NA
"12/6/2015 11:00",167,77,10,22,244,"neutor",NA
"12/6/2015 12:00",158,131,11,26,289,"neutor",NA
"12/6/2015 13:00",228,120,12,28,348,"neutor",NA
"12/6/2015 14:00",211,166,12,26,377,"neutor",NA
"12/6/2015 15:00",216,196,12,22,412,"neutor",NA
"12/6/2015 16:00",181,213,12,28,394,"neutor",NA
"12/6/2015 17:00",237,223,12,22,460,"neutor",NA
"12/6/2015 18:00",283,151,10,26,434,"neutor",NA
"12/6/2015 19:00",146,171,10,22,317,"neutor",NA
"12/6/2015 20:00",105,216,10,22,321,"neutor",NA
"12/6/2015 21:00",67,132,10,19,199,"neutor",NA
"12/6/2015 22:00",59,115,11,15,174,"neutor",NA
"12/6/2015 23:00",24,71,11,17,95,"neutor",NA
"12/7/2015 0:00",9,29,11,17,38,"neutor",NA
"12/7/2015 1:00",9,18,11,17,27,"neutor",NA
"12/7/2015 2:00",2,9,11,17,11,"neutor",NA
"12/7/2015 3:00",5,1,11,17,6,"neutor",NA
"12/7/2015 4:00",6,10,10,15,16,"neutor",NA
"12/7/2015 5:00",31,12,10,9,43,"neutor",NA
"12/7/2015 6:00",84,42,10,13,126,"neutor",NA
"12/7/2015 7:00",431,260,10,7,691,"neutor",NA
"12/7/2015 8:00",540,407,10,6,947,"neutor",NA
"12/7/2015 9:00",493,390,10,7,883,"neutor",NA
"12/7/2015 10:00",576,337,10,7,913,"neutor",NA
"12/7/2015 11:00",419,529,11,7,948,"neutor",NA
"12/7/2015 12:00",446,424,11,6,870,"neutor",NA
"12/7/2015 13:00",580,545,12,6,1125,"neutor",NA
"12/7/2015 14:00",533,433,12,6,966,"neutor",NA
"12/7/2015 15:00",625,632,11,6,1257,"neutor",NA
"12/7/2015 16:00",695,572,11,9,1267,"neutor",NA
"12/7/2015 17:00",754,696,10,7,1450,"neutor",NA
"12/7/2015 18:00",718,530,9,2,1248,"neutor",NA
"12/7/2015 19:00",455,525,9,7,980,"neutor",NA
"12/7/2015 20:00",236,439,8,6,675,"neutor",NA
"12/7/2015 21:00",168,277,8,6,445,"neutor",NA
"12/7/2015 22:00",162,244,8,7,406,"neutor",NA
"12/7/2015 23:00",73,149,7,4,222,"neutor",NA
"12/8/2015 0:00",35,42,7,6,77,"neutor",NA
"12/8/2015 1:00",17,37,8,9,54,"neutor",NA
"12/8/2015 2:00",8,19,8,6,27,"neutor",NA
"12/8/2015 3:00",5,2,8,7,7,"neutor",NA
"12/8/2015 4:00",8,8,7,6,16,"neutor",NA
"12/8/2015 5:00",42,18,7,7,60,"neutor",NA
"12/8/2015 6:00",113,50,7,11,163,"neutor",NA
"12/8/2015 7:00",482,364,6,6,846,"neutor",NA
"12/8/2015 8:00",910,524,6,9,1434,"neutor",NA
"12/8/2015 9:00",629,549,7,11,1178,"neutor",NA
"12/8/2015 10:00",593,466,9,13,1059,"neutor",NA
"12/8/2015 11:00",545,474,11,13,1019,"neutor",NA
"12/8/2015 12:00",742,474,13,13,1216,"neutor",NA
"12/8/2015 13:00",710,593,14,11,1303,"neutor",NA
"12/8/2015 14:00",660,577,14,13,1237,"neutor",NA
"12/8/2015 15:00",732,618,13,11,1350,"neutor",NA
"12/8/2015 16:00",730,666,11,7,1396,"neutor",NA
"12/8/2015 17:00",890,727,11,11,1617,"neutor",NA
"12/8/2015 18:00",851,513,11,13,1364,"neutor",NA
"12/8/2015 19:00",553,552,11,13,1105,"neutor",NA
"12/8/2015 20:00",275,494,12,17,769,"neutor",NA
"12/8/2015 21:00",219,355,10,9,574,"neutor",NA
"12/8/2015 22:00",138,294,10,15,432,"neutor",NA
"12/8/2015 23:00",110,187,10,11,297,"neutor",NA
"12/9/2015 0:00",52,94,11,19,146,"neutor",NA
"12/9/2015 1:00",19,38,10,20,57,"neutor",NA
"12/9/2015 2:00",8,29,10,19,37,"neutor",NA
"12/9/2015 3:00",5,18,9,19,23,"neutor",NA
"12/9/2015 4:00",11,9,9,17,20,"neutor",NA
"12/9/2015 5:00",39,19,8,17,58,"neutor",NA
"12/9/2015 6:00",132,44,8,15,176,"neutor",NA
"12/9/2015 7:00",551,341,8,15,892,"neutor",NA
"12/9/2015 8:00",791,523,7,15,1314,"neutor",NA
"12/9/2015 9:00",631,531,7,17,1162,"neutor",NA
"12/9/2015 10:00",709,411,8,19,1120,"neutor",NA
"12/9/2015 11:00",584,493,8,19,1077,"neutor",NA
"12/9/2015 12:00",667,457,9,22,1124,"neutor",NA
"12/9/2015 13:00",658,567,9,24,1225,"neutor",NA
"12/9/2015 14:00",691,497,8,22,1188,"neutor",NA
"12/9/2015 15:00",590,634,8,9,1224,"neutor",NA
"12/9/2015 16:00",688,558,7,9,1246,"neutor",NA
"12/9/2015 17:00",878,671,6,13,1549,"neutor",NA
"12/9/2015 18:00",842,555,6,11,1397,"neutor",NA
"12/9/2015 19:00",574,576,6,13,1150,"neutor",NA
"12/9/2015 20:00",364,485,6,11,849,"neutor",NA
"12/9/2015 21:00",228,360,5,11,588,"neutor",NA
"12/9/2015 22:00",208,315,5,15,523,"neutor",NA
"12/9/2015 23:00",161,236,5,15,397,"neutor",NA
"12/10/2015 0:00",105,133,5,11,238,"neutor",NA
"12/10/2015 1:00",50,111,5,13,161,"neutor",NA
"12/10/2015 2:00",23,39,5,15,62,"neutor",NA
"12/10/2015 3:00",8,66,5,17,74,"neutor",NA
"12/10/2015 4:00",15,31,5,19,46,"neutor",NA
"12/10/2015 5:00",44,27,4,15,71,"neutor",NA
"12/10/2015 6:00",101,37,4,19,138,"neutor",NA
"12/10/2015 7:00",502,336,4,17,838,"neutor",NA
"12/10/2015 8:00",665,503,4,15,1168,"neutor",NA
"12/10/2015 9:00",588,433,5,19,1021,"neutor",NA
"12/10/2015 10:00",651,344,6,20,995,"neutor",NA
"12/10/2015 11:00",575,540,7,24,1115,"neutor",NA
"12/10/2015 12:00",664,467,7,20,1131,"neutor",NA
"12/10/2015 13:00",588,620,8,20,1208,"neutor",NA
"12/10/2015 14:00",587,567,8,17,1154,"neutor",NA
"12/10/2015 15:00",726,603,7,17,1329,"neutor",NA
"12/10/2015 16:00",748,574,7,17,1322,"neutor",NA
"12/10/2015 17:00",847,646,6,17,1493,"neutor",NA
"12/10/2015 18:00",756,585,6,15,1341,"neutor",NA
"12/10/2015 19:00",512,610,5,19,1122,"neutor",NA
"12/10/2015 20:00",274,415,5,19,689,"neutor",NA
"12/10/2015 21:00",238,324,5,17,562,"neutor",NA
"12/10/2015 22:00",185,293,5,20,478,"neutor",NA
"12/10/2015 23:00",128,208,5,19,336,"neutor",NA
"12/11/2015 0:00",110,114,6,15,224,"neutor",NA
"12/11/2015 1:00",48,65,6,19,113,"neutor",NA
"12/11/2015 2:00",18,50,4,22,68,"neutor",NA
"12/11/2015 3:00",14,36,5,19,50,"neutor",NA
"12/11/2015 4:00",16,25,4,19,41,"neutor",NA
"12/11/2015 5:00",28,17,5,20,45,"neutor",NA
"12/11/2015 6:00",58,24,5,20,82,"neutor",NA
"12/11/2015 7:00",346,219,5,22,565,"neutor",NA
"12/11/2015 8:00",447,313,5,24,760,"neutor",NA
"12/11/2015 9:00",435,314,6,26,749,"neutor",NA
"12/11/2015 10:00",472,265,7,26,737,"neutor",NA
"12/11/2015 11:00",428,316,7,22,744,"neutor",NA
"12/11/2015 12:00",459,345,7,26,804,"neutor",NA
"12/11/2015 13:00",446,361,7,24,807,"neutor",NA
"12/11/2015 14:00",406,339,7,20,745,"neutor",NA
"12/11/2015 15:00",390,329,8,24,719,"neutor",NA
"12/11/2015 16:00",407,326,8,24,733,"neutor",NA
"12/11/2015 17:00",428,319,8,24,747,"neutor",NA
"12/11/2015 18:00",439,287,8,32,726,"neutor",NA
"12/11/2015 19:00",355,300,7,13,655,"neutor",NA
"12/11/2015 20:00",194,228,7,22,422,"neutor",NA
"12/11/2015 21:00",202,240,6,20,442,"neutor",NA
"12/11/2015 22:00",140,167,6,17,307,"neutor",NA
"12/11/2015 23:00",116,152,6,17,268,"neutor",NA
"12/12/2015 0:00",138,186,5,15,324,"neutor",NA
"12/12/2015 1:00",110,156,5,13,266,"neutor",NA
"12/12/2015 2:00",47,104,5,15,151,"neutor",NA
"12/12/2015 3:00",33,88,5,15,121,"neutor",NA
"12/12/2015 4:00",24,64,5,17,88,"neutor",NA
"12/12/2015 5:00",19,26,4,15,45,"neutor",NA
"12/12/2015 6:00",36,30,4,17,66,"neutor",NA
"12/12/2015 7:00",97,21,5,17,118,"neutor",NA
"12/12/2015 8:00",242,94,5,17,336,"neutor",NA
"12/12/2015 9:00",274,125,5,15,399,"neutor",NA
"12/12/2015 10:00",401,165,5,13,566,"neutor",NA
"12/12/2015 11:00",391,153,6,15,544,"neutor",NA
"12/12/2015 12:00",377,221,7,13,598,"neutor",NA
"12/12/2015 13:00",390,246,7,7,636,"neutor",NA
"12/12/2015 14:00",304,267,7,7,571,"neutor",NA
"12/12/2015 15:00",342,273,7,7,615,"neutor",NA
"12/12/2015 16:00",261,257,7,11,518,"neutor",NA
"12/12/2015 17:00",254,320,7,11,574,"neutor",NA
"12/12/2015 18:00",221,277,6,15,498,"neutor",NA
"12/12/2015 19:00",203,211,7,19,414,"neutor",NA
"12/12/2015 20:00",196,266,9,26,462,"neutor",NA
"12/12/2015 21:00",143,152,10,30,295,"neutor",NA
"12/12/2015 22:00",102,147,10,37,249,"neutor",NA
"12/12/2015 23:00",97,158,11,41,255,"neutor",NA
"12/13/2015 0:00",112,118,11,35,230,"neutor",NA
"12/13/2015 1:00",133,122,10,44,255,"neutor",NA
"12/13/2015 2:00",82,76,10,35,158,"neutor",NA
"12/13/2015 3:00",56,87,10,39,143,"neutor",NA
"12/13/2015 4:00",47,61,9,33,108,"neutor",NA
"12/13/2015 5:00",21,29,8,26,50,"neutor",NA
"12/13/2015 6:00",23,7,7,20,30,"neutor",NA
"12/13/2015 7:00",26,13,7,9,39,"neutor",NA
"12/13/2015 8:00",34,27,6,11,61,"neutor",NA
"12/13/2015 9:00",147,33,6,11,180,"neutor",NA
"12/13/2015 10:00",218,67,7,11,285,"neutor",NA
"12/13/2015 11:00",184,93,7,13,277,"neutor",NA
"12/13/2015 12:00",240,131,8,9,371,"neutor",NA
"12/13/2015 13:00",258,147,8,7,405,"neutor",NA
"12/13/2015 14:00",270,194,8,6,464,"neutor",NA
"12/13/2015 15:00",306,224,6,4,530,"neutor",NA
"12/13/2015 16:00",320,242,4,4,562,"neutor",NA
"12/13/2015 17:00",221,250,3,4,471,"neutor",NA
"12/13/2015 18:00",209,345,2,0,554,"neutor",NA
"12/13/2015 19:00",183,221,2,2,404,"neutor",NA
"12/13/2015 20:00",94,205,2,4,299,"neutor",NA
"12/13/2015 21:00",71,141,3,6,212,"neutor",NA
"12/13/2015 22:00",83,130,3,4,213,"neutor",NA
"12/13/2015 23:00",39,83,3,6,122,"neutor",NA
"12/14/2015 0:00",25,41,3,6,66,"neutor",NA
"12/14/2015 1:00",13,15,3,6,28,"neutor",NA
"12/14/2015 2:00",1,2,3,6,3,"neutor",NA
"12/14/2015 3:00",4,1,4,6,5,"neutor",NA
"12/14/2015 4:00",11,2,4,6,13,"neutor",NA
"12/14/2015 5:00",36,12,4,6,48,"neutor",NA
"12/14/2015 6:00",106,38,4,6,144,"neutor",NA
"12/14/2015 7:00",444,266,5,6,710,"neutor",NA
"12/14/2015 8:00",615,440,5,7,1055,"neutor",NA
"12/14/2015 9:00",535,435,5,6,970,"neutor",NA
"12/14/2015 10:00",536,321,6,6,857,"neutor",NA
"12/14/2015 11:00",455,481,6,7,936,"neutor",NA
"12/14/2015 12:00",492,397,7,7,889,"neutor",NA
"12/14/2015 13:00",592,527,8,6,1119,"neutor",NA
"12/14/2015 14:00",514,421,8,9,935,"neutor",NA
"12/14/2015 15:00",661,616,8,6,1277,"neutor",NA
"12/14/2015 16:00",660,544,8,6,1204,"neutor",NA
"12/14/2015 17:00",948,630,8,6,1578,"neutor",NA
"12/14/2015 18:00",665,599,8,6,1264,"neutor",NA
"12/14/2015 19:00",480,545,9,11,1025,"neutor",NA
"12/14/2015 20:00",231,465,9,9,696,"neutor",NA
"12/14/2015 21:00",171,246,8,7,417,"neutor",NA
"12/14/2015 22:00",191,238,8,9,429,"neutor",NA
"12/14/2015 23:00",95,162,7,9,257,"neutor",NA
"12/15/2015 0:00",32,81,7,9,113,"neutor",NA
"12/15/2015 1:00",14,23,6,4,37,"neutor",NA
"12/15/2015 2:00",13,20,4,4,33,"neutor",NA
"12/15/2015 3:00",8,6,5,6,14,"neutor",NA
"12/15/2015 4:00",15,7,5,6,22,"neutor",NA
"12/15/2015 5:00",49,12,4,2,61,"neutor",NA
"12/15/2015 6:00",102,48,4,2,150,"neutor",NA
"12/15/2015 7:00",444,332,5,4,776,"neutor",NA
"12/15/2015 8:00",815,524,5,4,1339,"neutor",NA
"12/15/2015 9:00",579,500,5,2,1079,"neutor",NA
"12/15/2015 10:00",622,434,6,4,1056,"neutor",NA
"12/15/2015 11:00",514,557,7,2,1071,"neutor",NA
"12/15/2015 12:00",635,453,8,4,1088,"neutor",NA
"12/15/2015 13:00",630,563,8,4,1193,"neutor",NA
"12/15/2015 14:00",599,472,7,2,1071,"neutor",NA
"12/15/2015 15:00",678,597,7,4,1275,"neutor",NA
"12/15/2015 16:00",720,514,6,4,1234,"neutor",NA
"12/15/2015 17:00",869,636,6,6,1505,"neutor",NA
"12/15/2015 18:00",704,636,6,6,1340,"neutor",NA
"12/15/2015 19:00",516,586,6,7,1102,"neutor",NA
"12/15/2015 20:00",318,506,6,6,824,"neutor",NA
"12/15/2015 21:00",271,291,7,7,562,"neutor",NA
"12/15/2015 22:00",201,306,7,7,507,"neutor",NA
"12/15/2015 23:00",142,213,7,7,355,"neutor",NA
"12/16/2015 0:00",65,131,6,6,196,"neutor",NA
"12/16/2015 1:00",39,94,6,9,133,"neutor",NA
"12/16/2015 2:00",4,11,6,9,15,"neutor",NA
"12/16/2015 3:00",17,9,5,9,26,"neutor",NA
"12/16/2015 4:00",17,10,5,9,27,"neutor",NA
"12/16/2015 5:00",36,14,6,11,50,"neutor",NA
"12/16/2015 6:00",116,38,7,11,154,"neutor",NA
"12/16/2015 7:00",461,269,7,9,730,"neutor",NA
"12/16/2015 8:00",524,448,7,9,972,"neutor",NA
"12/16/2015 9:00",457,337,8,13,794,"neutor",NA
"12/16/2015 10:00",534,318,8,11,852,"neutor",NA
"12/16/2015 11:00",407,342,9,11,749,"neutor",NA
"12/16/2015 12:00",532,405,10,11,937,"neutor",NA
"12/16/2015 13:00",536,460,10,11,996,"neutor",NA
"12/16/2015 14:00",493,428,11,13,921,"neutor",NA
"12/16/2015 15:00",518,504,11,13,1022,"neutor",NA
"12/16/2015 16:00",563,464,11,13,1027,"neutor",NA
"12/16/2015 17:00",617,539,11,13,1156,"neutor",NA
"12/16/2015 18:00",604,485,11,13,1089,"neutor",NA
"12/16/2015 19:00",566,415,12,15,981,"neutor",NA
"12/16/2015 20:00",261,400,12,15,661,"neutor",NA
"12/16/2015 21:00",204,343,12,15,547,"neutor",NA
"12/16/2015 22:00",166,277,12,15,443,"neutor",NA
"12/16/2015 23:00",203,179,12,15,382,"neutor",NA
"12/17/2015 0:00",275,127,12,17,402,"neutor",NA
"12/17/2015 1:00",115,105,12,19,220,"neutor",NA
"12/17/2015 2:00",29,96,12,15,125,"neutor",NA
"12/17/2015 3:00",25,132,12,11,157,"neutor",NA
"12/17/2015 4:00",33,147,12,11,180,"neutor",NA
"12/17/2015 5:00",36,76,13,15,112,"neutor",NA
"12/17/2015 6:00",84,57,13,15,141,"neutor",NA
"12/17/2015 7:00",389,254,13,17,643,"neutor",NA
"12/17/2015 8:00",540,376,13,13,916,"neutor",NA
"12/17/2015 9:00",460,362,13,9,822,"neutor",NA
"12/17/2015 10:00",489,362,14,17,851,"neutor",NA
"12/17/2015 11:00",515,460,14,15,975,"neutor",NA
"12/17/2015 12:00",593,441,15,15,1034,"neutor",NA
"12/17/2015 13:00",540,597,15,15,1137,"neutor",NA
"12/17/2015 14:00",612,518,15,15,1130,"neutor",NA
"12/17/2015 15:00",659,577,14,9,1236,"neutor",NA
"12/17/2015 16:00",747,559,13,9,1306,"neutor",NA
"12/17/2015 17:00",793,564,13,9,1357,"neutor",NA
"12/17/2015 18:00",749,612,13,9,1361,"neutor",NA
"12/17/2015 19:00",426,540,12,7,966,"neutor",NA
"12/17/2015 20:00",253,455,12,9,708,"neutor",NA
"12/17/2015 21:00",202,295,13,11,497,"neutor",NA
"12/17/2015 22:00",210,261,13,11,471,"neutor",NA
"12/17/2015 23:00",137,273,13,11,410,"neutor",NA
"12/18/2015 0:00",106,138,14,13,244,"neutor",NA
"12/18/2015 1:00",68,109,14,13,177,"neutor",NA
"12/18/2015 2:00",19,60,13,13,79,"neutor",NA
"12/18/2015 3:00",26,56,14,19,82,"neutor",NA
"12/18/2015 4:00",17,47,12,20,64,"neutor",NA
"12/18/2015 5:00",35,42,12,17,77,"neutor",NA
"12/18/2015 6:00",114,42,12,17,156,"neutor",NA
"12/18/2015 7:00",410,244,12,24,654,"neutor",NA
"12/18/2015 8:00",510,408,12,19,918,"neutor",NA
"12/18/2015 9:00",480,324,12,17,804,"neutor",NA
"12/18/2015 10:00",564,321,12,20,885,"neutor",NA
"12/18/2015 11:00",511,364,12,20,875,"neutor",NA
"12/18/2015 12:00",575,414,12,17,989,"neutor",NA
"12/18/2015 13:00",571,491,12,19,1062,"neutor",NA
"12/18/2015 14:00",509,446,12,15,955,"neutor",NA
"12/18/2015 15:00",523,445,12,15,968,"neutor",NA
"12/18/2015 16:00",452,433,12,15,885,"neutor",NA
"12/18/2015 17:00",445,430,12,13,875,"neutor",NA
"12/18/2015 18:00",477,430,12,11,907,"neutor",NA
"12/18/2015 19:00",351,328,12,11,679,"neutor",NA
"12/18/2015 20:00",278,300,11,11,578,"neutor",NA
"12/18/2015 21:00",216,250,11,9,466,"neutor",NA
"12/18/2015 22:00",136,196,11,9,332,"neutor",NA
"12/18/2015 23:00",116,207,11,11,323,"neutor",NA
"12/19/2015 0:00",106,196,11,11,302,"neutor",NA
"12/19/2015 1:00",105,205,11,11,310,"neutor",NA
"12/19/2015 2:00",66,168,11,11,234,"neutor",NA
"12/19/2015 3:00",55,116,11,13,171,"neutor",NA
"12/19/2015 4:00",39,72,12,15,111,"neutor",NA
"12/19/2015 5:00",31,48,12,15,79,"neutor",NA
"12/19/2015 6:00",45,17,12,13,62,"neutor",NA
"12/19/2015 7:00",63,27,12,13,90,"neutor",NA
"12/19/2015 8:00",130,61,11,13,191,"neutor",NA
"12/19/2015 9:00",259,56,12,13,315,"neutor",NA
"12/19/2015 10:00",380,127,12,13,507,"neutor",NA
"12/19/2015 11:00",407,174,13,15,581,"neutor",NA
"12/19/2015 12:00",459,259,13,13,718,"neutor",NA
"12/19/2015 13:00",459,242,14,17,701,"neutor",NA
"12/19/2015 14:00",323,343,14,17,666,"neutor",NA
"12/19/2015 15:00",335,304,14,11,639,"neutor",NA
"12/19/2015 16:00",294,313,14,13,607,"neutor",NA
"12/19/2015 17:00",265,306,14,13,571,"neutor",NA
"12/19/2015 18:00",257,306,14,13,563,"neutor",NA
"12/19/2015 19:00",232,287,13,17,519,"neutor",NA
"12/19/2015 20:00",207,255,13,17,462,"neutor",NA
"12/19/2015 21:00",130,251,12,17,381,"neutor",NA
"12/19/2015 22:00",96,165,11,13,261,"neutor",NA
"12/19/2015 23:00",105,161,11,11,266,"neutor",NA
"12/20/2015 0:00",114,146,11,13,260,"neutor",NA
"12/20/2015 1:00",109,178,10,11,287,"neutor",NA
"12/20/2015 2:00",88,123,10,11,211,"neutor",NA
"12/20/2015 3:00",62,101,10,11,163,"neutor",NA
"12/20/2015 4:00",30,73,10,11,103,"neutor",NA
"12/20/2015 5:00",31,46,11,13,77,"neutor",NA
"12/20/2015 6:00",16,20,10,9,36,"neutor",NA
"12/20/2015 7:00",19,18,11,15,37,"neutor",NA
"12/20/2015 8:00",32,22,10,9,54,"neutor",NA
"12/20/2015 9:00",115,63,11,7,178,"neutor",NA
"12/20/2015 10:00",224,79,12,11,303,"neutor",NA
"12/20/2015 11:00",167,120,13,15,287,"neutor",NA
"12/20/2015 12:00",184,152,14,13,336,"neutor",NA
"12/20/2015 13:00",257,166,14,20,423,"neutor",NA
"12/20/2015 14:00",278,187,14,17,465,"neutor",NA
"12/20/2015 15:00",279,153,13,9,432,"neutor",NA
"12/20/2015 16:00",286,237,12,11,523,"neutor",NA
"12/20/2015 17:00",323,211,12,11,534,"neutor",NA
"12/20/2015 18:00",243,240,12,9,483,"neutor",NA
"12/20/2015 19:00",190,206,11,11,396,"neutor",NA
"12/20/2015 20:00",118,247,12,11,365,"neutor",NA
"12/20/2015 21:00",59,137,12,13,196,"neutor",NA
"12/20/2015 22:00",92,154,12,9,246,"neutor",NA
"12/20/2015 23:00",60,86,13,15,146,"neutor",NA
"12/21/2015 0:00",32,50,12,17,82,"neutor",NA
"12/21/2015 1:00",21,33,12,17,54,"neutor",NA
"12/21/2015 2:00",11,7,11,15,18,"neutor",NA
"12/21/2015 3:00",9,8,11,20,17,"neutor",NA
"12/21/2015 4:00",11,12,11,15,23,"neutor",NA
"12/21/2015 5:00",18,13,11,17,31,"neutor",NA
"12/21/2015 6:00",63,29,11,19,92,"neutor",NA
"12/21/2015 7:00",318,164,10,19,482,"neutor",NA
"12/21/2015 8:00",455,280,9,17,735,"neutor",NA
"12/21/2015 9:00",463,292,10,24,755,"neutor",NA
"12/21/2015 10:00",506,314,11,28,820,"neutor",NA
"12/21/2015 11:00",504,413,11,30,917,"neutor",NA
"12/21/2015 12:00",485,417,11,28,902,"neutor",NA
"12/21/2015 13:00",534,448,11,32,982,"neutor",NA
"12/21/2015 14:00",487,438,11,32,925,"neutor",NA
"12/21/2015 15:00",655,464,11,30,1119,"neutor",NA
"12/21/2015 16:00",532,492,11,32,1024,"neutor",NA
"12/21/2015 17:00",693,507,11,28,1200,"neutor",NA
"12/21/2015 18:00",502,504,11,30,1006,"neutor",NA
"12/21/2015 19:00",328,419,10,35,747,"neutor",NA
"12/21/2015 20:00",156,285,10,33,441,"neutor",NA
"12/21/2015 21:00",99,201,10,32,300,"neutor",NA
"12/21/2015 22:00",119,178,11,33,297,"neutor",NA
"12/21/2015 23:00",100,135,11,30,235,"neutor",NA
"12/22/2015 0:00",36,105,11,24,141,"neutor",NA
"12/22/2015 1:00",20,103,11,19,123,"neutor",NA
"12/22/2015 2:00",15,51,11,15,66,"neutor",NA
"12/22/2015 3:00",14,15,11,19,29,"neutor",NA
"12/22/2015 4:00",10,11,11,19,21,"neutor",NA
"12/22/2015 5:00",26,13,11,13,39,"neutor",NA
"12/22/2015 6:00",69,35,12,19,104,"neutor",NA
"12/22/2015 7:00",260,167,11,26,427,"neutor",NA
"12/22/2015 8:00",302,240,11,24,542,"neutor",NA
"12/22/2015 9:00",358,283,11,26,641,"neutor",NA
"12/22/2015 10:00",371,239,12,28,610,"neutor",NA
"12/22/2015 11:00",436,272,13,33,708,"neutor",NA
"12/22/2015 12:00",471,372,13,35,843,"neutor",NA
"12/22/2015 13:00",450,381,14,32,831,"neutor",NA
"12/22/2015 14:00",396,369,14,28,765,"neutor",NA
"12/22/2015 15:00",466,358,14,28,824,"neutor",NA
"12/22/2015 16:00",448,371,14,28,819,"neutor",NA
"12/22/2015 17:00",460,417,14,24,877,"neutor",NA
"12/22/2015 18:00",328,338,14,32,666,"neutor",NA
"12/22/2015 19:00",251,328,14,26,579,"neutor",NA
"12/22/2015 20:00",181,238,14,28,419,"neutor",NA
"12/22/2015 21:00",102,130,14,26,232,"neutor",NA
"12/22/2015 22:00",116,136,14,30,252,"neutor",NA
"12/22/2015 23:00",66,130,14,32,196,"neutor",NA
"12/23/2015 0:00",52,89,13,30,141,"neutor",NA
"12/23/2015 1:00",29,111,13,22,140,"neutor",NA
"12/23/2015 2:00",14,72,13,24,86,"neutor",NA
"12/23/2015 3:00",6,26,13,32,32,"neutor",NA
"12/23/2015 4:00",25,23,13,32,48,"neutor",NA
"12/23/2015 5:00",21,15,12,30,36,"neutor",NA
"12/23/2015 6:00",63,20,12,26,83,"neutor",NA
"12/23/2015 7:00",154,88,12,33,242,"neutor",NA
"12/23/2015 8:00",165,91,11,22,256,"neutor",NA
"12/23/2015 9:00",240,123,11,28,363,"neutor",NA
"12/23/2015 10:00",272,130,12,30,402,"neutor",NA
"12/23/2015 11:00",300,208,12,32,508,"neutor",NA
"12/23/2015 12:00",274,217,12,30,491,"neutor",NA
"12/23/2015 13:00",251,234,12,35,485,"neutor",NA
"12/23/2015 14:00",213,238,12,35,451,"neutor",NA
"12/23/2015 15:00",278,218,11,30,496,"neutor",NA
"12/23/2015 16:00",242,251,9,15,493,"neutor",NA
"12/23/2015 17:00",209,241,9,9,450,"neutor",NA
"12/23/2015 18:00",199,164,7,6,363,"neutor",NA
"12/23/2015 19:00",133,139,7,9,272,"neutor",NA
"12/23/2015 20:00",109,132,7,9,241,"neutor",NA
"12/23/2015 21:00",106,62,6,9,168,"neutor",NA
"12/23/2015 22:00",56,72,6,9,128,"neutor",NA
"12/23/2015 23:00",59,84,6,9,143,"neutor",NA
"12/24/2015 0:00",53,79,7,13,132,"neutor",NA
"12/24/2015 1:00",19,102,6,11,121,"neutor",NA
"12/24/2015 2:00",16,69,7,15,85,"neutor",NA
"12/24/2015 3:00",13,54,7,15,67,"neutor",NA
"12/24/2015 4:00",21,13,6,15,34,"neutor",NA
"12/24/2015 5:00",18,22,6,11,40,"neutor",NA
"12/24/2015 6:00",33,21,7,15,54,"neutor",NA
"12/24/2015 7:00",36,17,8,15,53,"neutor",NA
"12/24/2015 8:00",68,37,7,13,105,"neutor",NA
"12/24/2015 9:00",111,38,8,13,149,"neutor",NA
"12/24/2015 10:00",154,76,9,11,230,"neutor",NA
"12/24/2015 11:00",141,100,11,15,241,"neutor",NA
"12/24/2015 12:00",98,110,12,17,208,"neutor",NA
"12/24/2015 13:00",73,114,13,22,187,"neutor",NA
"12/24/2015 14:00",83,70,13,19,153,"neutor",NA
"12/24/2015 15:00",84,59,13,22,143,"neutor",NA
"12/24/2015 16:00",112,67,13,22,179,"neutor",NA
"12/24/2015 17:00",44,47,13,24,91,"neutor",NA
"12/24/2015 18:00",30,46,13,24,76,"neutor",NA
"12/24/2015 19:00",23,36,13,32,59,"neutor",NA
"12/24/2015 20:00",14,14,13,26,28,"neutor",NA
"12/24/2015 21:00",20,19,9,37,39,"neutor",NA
"12/24/2015 22:00",26,10,9,19,36,"neutor",NA
"12/24/2015 23:00",21,20,9,17,41,"neutor",NA
"12/25/2015 0:00",23,24,9,20,47,"neutor",NA
"12/25/2015 1:00",10,16,9,20,26,"neutor",NA
"12/25/2015 2:00",5,7,9,19,12,"neutor",NA
"12/25/2015 3:00",1,5,8,15,6,"neutor",NA
"12/25/2015 4:00",5,3,9,20,8,"neutor",NA
"12/25/2015 5:00",3,8,8,19,11,"neutor",NA
"12/25/2015 6:00",10,8,8,15,18,"neutor",NA
"12/25/2015 7:00",9,2,7,15,11,"neutor",NA
"12/25/2015 8:00",4,11,7,13,15,"neutor",NA
"12/25/2015 9:00",28,8,8,15,36,"neutor",NA
"12/25/2015 10:00",21,28,8,13,49,"neutor",NA
"12/25/2015 11:00",50,31,9,17,81,"neutor",NA
"12/25/2015 12:00",50,39,9,15,89,"neutor",NA
"12/25/2015 13:00",58,43,10,15,101,"neutor",NA
"12/25/2015 14:00",49,32,10,9,81,"neutor",NA
"12/25/2015 15:00",51,50,9,11,101,"neutor",NA
"12/25/2015 16:00",33,44,8,13,77,"neutor",NA
"12/25/2015 17:00",45,38,8,11,83,"neutor",NA
"12/25/2015 18:00",45,26,8,11,71,"neutor",NA
"12/25/2015 19:00",50,27,9,15,77,"neutor",NA
"12/25/2015 20:00",28,27,11,20,55,"neutor",NA
"12/25/2015 21:00",40,30,13,32,70,"neutor",NA
"12/25/2015 22:00",34,23,13,24,57,"neutor",NA
"12/25/2015 23:00",14,27,13,26,41,"neutor",NA
"12/26/2015 0:00",23,24,13,30,47,"neutor",NA
"12/26/2015 1:00",7,9,14,35,16,"neutor",NA
"12/26/2015 2:00",11,15,14,32,26,"neutor",NA
"12/26/2015 3:00",6,9,14,33,15,"neutor",NA
"12/26/2015 4:00",0,6,14,33,6,"neutor",NA
"12/26/2015 5:00",2,6,13,30,8,"neutor",NA
"12/26/2015 6:00",8,5,14,35,13,"neutor",NA
"12/26/2015 7:00",7,6,13,32,13,"neutor",NA
"12/26/2015 8:00",10,15,13,30,25,"neutor",NA
"12/26/2015 9:00",44,18,13,32,62,"neutor",NA
"12/26/2015 10:00",47,24,14,28,71,"neutor",NA
"12/26/2015 11:00",73,46,14,24,119,"neutor",NA
"12/26/2015 12:00",66,52,14,26,118,"neutor",NA
"12/26/2015 13:00",84,51,14,26,135,"neutor",NA
"12/26/2015 14:00",71,59,14,28,130,"neutor",NA
"12/26/2015 15:00",73,61,14,24,134,"neutor",NA
"12/26/2015 16:00",62,63,13,19,125,"neutor",NA
"12/26/2015 17:00",55,46,13,19,101,"neutor",NA
"12/26/2015 18:00",69,49,13,19,118,"neutor",NA
"12/26/2015 19:00",54,48,13,19,102,"neutor",NA
"12/26/2015 20:00",68,41,13,22,109,"neutor",NA
"12/26/2015 21:00",62,40,12,17,102,"neutor",NA
"12/26/2015 22:00",53,48,12,19,101,"neutor",NA
"12/26/2015 23:00",47,35,12,19,82,"neutor",NA
"12/27/2015 0:00",26,39,11,20,65,"neutor",NA
"12/27/2015 1:00",14,32,11,22,46,"neutor",NA
"12/27/2015 2:00",5,41,11,17,46,"neutor",NA
"12/27/2015 3:00",7,36,11,19,43,"neutor",NA
"12/27/2015 4:00",9,18,11,19,27,"neutor",NA
"12/27/2015 5:00",6,19,11,19,25,"neutor",NA
"12/27/2015 6:00",13,10,11,19,23,"neutor",NA
"12/27/2015 7:00",18,7,11,19,25,"neutor",NA
"12/27/2015 8:00",13,10,11,20,23,"neutor",NA
"12/27/2015 9:00",51,21,11,19,72,"neutor",NA
"12/27/2015 10:00",76,37,11,17,113,"neutor",NA
"12/27/2015 11:00",65,36,12,24,101,"neutor",NA
"12/27/2015 12:00",84,69,12,24,153,"neutor",NA
"12/27/2015 13:00",108,79,13,22,187,"neutor",NA
"12/27/2015 14:00",122,84,12,22,206,"neutor",NA
"12/27/2015 15:00",102,87,13,22,189,"neutor",NA
"12/27/2015 16:00",82,55,13,24,137,"neutor",NA
"12/27/2015 17:00",90,74,13,20,164,"neutor",NA
"12/27/2015 18:00",81,61,12,20,142,"neutor",NA
"12/27/2015 19:00",98,78,13,20,176,"neutor",NA
"12/27/2015 20:00",65,69,13,17,134,"neutor",NA
"12/27/2015 21:00",28,38,12,19,66,"neutor",NA
"12/27/2015 22:00",31,57,12,17,88,"neutor",NA
"12/27/2015 23:00",27,65,12,11,92,"neutor",NA
"12/28/2015 0:00",12,25,12,11,37,"neutor",NA
"12/28/2015 1:00",10,17,12,9,27,"neutor",NA
"12/28/2015 2:00",4,15,12,7,19,"neutor",NA
"12/28/2015 3:00",6,3,11,6,9,"neutor",NA
"12/28/2015 4:00",7,4,11,7,11,"neutor",NA
"12/28/2015 5:00",25,8,9,4,33,"neutor",NA
"12/28/2015 6:00",51,19,8,7,70,"neutor",NA
"12/28/2015 7:00",95,60,9,6,155,"neutor",NA
"12/28/2015 8:00",95,52,9,6,147,"neutor",NA
"12/28/2015 9:00",153,54,9,6,207,"neutor",NA
"12/28/2015 10:00",165,84,10,6,249,"neutor",NA
"12/28/2015 11:00",194,103,12,7,297,"neutor",NA
"12/28/2015 12:00",214,144,12,13,358,"neutor",NA
"12/28/2015 13:00",265,143,12,9,408,"neutor",NA
"12/28/2015 14:00",255,186,12,7,441,"neutor",NA
"12/28/2015 15:00",234,246,12,9,480,"neutor",NA
"12/28/2015 16:00",218,220,11,11,438,"neutor",NA
"12/28/2015 17:00",187,237,11,9,424,"neutor",NA
"12/28/2015 18:00",165,153,10,11,318,"neutor",NA
"12/28/2015 19:00",145,143,10,11,288,"neutor",NA
"12/28/2015 20:00",89,122,10,13,211,"neutor",NA
"12/28/2015 21:00",59,69,9,13,128,"neutor",NA
"12/28/2015 22:00",42,78,9,11,120,"neutor",NA
"12/28/2015 23:00",42,72,8,15,114,"neutor",NA
"12/29/2015 0:00",17,51,9,15,68,"neutor",NA
"12/29/2015 1:00",14,53,8,13,67,"neutor",NA
"12/29/2015 2:00",8,29,8,11,37,"neutor",NA
"12/29/2015 3:00",1,9,8,9,10,"neutor",NA
"12/29/2015 4:00",7,8,7,9,15,"neutor",NA
"12/29/2015 5:00",28,9,7,7,37,"neutor",NA
"12/29/2015 6:00",53,20,7,11,73,"neutor",NA
"12/29/2015 7:00",70,49,6,9,119,"neutor",NA
"12/29/2015 8:00",117,58,6,6,175,"neutor",NA
"12/29/2015 9:00",197,54,6,7,251,"neutor",NA
"12/29/2015 10:00",175,74,8,11,249,"neutor",NA
"12/29/2015 11:00",168,127,9,11,295,"neutor",NA
"12/29/2015 12:00",217,140,10,11,357,"neutor",NA
"12/29/2015 13:00",246,159,11,9,405,"neutor",NA
"12/29/2015 14:00",219,198,10,7,417,"neutor",NA
"12/29/2015 15:00",228,216,10,6,444,"neutor",NA
"12/29/2015 16:00",213,198,10,7,411,"neutor",NA
"12/29/2015 17:00",217,244,10,9,461,"neutor",NA
"12/29/2015 18:00",186,205,10,6,391,"neutor",NA
"12/29/2015 19:00",153,152,9,6,305,"neutor",NA
"12/29/2015 20:00",108,109,9,7,217,"neutor",NA
"12/29/2015 21:00",74,92,9,7,166,"neutor",NA
"12/29/2015 22:00",56,80,9,9,136,"neutor",NA
"12/29/2015 23:00",30,67,8,7,97,"neutor",NA
"12/30/2015 0:00",21,70,8,7,91,"neutor",NA
"12/30/2015 1:00",24,45,6,4,69,"neutor",NA
"12/30/2015 2:00",17,31,6,4,48,"neutor",NA
"12/30/2015 3:00",5,8,6,9,13,"neutor",NA
"12/30/2015 4:00",12,11,5,7,23,"neutor",NA
"12/30/2015 5:00",18,7,5,9,25,"neutor",NA
"12/30/2015 6:00",56,19,4,9,75,"neutor",NA
"12/30/2015 7:00",88,41,4,9,129,"neutor",NA
"12/30/2015 8:00",157,61,4,9,218,"neutor",NA
"12/30/2015 9:00",181,68,5,13,249,"neutor",NA
"12/30/2015 10:00",220,110,7,13,330,"neutor",NA
"12/30/2015 11:00",260,153,8,15,413,"neutor",NA
"12/30/2015 12:00",250,157,9,13,407,"neutor",NA
"12/30/2015 13:00",265,203,10,11,468,"neutor",NA
"12/30/2015 14:00",226,247,9,19,473,"neutor",NA
"12/30/2015 15:00",241,209,9,15,450,"neutor",NA
"12/30/2015 16:00",195,228,7,17,423,"neutor",NA
"12/30/2015 17:00",190,243,6,19,433,"neutor",NA
"12/30/2015 18:00",190,189,6,17,379,"neutor",NA
"12/30/2015 19:00",135,151,5,13,286,"neutor",NA
"12/30/2015 20:00",104,121,5,13,225,"neutor",NA
"12/30/2015 21:00",67,79,4,15,146,"neutor",NA
"12/30/2015 22:00",54,89,3,13,143,"neutor",NA
"12/30/2015 23:00",52,81,3,17,133,"neutor",NA
"12/31/2015 0:00",29,88,3,17,117,"neutor",NA
"12/31/2015 1:00",13,46,4,15,59,"neutor",NA
"12/31/2015 2:00",9,23,4,15,32,"neutor",NA
"12/31/2015 3:00",7,15,4,15,22,"neutor",NA
"12/31/2015 4:00",4,9,4,17,13,"neutor",NA
"12/31/2015 5:00",14,6,5,15,20,"neutor",NA
"12/31/2015 6:00",21,10,5,13,31,"neutor",NA
"12/31/2015 7:00",29,17,6,11,46,"neutor",NA
"12/31/2015 8:00",29,29,7,11,58,"neutor",NA
"12/31/2015 9:00",62,38,7,15,100,"neutor",NA
"12/31/2015 10:00",122,66,8,15,188,"neutor",NA
"12/31/2015 11:00",145,84,8,15,229,"neutor",NA
"12/31/2015 12:00",134,108,9,17,242,"neutor",NA
"12/31/2015 13:00",107,141,10,15,248,"neutor",NA
"12/31/2015 14:00",128,136,10,20,264,"neutor",NA
"12/31/2015 15:00",125,130,9,19,255,"neutor",NA
"12/31/2015 16:00",121,76,9,13,197,"neutor",NA
"12/31/2015 17:00",139,89,7,7,228,"neutor",NA
"12/31/2015 18:00",182,138,7,9,320,"neutor",NA
"12/31/2015 19:00",202,155,6,9,357,"neutor",NA
"12/31/2015 20:00",135,91,6,7,226,"neutor",NA
"12/31/2015 21:00",110,60,5,9,170,"neutor",NA
"12/31/2015 22:00",125,26,6,9,151,"neutor",NA
"12/31/2015 23:00",195,43,4,7,238,"neutor",NA
