"Stunden","FR.stadteinwärts","FR.stadtauswärts","Temperatur...C.","Windstärke..km.h.","Wetter","noOfBikes"
"1/1/2016 0:00","49",88,"3","9","Klarer Himmel",137
"1/1/2016 1:00","97",81,"3","7","Klarer Himmel",178
"1/1/2016 2:00","115",128,"3","9","Klarer Himmel",243
"1/1/2016 3:00","101",155,"3","9","teilweise bewölkt",256
"1/1/2016 4:00","68",137,"2","6","wolkig",205
"1/1/2016 5:00","36",89,"3","6","Regen",125
"1/1/2016 6:00","11",38,"3","7","",49
"1/1/2016 7:00","21",25,"2","4","",46
"1/1/2016 8:00","10",12,"0","2","Nebel",22
"1/1/2016 9:00","20",5,"1","4","wolkig",25
"1/1/2016 10:00","24",16,"4","6","Nebel",40
"1/1/2016 11:00","44",31,"5","6","wolkig",75
"1/1/2016 12:00","86",40,"6","4","wolkig",126
"1/1/2016 13:00","65",80,"7","4","wolkig",145
"1/1/2016 14:00","94",79,"7","4","wolkig",173
"1/1/2016 15:00","119",97,"6","4","Nebel",216
"1/1/2016 16:00","100",79,"6","6","Nebel",179
"1/1/2016 17:00","72",66,"5","4","Nebel",138
"1/1/2016 18:00","89",74,"4","4","Nebel",163
"1/1/2016 19:00","53",43,"5","7","",96
"1/1/2016 20:00","30",53,"4","9","wolkig",83
"1/1/2016 21:00","25",30,"4","9","wolkig",55
"1/1/2016 22:00","24",53,"4","9","Klarer Himmel",77
"1/1/2016 23:00","7",26,"4","7","Klarer Himmel",33
"1/2/2016 0:00","18",16,"4","9","teilweise bewölkt",34
"1/2/2016 1:00","5",13,"5","9","wolkig",18
"1/2/2016 2:00","5",3,"4","11","Klarer Himmel",8
"1/2/2016 3:00","2",3,"4","13","Klarer Himmel",5
"1/2/2016 4:00","5",1,"4","13","Klarer Himmel",6
"1/2/2016 5:00","12",9,"4","17","Klarer Himmel",21
"1/2/2016 6:00","20",15,"4","17","Klarer Himmel",35
"1/2/2016 7:00","34",10,"4","13","Klarer Himmel",44
"1/2/2016 8:00","43",36,"4","15","Klarer Himmel",79
"1/2/2016 9:00","97",33,"4","15","wolkig",130
"1/2/2016 10:00","131",64,"4","15","Regen",195
"1/2/2016 11:00","133",68,"3","15","wolkig",201
"1/2/2016 12:00","107",107,"3","15","Regen",214
"1/2/2016 13:00","120",95,"3","15","Regen",215
"1/2/2016 14:00","151",101,"3","13","wolkig",252
"1/2/2016 15:00","134",114,"3","13","Regen",248
"1/2/2016 16:00","119",116,"3","15","Regen",235
"1/2/2016 17:00","91",125,"3","13","Regen",216
"1/2/2016 18:00","83",94,"2","17","Regen",177
"1/2/2016 19:00","77",98,"2","13","Regen",175
"1/2/2016 20:00","79",69,"2","13","wolkig",148
"1/2/2016 21:00","45",50,"2","15","wolkig",95
"1/2/2016 22:00","29",39,"2","13","wolkig",68
"1/2/2016 23:00","51",32,"2","13","wolkig",83
"1/3/2016 0:00","37",36,"2","13","wolkig",73
"1/3/2016 1:00","16",37,"2","11","teilweise bewölkt",53
"1/3/2016 2:00","9",24,"2","15","wolkig",33
"1/3/2016 3:00","4",29,"2","11","Regen",33
"1/3/2016 4:00","6",10,"3","15","wolkig",16
"1/3/2016 5:00","6",9,"3","15","wolkig",15
"1/3/2016 6:00","6",12,"2","17","Regen",18
"1/3/2016 7:00","10",9,"2","13","Regen",19
"1/3/2016 8:00","23",11,"2","17","Regen",34
"1/3/2016 9:00","31",9,"2","15","Regen",40
"1/3/2016 10:00","50",38,"2","15","Regen",88
"1/3/2016 11:00","43",26,"3","11","Regen",69
"1/3/2016 12:00","40",40,"3","13","Regen",80
"1/3/2016 13:00","60",51,"3","11","Regen",111
"1/3/2016 14:00","74",59,"3","9","Regen",133
"1/3/2016 15:00","78",61,"3","13","wolkig",139
"1/3/2016 16:00","78",69,"3","11","wolkig",147
"1/3/2016 17:00","96",74,"3","13","teilweise bewölkt",170
"1/3/2016 18:00","114",87,"3","11","teilweise bewölkt",201
"1/3/2016 19:00","74",96,"2","11","wolkig",170
"1/3/2016 20:00","59",59,"2","15","wolkig",118
"1/3/2016 21:00","32",33,"2","15","wolkig",65
"1/3/2016 22:00","31",46,"2","17","wolkig",77
"1/3/2016 23:00","27",45,"2","15","wolkig",72
"1/4/2016 0:00","14",28,"2","15","Regen",42
"1/4/2016 1:00","5",14,"2","15","Schnee",19
"1/4/2016 2:00","2",7,"1","13","Schnee",9
"1/4/2016 3:00","3",3,"1","13","Schnee",6
"1/4/2016 4:00","10",4,"1","13","Regen",14
"1/4/2016 5:00","31",9,"1","13","Schnee",40
"1/4/2016 6:00","75",25,"1","11","Schnee",100
"1/4/2016 7:00","195",109,"1","13","Schnee",304
"1/4/2016 8:00","237",157,"1","9","Schnee",394
"1/4/2016 9:00","194",128,"0","9","Schnee",322
"1/4/2016 10:00","124",86,"0","9","Schnee",210
"1/4/2016 11:00","129",97,"0","7","Schnee",226
"1/4/2016 12:00","142",129,"0","9","Schnee",271
"1/4/2016 13:00","159",128,"0","7","Schnee",287
"1/4/2016 14:00","184",158,"0","7","wolkig",342
"1/4/2016 15:00","179",182,"1","6","Schnee",361
"1/4/2016 16:00","255",226,"0","7","wolkig",481
"1/4/2016 17:00","274",223,"-1","9","wolkig",497
"1/4/2016 18:00","238",236,"-1","11","wolkig",474
"1/4/2016 19:00","180",194,"-1","9","Regen",374
"1/4/2016 20:00","124",132,"-1","6","Regen",256
"1/4/2016 21:00","45",99,"-1","6","Schneeregen",144
"1/4/2016 22:00","59",69,"0","4","wolkig",128
"1/4/2016 23:00","35",78,"0","6","Schnee",113
"1/5/2016 0:00","20",40,"0","4","Schnee",60
"1/5/2016 1:00","15",20,"1","6","wolkig",35
"1/5/2016 2:00","16",18,"1","4","wolkig",34
"1/5/2016 3:00","8",13,"1","4","wolkig",21
"1/5/2016 4:00","16",3,"1","4","wolkig",19
"1/5/2016 5:00","31",14,"","","",45
"1/5/2016 6:00","75",40,"","","",115
"1/5/2016 7:00","187",113,"","","",300
"1/5/2016 8:00","340",197,"3","4","wolkig",537
"1/5/2016 9:00","297",182,"3","7","wolkig",479
"1/5/2016 10:00","242",166,"4","6","wolkig",408
"1/5/2016 11:00","248",156,"4","7","wolkig",404
"1/5/2016 12:00","265",216,"5","7","wolkig",481
"1/5/2016 13:00","268",231,"5","7","wolkig",499
"1/5/2016 14:00","328",246,"4","7","wolkig",574
"1/5/2016 15:00","297",278,"2","11","wolkig",575
"1/5/2016 16:00","334",363,"1","13","wolkig",697
"1/5/2016 17:00","379",375,"0","11","wolkig",754
"1/5/2016 18:00","309",296,"0","9","wolkig",605
"1/5/2016 19:00","234",271,"-1","13","Schneeregen",505
"1/5/2016 20:00","169",165,"-1","13","wolkig",334
"1/5/2016 21:00","79",112,"-1","11","wolkig",191
"1/5/2016 22:00","85",115,"-2","13","wolkig",200
"1/5/2016 23:00","46",99,"-2","11","wolkig",145
"1/6/2016 0:00","33",55,"-2","15","wolkig",88
"1/6/2016 1:00","11",31,"-2","13","wolkig",42
"1/6/2016 2:00","6",10,"-2","9","Schneeregen",16
"1/6/2016 3:00","3",11,"-2","11","wolkig",14
"1/6/2016 4:00","11",9,"-2","11","wolkig",20
"1/6/2016 5:00","38",12,"-2","13","wolkig",50
"1/6/2016 6:00","95",32,"-2","13","Schneeregen",127
"1/6/2016 7:00","253",158,"-2","11","Schneeregen",411
"1/6/2016 8:00","310",250,"-2","11","Schneeregen",560
"1/6/2016 9:00","325",189,"-2","11","Schneeregen",514
"1/6/2016 10:00","291",178,"-2","11","Schneeregen",469
"1/6/2016 11:00","204",181,"-2","11","Schneeregen",385
"1/6/2016 12:00","272",241,"-2","11","Schneeregen",513
"1/6/2016 13:00","261",267,"-2","11","wolkig",528
"1/6/2016 14:00","281",251,"-2","15","wolkig",532
"1/6/2016 15:00","352",264,"-2","9","wolkig",616
"1/6/2016 16:00","374",331,"-2","9","wolkig",705
"1/6/2016 17:00","381",342,"-2","7","wolkig",723
"1/6/2016 18:00","351",320,"-2","9","wolkig",671
"1/6/2016 19:00","299",255,"-2","6","wolkig",554
"1/6/2016 20:00","221",195,"-2","7","wolkig",416
"1/6/2016 21:00","127",153,"-2","7","wolkig",280
"1/6/2016 22:00","85",156,"-2","6","wolkig",241
"1/6/2016 23:00","46",117,"-1","6","wolkig",163
"1/7/2016 0:00","30",65,"-1","6","wolkig",95
"1/7/2016 1:00","19",39,"-1","6","wolkig",58
"1/7/2016 2:00","12",17,"0","2","wolkig",29
"1/7/2016 3:00","2",15,"0","4","wolkig",17
"1/7/2016 4:00","11",13,"0","6","wolkig",24
"1/7/2016 5:00","33",22,"1","6","wolkig",55
"1/7/2016 6:00","92",22,"1","7","wolkig",114
"1/7/2016 7:00","417",263,"2","11","Nebel",680
"1/7/2016 8:00","488",397,"2","7","Nebel",885
"1/7/2016 9:00","465",377,"3","13","Nebel",842
"1/7/2016 10:00","448",305,"3","9","",753
"1/7/2016 11:00","483",412,"5","9","",895
"1/7/2016 12:00","455",373,"5","9","Klarer Himmel",828
"1/7/2016 13:00","487",495,"6","9","Klarer Himmel",982
"1/7/2016 14:00","453",414,"6","17","Klarer Himmel",867
"1/7/2016 15:00","585",506,"6","15","wolkig",1091
"1/7/2016 16:00","484",480,"5","17","Regen",964
"1/7/2016 17:00","390",405,"5","15","Regen",795
"1/7/2016 18:00","308",369,"5","24","Regen",677
"1/7/2016 19:00","289",326,"5","20","Regen",615
"1/7/2016 20:00","154",192,"5","19","Regen",346
"1/7/2016 21:00","126",131,"7","43","Regen",257
"1/7/2016 22:00","82",108,"6","35","Regen",190
"1/7/2016 23:00","53",85,"6","28","teilweise bewölkt",138
"1/8/2016 0:00","27",49,"6","30","teilweise bewölkt",76
"1/8/2016 1:00","14",21,"5","32","teilweise bewölkt",35
"1/8/2016 2:00","4",11,"5","28","wolkig",15
"1/8/2016 3:00","3",11,"5","33","Klarer Himmel",14
"1/8/2016 4:00","9",6,"5","32","Klarer Himmel",15
"1/8/2016 5:00","27",9,"5","32","Klarer Himmel",36
"1/8/2016 6:00","93",33,"5","32","Klarer Himmel",126
"1/8/2016 7:00","385",223,"5","28","teilweise bewölkt",608
"1/8/2016 8:00","460",409,"4","28","teilweise bewölkt",869
"1/8/2016 9:00","416",314,"4","26","teilweise bewölkt",730
"1/8/2016 10:00","471",259,"5","28","teilweise bewölkt",730
"1/8/2016 11:00","445",342,"6","26","teilweise bewölkt",787
"1/8/2016 12:00","455",346,"7","24","teilweise bewölkt",801
"1/8/2016 13:00","510",396,"7","24","teilweise bewölkt",906
"1/8/2016 14:00","454",449,"8","19","teilweise bewölkt",903
"1/8/2016 15:00","445",381,"7","17","teilweise bewölkt",826
"1/8/2016 16:00","397",384,"7","13","wolkig",781
"1/8/2016 17:00","399",377,"7","15","wolkig",776
"1/8/2016 18:00","369",329,"6","13","teilweise bewölkt",698
"1/8/2016 19:00","301",281,"5","9","Klarer Himmel",582
"1/8/2016 20:00","274",245,"4","11","Klarer Himmel",519
"1/8/2016 21:00","151",153,"4","11","Klarer Himmel",304
"1/8/2016 22:00","137",159,"2","7","Klarer Himmel",296
"1/8/2016 23:00","102",161,"2","7","Klarer Himmel",263
"1/9/2016 0:00","84",160,"1","6","Klarer Himmel",244
"1/9/2016 1:00","68",154,"1","6","Klarer Himmel",222
"1/9/2016 2:00","35",87,"0","6","Klarer Himmel",122
"1/9/2016 3:00","27",76,"1","7","wolkig",103
"1/9/2016 4:00","23",64,"1","9","wolkig",87
"1/9/2016 5:00","15",26,"1","7","Schnee",41
"1/9/2016 6:00","26",16,"1","9","wolkig",42
"1/9/2016 7:00","44",25,"1","9","teilweise bewölkt",69
"1/9/2016 8:00","107",64,"1","9","teilweise bewölkt",171
"1/9/2016 9:00","258",127,"2","9","Klarer Himmel",385
"1/9/2016 10:00","316",132,"4","9","Klarer Himmel",448
"1/9/2016 11:00","388",158,"6","13","Klarer Himmel",546
"1/9/2016 12:00","338",219,"6","7","Klarer Himmel",557
"1/9/2016 13:00","368",238,"7","11","Klarer Himmel",606
"1/9/2016 14:00","324",323,"7","9","Klarer Himmel",647
"1/9/2016 15:00","256",308,"7","7","Klarer Himmel",564
"1/9/2016 16:00","252",278,"7","9","Klarer Himmel",530
"1/9/2016 17:00","214",304,"7","9","Klarer Himmel",518
"1/9/2016 18:00","241",267,"6","13","Klarer Himmel",508
"1/9/2016 19:00","273",253,"5","20","Klarer Himmel",526
"1/9/2016 20:00","209",214,"5","15","wolkig",423
"1/9/2016 21:00","197",135,"4","13","teilweise bewölkt",332
"1/9/2016 22:00","120",151,"3","13","teilweise bewölkt",271
"1/9/2016 23:00","98",144,"3","13","teilweise bewölkt",242
"1/10/2016 0:00","116",147,"2","9","Klarer Himmel",263
"1/10/2016 1:00","98",109,"3","15","teilweise bewölkt",207
"1/10/2016 2:00","51",129,"3","15","Klarer Himmel",180
"1/10/2016 3:00","46",96,"4","13","wolkig",142
"1/10/2016 4:00","23",68,"4","13","Regen",91
"1/10/2016 5:00","6",39,"5","13","wolkig",45
"1/10/2016 6:00","14",21,"5","13","wolkig",35
"1/10/2016 7:00","18",8,"6","9","Regen",26
"1/10/2016 8:00","24",20,"6","13","Regen",44
"1/10/2016 9:00","136",32,"6","15","wolkig",168
"1/10/2016 10:00","190",69,"7","19","wolkig",259
"1/10/2016 11:00","157",105,"8","22","teilweise bewölkt",262
"1/10/2016 12:00","167",115,"8","20","teilweise bewölkt",282
"1/10/2016 13:00","195",150,"9","22","teilweise bewölkt",345
"1/10/2016 14:00","238",203,"9","19","teilweise bewölkt",441
"1/10/2016 15:00","240",222,"8","17","teilweise bewölkt",462
"1/10/2016 16:00","217",227,"7","11","Klarer Himmel",444
"1/10/2016 17:00","164",208,"7","15","Klarer Himmel",372
"1/10/2016 18:00","181",204,"7","11","wolkig",385
"1/10/2016 19:00","134",173,"6","11","Regen",307
"1/10/2016 20:00","78",160,"5","6","wolkig",238
"1/10/2016 21:00","50",86,"5","7","wolkig",136
"1/10/2016 22:00","53",114,"5","9","wolkig",167
"1/10/2016 23:00","41",88,"5","13","wolkig",129
"1/11/2016 0:00","17",26,"5","9","wolkig",43
"1/11/2016 1:00","8",19,"5","11","wolkig",27
"1/11/2016 2:00","3",9,"6","9","wolkig",12
"1/11/2016 3:00","5",0,"6","11","wolkig",5
"1/11/2016 4:00","8",0,"4","6","wolkig",8
"1/11/2016 5:00","36",12,"3","9","teilweise bewölkt",48
"1/11/2016 6:00","98",43,"3","7","teilweise bewölkt",141
"1/11/2016 7:00","446",220,"3","7","teilweise bewölkt",666
"1/11/2016 8:00","646",442,"3","7","Klarer Himmel",1088
"1/11/2016 9:00","516",402,"3","9","Klarer Himmel",918
"1/11/2016 10:00","527",339,"3","9","Klarer Himmel",866
"1/11/2016 11:00","424",514,"4","7","wolkig",938
"1/11/2016 12:00","463",447,"5","9","Regen",910
"1/11/2016 13:00","457",476,"5","13","Regen",933
"1/11/2016 14:00","375",339,"5","7","Regen",714
"1/11/2016 15:00","557",486,"5","9","Regen",1043
"1/11/2016 16:00","550",502,"5","7","Regen",1052
"1/11/2016 17:00","602",645,"5","9","wolkig",1247
"1/11/2016 18:00","520",473,"5","6","wolkig",993
"1/11/2016 19:00","406",482,"5","7","Regen",888
"1/11/2016 20:00","216",248,"5","7","wolkig",464
"1/11/2016 21:00","114",184,"6","13","wolkig",298
"1/11/2016 22:00","111",174,"6","13","Regen",285
"1/11/2016 23:00","51",106,"6","11","Regen",157
"1/12/2016 0:00","22",46,"6","17","Regen",68
"1/12/2016 1:00","10",33,"6","17","Regen",43
"1/12/2016 2:00","7",10,"6","13","Regen",17
"1/12/2016 3:00","3",5,"6","15","wolkig",8
"1/12/2016 4:00","9",5,"6","15","wolkig",14
"1/12/2016 5:00","23",12,"5","20","wolkig",35
"1/12/2016 6:00","92",42,"5","20","wolkig",134
"1/12/2016 7:00","412",266,"6","22","wolkig",678
"1/12/2016 8:00","689",490,"5","19","wolkig",1179
"1/12/2016 9:00","504",513,"6","20","wolkig",1017
"1/12/2016 10:00","596",366,"6","19","wolkig",962
"1/12/2016 11:00","502",519,"6","26","wolkig",1021
"1/12/2016 12:00","548",449,"6","22","Regen",997
"1/12/2016 13:00","522",511,"7","22","wolkig",1033
"1/12/2016 14:00","511",481,"6","20","Regen",992
"1/12/2016 15:00","494",618,"6","20","wolkig",1112
"1/12/2016 16:00","578",532,"7","17","wolkig",1110
"1/12/2016 17:00","694",635,"7","17","wolkig",1329
"1/12/2016 18:00","535",554,"6","17","wolkig",1089
"1/12/2016 19:00","474",571,"6","17","wolkig",1045
"1/12/2016 20:00","278",284,"6","20","wolkig",562
"1/12/2016 21:00","199",238,"6","24","wolkig",437
"1/12/2016 22:00","135",212,"5","22","wolkig",347
"1/12/2016 23:00","74",139,"5","20","Regen",213
"1/13/2016 0:00","37",53,"4","20","Regen",90
"1/13/2016 1:00","18",41,"4","15","wolkig",59
"1/13/2016 2:00","7",13,"4","17","Regen",20
"1/13/2016 3:00","4",0,"4","17","Regen",4
"1/13/2016 4:00","13",5,"5","19","wolkig",18
"1/13/2016 5:00","32",11,"5","20","wolkig",43
"1/13/2016 6:00","115",36,"5","22","wolkig",151
"1/13/2016 7:00","461",248,"5","24","Regen",709
"1/13/2016 8:00","635",502,"5","24","wolkig",1137
"1/13/2016 9:00","535",418,"5","17","wolkig",953
"1/13/2016 10:00","559",376,"5","19","wolkig",935
"1/13/2016 11:00","463",382,"6","17","wolkig",845
"1/13/2016 12:00","562",430,"6","17","wolkig",992
"1/13/2016 13:00","540",471,"6","13","wolkig",1011
"1/13/2016 14:00","532",426,"6","19","wolkig",958
"1/13/2016 15:00","547",533,"6","7","wolkig",1080
"1/13/2016 16:00","470",490,"5","28","Regen",960
"1/13/2016 17:00","579",602,"4","15","wolkig",1181
"1/13/2016 18:00","450",459,"4","13","wolkig",909
"1/13/2016 19:00","489",476,"5","20","wolkig",965
"1/13/2016 20:00","287",259,"4","20","teilweise bewölkt",546
"1/13/2016 21:00","144",230,"3","17","teilweise bewölkt",374
"1/13/2016 22:00","178",221,"3","11","teilweise bewölkt",399
"1/13/2016 23:00","102",145,"3","11","teilweise bewölkt",247
"1/14/2016 0:00","55",124,"3","15","teilweise bewölkt",179
"1/14/2016 1:00","38",69,"2","13","teilweise bewölkt",107
"1/14/2016 2:00","11",53,"1","9","teilweise bewölkt",64
"1/14/2016 3:00","15",29,"1","9","wolkig",44
"1/14/2016 4:00","12",21,"1","9","teilweise bewölkt",33
"1/14/2016 5:00","31",20,"1","13","wolkig",51
"1/14/2016 6:00","93",44,"1","13","wolkig",137
"1/14/2016 7:00","392",241,"1","13","wolkig",633
"1/14/2016 8:00","575",430,"2","17","Klarer Himmel",1005
"1/14/2016 9:00","565",360,"2","19","Klarer Himmel",925
"1/14/2016 10:00","526",320,"4","22","wolkig",846
"1/14/2016 11:00","487",456,"4","22","Regen",943
"1/14/2016 12:00","471",397,"4","28","Regen",868
"1/14/2016 13:00","462",444,"4","20","Regen",906
"1/14/2016 14:00","362",425,"3","22","Regen",787
"1/14/2016 15:00","414",450,"2","19","Regen",864
"1/14/2016 16:00","493",461,"3","15","wolkig",954
"1/14/2016 17:00","578",473,"3","15","wolkig",1051
"1/14/2016 18:00","490",413,"3","15","teilweise bewölkt",903
"1/14/2016 19:00","352",405,"3","17","Regen",757
"1/14/2016 20:00","234",295,"2","17","wolkig",529
"1/14/2016 21:00","170",173,"3","17","Regen",343
"1/14/2016 22:00","135",182,"3","17","Regen",317
"1/14/2016 23:00","66",151,"3","15","Regen",217
"1/15/2016 0:00","37",82,"3","15","wolkig",119
"1/15/2016 1:00","25",55,"3","15","Regen",80
"1/15/2016 2:00","8",23,"2","15","Regen",31
"1/15/2016 3:00","8",25,"2","15","Schnee",33
"1/15/2016 4:00","8",8,"2","13","Schnee",16
"1/15/2016 5:00","23",9,"1","7","Schnee",32
"1/15/2016 6:00","78",34,"2","6","Schnee",112
"1/15/2016 7:00","345",200,"2","7","wolkig",545
"1/15/2016 8:00","483",408,"1","13","wolkig",891
"1/15/2016 9:00","432",298,"2","9","wolkig",730
"1/15/2016 10:00","427",256,"2","9","wolkig",683
"1/15/2016 11:00","437",303,"3","11","wolkig",740
"1/15/2016 12:00","441",349,"3","17","wolkig",790
"1/15/2016 13:00","434",434,"2","13","wolkig",868
"1/15/2016 14:00","389",388,"3","13","wolkig",777
"1/15/2016 15:00","387",348,"2","20","wolkig",735
"1/15/2016 16:00","384",335,"2","15","wolkig",719
"1/15/2016 17:00","385",351,"2","9","wolkig",736
"1/15/2016 18:00","354",322,"2","11","wolkig",676
"1/15/2016 19:00","313",304,"2","9","wolkig",617
"1/15/2016 20:00","266",239,"1","9","wolkig",505
"1/15/2016 21:00","163",196,"2","9","wolkig",359
"1/15/2016 22:00","124",132,"2","7","wolkig",256
"1/15/2016 23:00","133",141,"0","4","wolkig",274
"1/16/2016 0:00","93",154,"0","4","wolkig",247
"1/16/2016 1:00","69",153,"0","7","wolkig",222
"1/16/2016 2:00","36",90,"1","7","wolkig",126
"1/16/2016 3:00","36",78,"1","9","teilweise bewölkt",114
"1/16/2016 4:00","14",49,"1","9","teilweise bewölkt",63
"1/16/2016 5:00","28",32,"0","9","teilweise bewölkt",60
"1/16/2016 6:00","28",12,"0","13","wolkig",40
"1/16/2016 7:00","82",16,"1","20","Schnee",98
"1/16/2016 8:00","122",52,"1","20","Schnee",174
"1/16/2016 9:00","222",105,"2","22","Schnee",327
"1/16/2016 10:00","219",87,"2","20","Regen",306
"1/16/2016 11:00","216",97,"2","32","Regen",313
"1/16/2016 12:00","234",122,"1","26","Schnee",356
"1/16/2016 13:00","196",159,"1","30","wolkig",355
"1/16/2016 14:00","213",222,"2","24","wolkig",435
"1/16/2016 15:00","200",175,"1","17","Schnee",375
"1/16/2016 16:00","206",169,"1","13","Schnee",375
"1/16/2016 17:00","131",209,"1","11","teilweise bewölkt",340
"1/16/2016 18:00","216",234,"0","9","wolkig",450
"1/16/2016 19:00","206",189,"0","17","Schnee",395
"1/16/2016 20:00","167",147,"0","9","teilweise bewölkt",314
"1/16/2016 21:00","136",134,"-1","11","teilweise bewölkt",270
"1/16/2016 22:00","84",114,"0","17","Schnee",198
"1/16/2016 23:00","88",110,"0","17","teilweise bewölkt",198
"1/17/2016 0:00","91",89,"0","17","wolkig",180
"1/17/2016 1:00","72",100,"-1","13","wolkig",172
"1/17/2016 2:00","35",78,"-1","13","Klarer Himmel",113
"1/17/2016 3:00","14",72,"-1","17","wolkig",86
"1/17/2016 4:00","21",51,"0","13","wolkig",72
"1/17/2016 5:00","11",37,"-1","19","wolkig",48
"1/17/2016 6:00","15",17,"-1","15","wolkig",32
"1/17/2016 7:00","18",6,"-1","13","wolkig",24
"1/17/2016 8:00","16",23,"-1","13","wolkig",39
"1/17/2016 9:00","108",23,"-1","9","wolkig",131
"1/17/2016 10:00","124",54,"0","7","wolkig",178
"1/17/2016 11:00","112",119,"0","11","wolkig",231
"1/17/2016 12:00","124",126,"0","11","wolkig",250
"1/17/2016 13:00","174",166,"0","11","wolkig",340
"1/17/2016 14:00","173",139,"0","9","Schnee",312
"1/17/2016 15:00","188",165,"0","11","wolkig",353
"1/17/2016 16:00","182",146,"-1","9","teilweise bewölkt",328
"1/17/2016 17:00","220",145,"-2","2","teilweise bewölkt",365
"1/17/2016 18:00","171",174,"-3","2","Klarer Himmel",345
"1/17/2016 19:00","124",183,"-4","4","Klarer Himmel",307
"1/17/2016 20:00","93",162,"-5","2","Klarer Himmel",255
"1/17/2016 21:00","59",67,"-5","4","Nebel",126
"1/17/2016 22:00","55",102,"-6","2","Nebel",157
"1/17/2016 23:00","40",60,"-7","2","Klarer Himmel",100
"1/18/2016 0:00","9",19,"-6","2","Nebel",28
"1/18/2016 1:00","9",8,"-7","0","Klarer Himmel",17
"1/18/2016 2:00","4",2,"-7","0","Klarer Himmel",6
"1/18/2016 3:00","6",1,"-7","2","",7
"1/18/2016 4:00","10",5,"-7","6","Klarer Himmel",15
"1/18/2016 5:00","26",16,"-7","2","",42
"1/18/2016 6:00","97",39,"-7","2","",136
"1/18/2016 7:00","392",156,"-7","4","",548
"1/18/2016 8:00","526",391,"-6","6","Nebel",917
"1/18/2016 9:00","433",321,"-5","6","Nebel",754
"1/18/2016 10:00","408",341,"-4","6","",749
"1/18/2016 11:00","334",375,"-3","6","",709
"1/18/2016 12:00","434",361,"-2","7","Klarer Himmel",795
"1/18/2016 13:00","495",457,"-1","7","teilweise bewölkt",952
"1/18/2016 14:00","522",425,"-1","9","teilweise bewölkt",947
"1/18/2016 15:00","532",517,"-1","6","Klarer Himmel",1049
"1/18/2016 16:00","593",516,"-2","6","Klarer Himmel",1109
"1/18/2016 17:00","599",678,"-3","6","Klarer Himmel",1277
"1/18/2016 18:00","501",530,"-3","4","Klarer Himmel",1031
"1/18/2016 19:00","414",470,"-3","4","Klarer Himmel",884
"1/18/2016 20:00","207",306,"-4","7","Klarer Himmel",513
"1/18/2016 21:00","132",203,"-4","9","Klarer Himmel",335
"1/18/2016 22:00","83",201,"-5","6","Klarer Himmel",284
"1/18/2016 23:00","60",133,"-5","4","Klarer Himmel",193
"1/19/2016 0:00","20",57,"-5","6","Klarer Himmel",77
"1/19/2016 1:00","7",28,"-6","9","Klarer Himmel",35
"1/19/2016 2:00","5",6,"-7","4","Klarer Himmel",11
"1/19/2016 3:00","10",2,"-8","2","Klarer Himmel",12
"1/19/2016 4:00","7",3,"-8","2","Klarer Himmel",10
"1/19/2016 5:00","26",15,"-7","4","Klarer Himmel",41
"1/19/2016 6:00","86",37,"-8","4","Klarer Himmel",123
"1/19/2016 7:00","362",264,"-8","7","Klarer Himmel",626
"1/19/2016 8:00","626",430,"-8","6","Klarer Himmel",1056
"1/19/2016 9:00","430",412,"-7","6","Klarer Himmel",842
"1/19/2016 10:00","490",352,"-4","6","Klarer Himmel",842
"1/19/2016 11:00","412",385,"-3","13","Klarer Himmel",797
"1/19/2016 12:00","560",394,"-2","13","Klarer Himmel",954
"1/19/2016 13:00","437",471,"-1","13","Klarer Himmel",908
"1/19/2016 14:00","474",426,"-1","11","Klarer Himmel",900
"1/19/2016 15:00","523",557,"-1","11","",1080
"1/19/2016 16:00","559",508,"-1","11","wolkig",1067
"1/19/2016 17:00","576",606,"-1","9","wolkig",1182
"1/19/2016 18:00","516",514,"-2","17","Schnee",1030
"1/19/2016 19:00","439",419,"-2","9","Schnee",858
"1/19/2016 20:00","223",322,"-2","15","Schnee",545
"1/19/2016 21:00","159",207,"-1","11","wolkig",366
"1/19/2016 22:00","117",212,"-1","9","wolkig",329
"1/19/2016 23:00","50",170,"-1","13","Klarer Himmel",220
"1/20/2016 0:00","38",64,"-1","9","wolkig",102
"1/20/2016 1:00","7",32,"-1","9","wolkig",39
"1/20/2016 2:00","4",8,"-1","9","wolkig",12
"1/20/2016 3:00","3",3,"-1","9","Schnee",6
"1/20/2016 4:00","19",9,"-1","13","wolkig",28
"1/20/2016 5:00","29",18,"-1","13","wolkig",47
"1/20/2016 6:00","108",30,"0","13","wolkig",138
"1/20/2016 7:00","449",222,"-1","13","Schnee",671
"1/20/2016 8:00","588",439,"0","15","wolkig",1027
"1/20/2016 9:00","429",385,"0","17","wolkig",814
"1/20/2016 10:00","456",327,"1","17","wolkig",783
"1/20/2016 11:00","408",367,"1","15","Schnee",775
"1/20/2016 12:00","456",378,"2","19","wolkig",834
"1/20/2016 13:00","461",442,"3","15","wolkig",903
"1/20/2016 14:00","431",395,"2","15","wolkig",826
"1/20/2016 15:00","452",446,"2","11","wolkig",898
"1/20/2016 16:00","523",467,"2","11","wolkig",990
"1/20/2016 17:00","547",599,"1","9","wolkig",1146
"1/20/2016 18:00","487",549,"1","6","wolkig",1036
"1/20/2016 19:00","433",446,"1","6","wolkig",879
"1/20/2016 20:00","265",279,"1","4","wolkig",544
"1/20/2016 21:00","156",228,"1","4","wolkig",384
"1/20/2016 22:00","257",199,"1","4","wolkig",456
"1/20/2016 23:00","151",160,"1","4","wolkig",311
"1/21/2016 0:00","81",84,"0","4","wolkig",165
"1/21/2016 1:00","45",50,"-2","2","teilweise bewölkt",95
"1/21/2016 2:00","25",54,"-3","4","Nebel",79
"1/21/2016 3:00","14",33,"-4","2","Nebel",47
"1/21/2016 4:00","17",32,"-5","4","Nebel",49
"1/21/2016 5:00","27",24,"-4","4","Nebel",51
"1/21/2016 6:00","86",42,"-4","2","Nebel",128
"1/21/2016 7:00","337",216,"-3","4","wolkig",553
"1/21/2016 8:00","530",437,"-3","2","Nebel",967
"1/21/2016 9:00","486",342,"-3","4","wolkig",828
"1/21/2016 10:00","446",309,"-2","4","teilweise bewölkt",755
"1/21/2016 11:00","458",426,"-2","6","Nebel",884
"1/21/2016 12:00","457",419,"-3","7","Nebel",876
"1/21/2016 13:00","456",442,"-3","7","Nebel",898
"1/21/2016 14:00","381",402,"-3","6","Nebel",783
"1/21/2016 15:00","475",449,"-3","6","Nebel",924
"1/21/2016 16:00","547",420,"-2","4","Nebel",967
"1/21/2016 17:00","566",507,"-2","7","Nebel",1073
"1/21/2016 18:00","497",442,"-3","6","Nebel",939
"1/21/2016 19:00","369",380,"-3","6","Nebel",749
"1/21/2016 20:00","216",298,"-4","6","Nebel",514
"1/21/2016 21:00","164",202,"-5","4","wolkig",366
"1/21/2016 22:00","112",163,"-5","4","Nebel",275
"1/21/2016 23:00","74",156,"-6","2","",230
"1/22/2016 0:00","38",65,"-6","6","",103
"1/22/2016 1:00","25",53,"-6","6","",78
"1/22/2016 2:00","6",32,"-6","6","",38
"1/22/2016 3:00","7",11,"-6","6","",18
"1/22/2016 4:00","11",14,"-6","6","",25
"1/22/2016 5:00","22",24,"-6","7","",46
"1/22/2016 6:00","92",39,"-6","7","",131
"1/22/2016 7:00","352",220,"-6","7","",572
"1/22/2016 8:00","438",383,"-6","9","",821
"1/22/2016 9:00","413",237,"-5","9","",650
"1/22/2016 10:00","440",251,"-3","9","",691
"1/22/2016 11:00","371",284,"-2","11","",655
"1/22/2016 12:00","447",329,"-1","15","Klarer Himmel",776
"1/22/2016 13:00","430",422,"0","15","Klarer Himmel",852
"1/22/2016 14:00","409",352,"1","13","Klarer Himmel",761
"1/22/2016 15:00","461",358,"1","11","Klarer Himmel",819
"1/22/2016 16:00","394",338,"0","9","Klarer Himmel",732
"1/22/2016 17:00","374",367,"0","13","Klarer Himmel",741
"1/22/2016 18:00","289",343,"0","13","Klarer Himmel",632
"1/22/2016 19:00","355",267,"1","13","Klarer Himmel",622
"1/22/2016 20:00","221",235,"0","11","Klarer Himmel",456
"1/22/2016 21:00","131",150,"0","9","Regen",281
"1/22/2016 22:00","86",188,"0","11","Regen",274
"1/22/2016 23:00","101",145,"0","9","Regen",246
"1/23/2016 0:00","71",168,"1","9","Regen",239
"1/23/2016 1:00","56",104,"2","9","Regen",160
"1/23/2016 2:00","41",86,"3","11","Regen",127
"1/23/2016 3:00","20",43,"3","20","wolkig",63
"1/23/2016 4:00","17",21,"4","19","Regen",38
"1/23/2016 5:00","17",9,"4","17","wolkig",26
"1/23/2016 6:00","21",17,"5","9","wolkig",38
"1/23/2016 7:00","40",12,"5","13","wolkig",52
"1/23/2016 8:00","127",63,"5","15","wolkig",190
"1/23/2016 9:00","272",81,"6","22","wolkig",353
"1/23/2016 10:00","287",140,"6","15","wolkig",427
"1/23/2016 11:00","310",150,"6","15","wolkig",460
"1/23/2016 12:00","329",172,"7","17","wolkig",501
"1/23/2016 13:00","308",226,"7","24","wolkig",534
"1/23/2016 14:00","288",221,"6","17","wolkig",509
"1/23/2016 15:00","241",236,"6","17","wolkig",477
"1/23/2016 16:00","164",216,"6","11","wolkig",380
"1/23/2016 17:00","148",233,"6","13","Regen",381
"1/23/2016 18:00","223",235,"6","13","Regen",458
"1/23/2016 19:00","183",212,"6","13","wolkig",395
"1/23/2016 20:00","225",150,"6","11","wolkig",375
"1/23/2016 21:00","191",104,"6","9","wolkig",295
"1/23/2016 22:00","105",105,"6","11","wolkig",210
"1/23/2016 23:00","92",144,"6","9","wolkig",236
"1/24/2016 0:00","89",129,"5","7","wolkig",218
"1/24/2016 1:00","62",137,"5","9","wolkig",199
"1/24/2016 2:00","43",105,"5","6","",148
"1/24/2016 3:00","24",75,"4","6","Klarer Himmel",99
"1/24/2016 4:00","26",48,"4","7","Klarer Himmel",74
"1/24/2016 5:00","11",37,"5","9","Klarer Himmel",48
"1/24/2016 6:00","14",16,"4","9","Klarer Himmel",30
"1/24/2016 7:00","23",11,"4","7","wolkig",34
"1/24/2016 8:00","41",25,"4","7","Klarer Himmel",66
"1/24/2016 9:00","178",34,"4","11","Regen",212
"1/24/2016 10:00","197",76,"6","13","wolkig",273
"1/24/2016 11:00","114",83,"6","13","wolkig",197
"1/24/2016 12:00","133",123,"7","15","wolkig",256
"1/24/2016 13:00","132",135,"6","13","wolkig",267
"1/24/2016 14:00","154",128,"7","15","Regen",282
"1/24/2016 15:00","143",136,"7","13","Regen",279
"1/24/2016 16:00","157",140,"7","11","Regen",297
"1/24/2016 17:00","108",160,"7","7","Regen",268
"1/24/2016 18:00","139",172,"7","9","Regen",311
"1/24/2016 19:00","102",183,"7","9","Regen",285
"1/24/2016 20:00","69",117,"8","11","Regen",186
"1/24/2016 21:00","71",94,"8","13","wolkig",165
"1/24/2016 22:00","52",130,"9","17","wolkig",182
"1/24/2016 23:00","39",53,"9","15","wolkig",92
"1/25/2016 0:00","23",37,"9","15","wolkig",60
"1/25/2016 1:00","11",14,"9","15","wolkig",25
"1/25/2016 2:00","4",2,"9","15","wolkig",6
"1/25/2016 3:00","4",3,"9","15","wolkig",7
"1/25/2016 4:00","13",3,"9","15","wolkig",16
"1/25/2016 5:00","37",8,"9","11","wolkig",45
"1/25/2016 6:00","105",39,"9","11","wolkig",144
"1/25/2016 7:00","442",202,"9","6","wolkig",644
"1/25/2016 8:00","631",385,"9","4","wolkig",1016
"1/25/2016 9:00","468",356,"10","6","wolkig",824
"1/25/2016 10:00","432",360,"10","9","wolkig",792
"1/25/2016 11:00","372",451,"12","13","wolkig",823
"1/25/2016 12:00","404",408,"13","15","wolkig",812
"1/25/2016 13:00","517",483,"13","19","wolkig",1000
"1/25/2016 14:00","457",460,"13","17","wolkig",917
"1/25/2016 15:00","646",510,"13","17","Klarer Himmel",1156
"1/25/2016 16:00","668",538,"12","13","Klarer Himmel",1206
"1/25/2016 17:00","649",721,"11","13","Klarer Himmel",1370
"1/25/2016 18:00","485",577,"10","11","Klarer Himmel",1062
"1/25/2016 19:00","393",502,"8","9","Klarer Himmel",895
"1/25/2016 20:00","224",347,"9","9","Klarer Himmel",571
"1/25/2016 21:00","169",205,"11","15","Klarer Himmel",374
"1/25/2016 22:00","133",219,"11","24","wolkig",352
"1/25/2016 23:00","64",90,"11","17","wolkig",154
"1/26/2016 0:00","24",66,"11","17","wolkig",90
"1/26/2016 1:00","9",25,"11","20","wolkig",34
"1/26/2016 2:00","5",14,"11","20","wolkig",19
"1/26/2016 3:00","6",9,"10","20","wolkig",15
"1/26/2016 4:00","8",8,"10","20","wolkig",16
"1/26/2016 5:00","38",20,"10","20","wolkig",58
"1/26/2016 6:00","108",52,"9","17","wolkig",160
"1/26/2016 7:00","495",301,"9","13","teilweise bewölkt",796
"1/26/2016 8:00","659",425,"9","11","Klarer Himmel",1084
"1/26/2016 9:00","552",438,"9","7","wolkig",990
"1/26/2016 10:00","549",408,"10","15","wolkig",957
"1/26/2016 11:00","503",531,"10","20","wolkig",1034
"1/26/2016 12:00","527",474,"11","19","wolkig",1001
"1/26/2016 13:00","446",494,"10","17","Regen",940
"1/26/2016 14:00","292",464,"11","19","wolkig",756
"1/26/2016 15:00","546",512,"11","26","wolkig",1058
"1/26/2016 16:00","610",506,"11","26","wolkig",1116
"1/26/2016 17:00","631",599,"11","22","wolkig",1230
"1/26/2016 18:00","502",573,"10","28","Klarer Himmel",1075
"1/26/2016 19:00","502",462,"10","30","wolkig",964
"1/26/2016 20:00","219",294,"9","30","Regen",513
"1/26/2016 21:00","149",292,"9","28","Regen",441
"1/26/2016 22:00","124",244,"9","32","Regen",368
"1/26/2016 23:00","74",136,"9","33","Regen",210
"1/27/2016 0:00","29",56,"9","32","Regen",85
"1/27/2016 1:00","13",42,"9","28","wolkig",55
"1/27/2016 2:00","6",11,"10","24","wolkig",17
"1/27/2016 3:00","3",2,"10","28","wolkig",5
"1/27/2016 4:00","13",3,"10","30","wolkig",16
"1/27/2016 5:00","32",14,"10","32","wolkig",46
"1/27/2016 6:00","106",30,"11","33","wolkig",136
"1/27/2016 7:00","420",239,"11","30","wolkig",659
"1/27/2016 8:00","651",457,"11","30","wolkig",1108
"1/27/2016 9:00","495",405,"11","28","wolkig",900
"1/27/2016 10:00","442",316,"10","32","Regen",758
"1/27/2016 11:00","365",332,"10","26","Regen",697
"1/27/2016 12:00","459",373,"10","30","wolkig",832
"1/27/2016 13:00","445",381,"11","28","wolkig",826
"1/27/2016 14:00","422",387,"11","28","wolkig",809
"1/27/2016 15:00","419",441,"12","26","wolkig",860
"1/27/2016 16:00","437",453,"12","26","wolkig",890
"1/27/2016 17:00","594",551,"12","32","wolkig",1145
"1/27/2016 18:00","405",528,"12","28","wolkig",933
"1/27/2016 19:00","416",368,"11","26","wolkig",784
"1/27/2016 20:00","262",331,"10","24","Regen",593
"1/27/2016 21:00","168",198,"10","28","Regen",366
"1/27/2016 22:00","144",249,"10","28","Regen",393
"1/27/2016 23:00","112",122,"10","26","Regen",234
"1/28/2016 0:00","53",109,"10","26","Regen",162
"1/28/2016 1:00","21",76,"10","26","Regen",97
"1/28/2016 2:00","18",33,"8","24","Regen",51
"1/28/2016 3:00","8",31,"8","22","Regen",39
"1/28/2016 4:00","7",26,"7","19","wolkig",33
"1/28/2016 5:00","33",18,"7","22","wolkig",51
"1/28/2016 6:00","94",30,"7","20","wolkig",124
"1/28/2016 7:00","401",244,"6","19","teilweise bewölkt",645
"1/28/2016 8:00","557",383,"5","17","teilweise bewölkt",940
"1/28/2016 9:00","487",360,"6","19","teilweise bewölkt",847
"1/28/2016 10:00","565",328,"7","28","teilweise bewölkt",893
"1/28/2016 11:00","437",453,"7","30","teilweise bewölkt",890
"1/28/2016 12:00","469",436,"8","24","teilweise bewölkt",905
"1/28/2016 13:00","499",550,"8","26","teilweise bewölkt",1049
"1/28/2016 14:00","480",483,"8","22","teilweise bewölkt",963
"1/28/2016 15:00","583",500,"8","20","teilweise bewölkt",1083
"1/28/2016 16:00","553",514,"7","17","teilweise bewölkt",1067
"1/28/2016 17:00","590",570,"6","13","Klarer Himmel",1160
"1/28/2016 18:00","484",513,"5","11","Klarer Himmel",997
"1/28/2016 19:00","361",497,"5","13","Klarer Himmel",858
"1/28/2016 20:00","245",269,"5","15","Klarer Himmel",514
"1/28/2016 21:00","190",189,"4","13","Klarer Himmel",379
"1/28/2016 22:00","154",220,"4","11","Klarer Himmel",374
"1/28/2016 23:00","91",151,"4","15","Klarer Himmel",242
"1/29/2016 0:00","52",96,"4","13","Klarer Himmel",148
"1/29/2016 1:00","16",47,"4","17","Klarer Himmel",63
"1/29/2016 2:00","17",18,"4","20","Klarer Himmel",35
"1/29/2016 3:00","7",9,"5","20","Klarer Himmel",16
"1/29/2016 4:00","15",6,"5","28","wolkig",21
"1/29/2016 5:00","28",11,"5","22","wolkig",39
"1/29/2016 6:00","87",25,"6","24","wolkig",112
"1/29/2016 7:00","376",200,"6","28","wolkig",576
"1/29/2016 8:00","507",385,"6","26","wolkig",892
"1/29/2016 9:00","475",273,"7","28","wolkig",748
"1/29/2016 10:00","464",324,"7","30","wolkig",788
"1/29/2016 11:00","415",366,"8","33","wolkig",781
"1/29/2016 12:00","435",384,"8","32","wolkig",819
"1/29/2016 13:00","387",425,"9","33","wolkig",812
"1/29/2016 14:00","376",368,"9","32","wolkig",744
"1/29/2016 15:00","396",337,"9","39","wolkig",733
"1/29/2016 16:00","359",332,"9","33","wolkig",691
"1/29/2016 17:00","348",340,"9","33","wolkig",688
"1/29/2016 18:00","330",366,"9","33","wolkig",696
"1/29/2016 19:00","258",253,"9","30","wolkig",511
"1/29/2016 20:00","230",255,"8","32","wolkig",485
"1/29/2016 21:00","144",164,"9","32","Regen",308
"1/29/2016 22:00","122",140,"9","30","wolkig",262
"1/29/2016 23:00","96",154,"9","33","Regen",250
"1/30/2016 0:00","93",117,"9","32","Regen",210
"1/30/2016 1:00","81",111,"9","35","Regen",192
"1/30/2016 2:00","40",95,"9","35","wolkig",135
"1/30/2016 3:00","24",61,"9","41","wolkig",85
"1/30/2016 4:00","18",35,"8","32","Regen",53
"1/30/2016 5:00","13",26,"8","28","Regen",39
"1/30/2016 6:00","14",8,"8","32","Regen",22
"1/30/2016 7:00","58",18,"8","37","Regen",76
"1/30/2016 8:00","96",55,"9","33","Regen",151
"1/30/2016 9:00","203",59,"9","33","Regen",262
"1/30/2016 10:00","149",69,"9","33","Regen",218
"1/30/2016 11:00","142",73,"8","33","Regen",215
"1/30/2016 12:00","137",86,"8","24","Regen",223
"1/30/2016 13:00","112",93,"7","17","Regen",205
"1/30/2016 14:00","99",148,"7","32","Regen",247
"1/30/2016 15:00","111",112,"7","19","Regen",223
"1/30/2016 16:00","81",111,"6","19","wolkig",192
"1/30/2016 17:00","114",144,"6","20","wolkig",258
"1/30/2016 18:00","120",163,"5","20","wolkig",283
"1/30/2016 19:00","187",165,"4","22","teilweise bewölkt",352
"1/30/2016 20:00","173",137,"4","19","Klarer Himmel",310
"1/30/2016 21:00","118",94,"4","22","teilweise bewölkt",212
"1/30/2016 22:00","54",119,"4","22","Klarer Himmel",173
"1/30/2016 23:00","53",91,"4","30","teilweise bewölkt",144
"1/31/2016 0:00","96",121,"3","22","teilweise bewölkt",217
"1/31/2016 1:00","62",83,"3","22","teilweise bewölkt",145
"1/31/2016 2:00","34",85,"3","24","Klarer Himmel",119
"1/31/2016 3:00","18",47,"3","24","Klarer Himmel",65
"1/31/2016 4:00","26",25,"3","24","Klarer Himmel",51
"1/31/2016 5:00","19",19,"3","28","teilweise bewölkt",38
"1/31/2016 6:00","15",7,"3","22","Klarer Himmel",22
"1/31/2016 7:00","16",13,"3","22","Klarer Himmel",29
"1/31/2016 8:00","38",27,"3","26","Klarer Himmel",65
"1/31/2016 9:00","148",34,"4","22","Klarer Himmel",182
"1/31/2016 10:00","204",56,"4","22","Klarer Himmel",260
"1/31/2016 11:00","136",89,"5","24","Klarer Himmel",225
"1/31/2016 12:00","165",88,"6","24","wolkig",253
"1/31/2016 13:00","155",141,"5","20","wolkig",296
"1/31/2016 14:00","175",163,"6","20","Regen",338
"1/31/2016 15:00","129",98,"5","15","Regen",227
"1/31/2016 16:00","146",147,"5","11","Regen",293
"1/31/2016 17:00","159",181,"5","9","Regen",340
"1/31/2016 18:00","104",145,"5","9","Regen",249
"1/31/2016 19:00","130",162,"5","9","Regen",292
"1/31/2016 20:00","65",139,"6","7","Regen",204
"1/31/2016 21:00","64",101,"6","9","wolkig",165
"1/31/2016 22:00","49",99,"8","22","wolkig",148
"1/31/2016 23:00","25",52,"9","19","Regen",77
"2/1/2016 0:00","13",25,"9","20","wolkig",38
"2/1/2016 1:00","14",11,"9","13","Regen",25
"2/1/2016 2:00","6",3,"9","15","wolkig",9
"2/1/2016 3:00","3",5,"10","17","Regen",8
"2/1/2016 4:00","13",4,"10","20","Regen",17
"2/1/2016 5:00","24",14,"11","28","Regen",38
"2/1/2016 6:00","83",32,"11","28","wolkig",115
"2/1/2016 7:00","384",160,"11","26","Regen",544
"2/1/2016 8:00","576",307,"11","33","Regen",883
"2/1/2016 9:00","454",295,"11","28","Regen",749
"2/1/2016 10:00","344",271,"11","32","Regen",615
"2/1/2016 11:00","308",375,"11","30","Regen",683
"2/1/2016 12:00","339",304,"11","39","wolkig",643
"2/1/2016 13:00","424",401,"11","37","wolkig",825
"2/1/2016 14:00","374",349,"11","44","wolkig",723
"2/1/2016 15:00","459",479,"12","39","wolkig",938
"2/1/2016 16:00","503",458,"11","35","wolkig",961
"2/1/2016 17:00","542",584,"11","33","Regen",1126
"2/1/2016 18:00","375",479,"11","30","wolkig",854
"2/1/2016 19:00","308",399,"11","33","wolkig",707
"2/1/2016 20:00","186",273,"11","32","wolkig",459
"2/1/2016 21:00","154",208,"11","37","wolkig",362
"2/1/2016 22:00","88",153,"11","37","Regen",241
"2/1/2016 23:00","49",113,"12","35","wolkig",162
"2/2/2016 0:00","26",52,"10","37","Regen",78
"2/2/2016 1:00","11",23,"11","33","Regen",34
"2/2/2016 2:00","3",20,"11","32","wolkig",23
"2/2/2016 3:00","4",3,"10","33","wolkig",7
"2/2/2016 4:00","11",8,"10","43","teilweise bewölkt",19
"2/2/2016 5:00","23",14,"10","26","wolkig",37
"2/2/2016 6:00","83",49,"10","33","wolkig",132
"2/2/2016 7:00","397",202,"9","33","wolkig",599
"2/2/2016 8:00","565",389,"10","41","wolkig",954
"2/2/2016 9:00","533",341,"10","32","wolkig",874
"2/2/2016 10:00","488",340,"10","33","wolkig",828
"2/2/2016 11:00","445",394,"10","35","Regen",839
"2/2/2016 12:00","531",377,"8","50","Regen",908
"2/2/2016 13:00","356",419,"7","39","Regen",775
"2/2/2016 14:00","365",383,"8","32","Regen",748
"2/2/2016 15:00","399",414,"6","24","Regen",813
"2/2/2016 16:00","423",437,"7","20","teilweise bewölkt",860
"2/2/2016 17:00","536",534,"7","28","wolkig",1070
"2/2/2016 18:00","430",438,"7","28","wolkig",868
"2/2/2016 19:00","385",425,"7","37","teilweise bewölkt",810
"2/2/2016 20:00","201",287,"7","33","teilweise bewölkt",488
"2/2/2016 21:00","153",231,"7","33","wolkig",384
"2/2/2016 22:00","109",210,"7","33","Klarer Himmel",319
"2/2/2016 23:00","73",126,"7","30","Klarer Himmel",199
"2/3/2016 0:00","30",43,"6","30","teilweise bewölkt",73
"2/3/2016 1:00","16",39,"6","28","Klarer Himmel",55
"2/3/2016 2:00","8",27,"5","24","Klarer Himmel",35
"2/3/2016 3:00","3",10,"5","22","teilweise bewölkt",13
"2/3/2016 4:00","14",3,"4","20","teilweise bewölkt",17
"2/3/2016 5:00","24",17,"4","22","wolkig",41
"2/3/2016 6:00","114",44,"4","20","teilweise bewölkt",158
"2/3/2016 7:00","490",201,"4","17","teilweise bewölkt",691
"2/3/2016 8:00","627",377,"4","15","teilweise bewölkt",1004
"2/3/2016 9:00","635",293,"4","26","wolkig",928
"2/3/2016 10:00","578",354,"5","28","wolkig",932
"2/3/2016 11:00","534",443,"6","32","wolkig",977
"2/3/2016 12:00","489",433,"7","33","teilweise bewölkt",922
"2/3/2016 13:00","459",487,"7","32","teilweise bewölkt",946
"2/3/2016 14:00","464",440,"6","24","teilweise bewölkt",904
"2/3/2016 15:00","434",505,"5","30","teilweise bewölkt",939
"2/3/2016 16:00","526",490,"4","24","wolkig",1016
"2/3/2016 17:00","561",622,"4","28","wolkig",1183
"2/3/2016 18:00","452",514,"5","26","wolkig",966
"2/3/2016 19:00","431",504,"4","26","wolkig",935
"2/3/2016 20:00","234",366,"4","26","wolkig",600
"2/3/2016 21:00","130",319,"3","17","teilweise bewölkt",449
"2/3/2016 22:00","201",276,"3","17","teilweise bewölkt",477
"2/3/2016 23:00","137",191,"2","19","teilweise bewölkt",328
"2/4/2016 0:00","91",105,"3","19","teilweise bewölkt",196
"2/4/2016 1:00","89",70,"3","15","teilweise bewölkt",159
"2/4/2016 2:00","82",28,"2","19","teilweise bewölkt",110
"2/4/2016 3:00","41",21,"3","19","wolkig",62
"2/4/2016 4:00","31",9,"3","15","Klarer Himmel",40
"2/4/2016 5:00","40",17,"3","19","wolkig",57
"2/4/2016 6:00","88",47,"3","19","wolkig",135
"2/4/2016 7:00","437",211,"3","17","wolkig",648
"2/4/2016 8:00","574",293,"4","17","Regen",867
"2/4/2016 9:00","474",258,"3","19","Regen",732
"2/4/2016 10:00","363",249,"3","15","Regen",612
"2/4/2016 11:00","378",305,"4","15","Regen",683
"2/4/2016 12:00","344",309,"4","19","Regen",653
"2/4/2016 13:00","318",295,"3","13","Regen",613
"2/4/2016 14:00","307",326,"3","9","Regen",633
"2/4/2016 15:00","387",362,"3","6","Regen",749
"2/4/2016 16:00","467",379,"4","4","wolkig",846
"2/4/2016 17:00","509",440,"3","6","wolkig",949
"2/4/2016 18:00","439",380,"3","9","wolkig",819
"2/4/2016 19:00","344",357,"3","11","wolkig",701
"2/4/2016 20:00","224",266,"3","11","wolkig",490
"2/4/2016 21:00","175",201,"4","11","wolkig",376
"2/4/2016 22:00","132",170,"4","11","wolkig",302
"2/4/2016 23:00","90",160,"4","11","wolkig",250
"2/5/2016 0:00","34",87,"4","7","wolkig",121
"2/5/2016 1:00","38",56,"4","11","wolkig",94
"2/5/2016 2:00","4",28,"4","7","wolkig",32
"2/5/2016 3:00","6",35,"4","9","wolkig",41
"2/5/2016 4:00","15",20,"4","11","wolkig",35
"2/5/2016 5:00","25",14,"4","11","Regen",39
"2/5/2016 6:00","70",42,"4","11","Regen",112
"2/5/2016 7:00","376",178,"4","15","Regen",554
"2/5/2016 8:00","499",245,"4","13","Regen",744
"2/5/2016 9:00","400",206,"5","13","wolkig",606
"2/5/2016 10:00","298",242,"6","15","Regen",540
"2/5/2016 11:00","299",251,"6","13","wolkig",550
"2/5/2016 12:00","327",278,"8","17","wolkig",605
"2/5/2016 13:00","403",359,"8","15","wolkig",762
"2/5/2016 14:00","371",345,"10","15","wolkig",716
"2/5/2016 15:00","358",359,"10","15","wolkig",717
"2/5/2016 16:00","342",324,"10","15","wolkig",666
"2/5/2016 17:00","330",354,"9","15","wolkig",684
"2/5/2016 18:00","302",329,"10","17","wolkig",631
"2/5/2016 19:00","275",273,"9","13","wolkig",548
"2/5/2016 20:00","233",260,"9","13","Regen",493
"2/5/2016 21:00","159",203,"9","15","wolkig",362
"2/5/2016 22:00","122",175,"9","11","Regen",297
"2/5/2016 23:00","153",162,"9","13","wolkig",315
"2/6/2016 0:00","80",113,"10","15","wolkig",193
"2/6/2016 1:00","54",98,"9","13","wolkig",152
"2/6/2016 2:00","61",44,"10","15","wolkig",105
"2/6/2016 3:00","45",39,"9","11","wolkig",84
"2/6/2016 4:00","31",33,"9","13","wolkig",64
"2/6/2016 5:00","27",34,"8","11","teilweise bewölkt",61
"2/6/2016 6:00","22",15,"8","9","wolkig",37
"2/6/2016 7:00","58",36,"7","11","wolkig",94
"2/6/2016 8:00","161",56,"8","19","wolkig",217
"2/6/2016 9:00","299",92,"8","17","wolkig",391
"2/6/2016 10:00","236",110,"9","19","wolkig",346
"2/6/2016 11:00","312",191,"9","19","wolkig",503
"2/6/2016 12:00","297",202,"10","15","wolkig",499
"2/6/2016 13:00","286",250,"10","24","wolkig",536
"2/6/2016 14:00","273",273,"10","17","wolkig",546
"2/6/2016 15:00","160",293,"11","15","wolkig",453
"2/6/2016 16:00","232",245,"11","19","wolkig",477
"2/6/2016 17:00","442",293,"10","13","Klarer Himmel",735
"2/6/2016 18:00","190",248,"9","13","Klarer Himmel",438
"2/6/2016 19:00","273",242,"9","15","Klarer Himmel",515
"2/6/2016 20:00","234",170,"9","17","Klarer Himmel",404
"2/6/2016 21:00","122",79,"8","11","Klarer Himmel",201
"2/6/2016 22:00","112",100,"9","11","Klarer Himmel",212
"2/6/2016 23:00","99",119,"8","15","Klarer Himmel",218
"2/7/2016 0:00","82",126,"8","17","Klarer Himmel",208
"2/7/2016 1:00","35",96,"8","17","Klarer Himmel",131
"2/7/2016 2:00","31",102,"9","15","Klarer Himmel",133
"2/7/2016 3:00","16",66,"9","19","Klarer Himmel",82
"2/7/2016 4:00","22",50,"9","17","Klarer Himmel",72
"2/7/2016 5:00","9",25,"10","19","Klarer Himmel",34
"2/7/2016 6:00","13",15,"10","20","Klarer Himmel",28
"2/7/2016 7:00","20",16,"10","20","Regen",36
"2/7/2016 8:00","40",20,"11","20","wolkig",60
"2/7/2016 9:00","226",55,"11","24","Regen",281
"2/7/2016 10:00","185",67,"9","19","wolkig",252
"2/7/2016 11:00","131",75,"10","22","wolkig",206
"2/7/2016 12:00","140",129,"10","32","wolkig",269
"2/7/2016 13:00","132",197,"10","28","wolkig",329
"2/7/2016 14:00","172",199,"10","28","wolkig",371
"2/7/2016 15:00","175",188,"9","22","wolkig",363
"2/7/2016 16:00","182",185,"9","24","wolkig",367
"2/7/2016 17:00","233",206,"9","22","teilweise bewölkt",439
"2/7/2016 18:00","202",193,"8","24","teilweise bewölkt",395
"2/7/2016 19:00","147",213,"8","24","Klarer Himmel",360
"2/7/2016 20:00","92",170,"8","20","Klarer Himmel",262
"2/7/2016 21:00","78",96,"7","20","Klarer Himmel",174
"2/7/2016 22:00","83",84,"7","22","Klarer Himmel",167
"2/7/2016 23:00","57",60,"7","26","Klarer Himmel",117
"2/8/2016 0:00","19",41,"6","24","Klarer Himmel",60
"2/8/2016 1:00","21",14,"7","26","Klarer Himmel",35
"2/8/2016 2:00","16",22,"7","26","teilweise bewölkt",38
"2/8/2016 3:00","8",12,"8","28","wolkig",20
"2/8/2016 4:00","76",50,"8","32","wolkig",126
"2/8/2016 5:00","24",28,"8","33","Regen",52
"2/8/2016 6:00","30",19,"8","35","Regen",49
"2/8/2016 7:00","53",37,"7","28","Regen",90
"2/8/2016 8:00","86",68,"8","30","wolkig",154
"2/8/2016 9:00","90",63,"9","26","wolkig",153
"2/8/2016 10:00","107",82,"9","24","Regen",189
"2/8/2016 11:00","145",99,"10","39","Regen",244
"2/8/2016 12:00","159",135,"10","35","wolkig",294
"2/8/2016 13:00","150",117,"9","39","Regen",267
"2/8/2016 14:00","163",112,"9","33","wolkig",275
"2/8/2016 15:00","153",127,"9","39","wolkig",280
"2/8/2016 16:00","133",147,"9","39","wolkig",280
"2/8/2016 17:00","148",144,"9","37","wolkig",292
"2/8/2016 18:00","120",132,"8","39","Regen",252
"2/8/2016 19:00","65",108,"7","39","Regen",173
"2/8/2016 20:00","68",113,"7","43","Regen",181
"2/8/2016 21:00","37",66,"8","46","Regen",103
"2/8/2016 22:00","38",80,"7","41","Regen",118
"2/8/2016 23:00","23",54,"7","43","Regen",77
"2/9/2016 0:00","15",31,"7","43","Regen",46
"2/9/2016 1:00","10",13,"7","41","Regen",23
"2/9/2016 2:00","4",11,"7","35","wolkig",15
"2/9/2016 3:00","3",2,"7","39","wolkig",5
"2/9/2016 4:00","10",3,"6","32","Regen",13
"2/9/2016 5:00","23",11,"7","30","teilweise bewölkt",34
"2/9/2016 6:00","69",31,"7","32","wolkig",100
"2/9/2016 7:00","322",157,"7","30","",479
"2/9/2016 8:00","430",255,"6","24","Regen",685
"2/9/2016 9:00","419",282,"7","15","wolkig",701
"2/9/2016 10:00","385",222,"7","19","wolkig",607
"2/9/2016 11:00","410",315,"8","17","wolkig",725
"2/9/2016 12:00","352",336,"8","13","wolkig",688
"2/9/2016 13:00","259",293,"6","19","Regen",552
"2/9/2016 14:00","229",214,"4","13","Regen",443
"2/9/2016 15:00","240",240,"5","11","Regen",480
"2/9/2016 16:00","300",288,"5","11","Regen",588
"2/9/2016 17:00","323",361,"6","13","wolkig",684
"2/9/2016 18:00","293",322,"8","33","Regen",615
"2/9/2016 19:00","225",303,"1","37","Schnee",528
"2/9/2016 20:00","167",171,"0","32","Schnee",338
"2/9/2016 21:00","100",136,"1","22","Schnee",236
"2/9/2016 22:00","69",147,"2","26","teilweise bewölkt",216
"2/9/2016 23:00","44",68,"3","22","wolkig",112
"2/10/2016 0:00","23",53,"4","24","teilweise bewölkt",76
"2/10/2016 1:00","6",18,"4","24","teilweise bewölkt",24
"2/10/2016 2:00","8",15,"3","19","teilweise bewölkt",23
"2/10/2016 3:00","6",5,"4","22","wolkig",11
"2/10/2016 4:00","8",3,"4","20","wolkig",11
"2/10/2016 5:00","20",11,"4","17","wolkig",31
"2/10/2016 6:00","74",27,"1","19","Schnee",101
"2/10/2016 7:00","361",150,"1","15","Schnee",511
"2/10/2016 8:00","511",277,"2","11","wolkig",788
"2/10/2016 9:00","432",275,"3","17","wolkig",707
"2/10/2016 10:00","437",268,"4","17","wolkig",705
"2/10/2016 11:00","338",283,"4","17","Regen",621
"2/10/2016 12:00","364",342,"5","20","wolkig",706
"2/10/2016 13:00","315",350,"5","24","wolkig",665
"2/10/2016 14:00","311",301,"6","24","wolkig",612
"2/10/2016 15:00","490",335,"6","17","wolkig",825
"2/10/2016 16:00","476",384,"6","19","Regen",860
"2/10/2016 17:00","437",386,"5","19","Regen",823
"2/10/2016 18:00","352",330,"5","20","Regen",682
"2/10/2016 19:00","371",407,"5","20","wolkig",778
"2/10/2016 20:00","256",238,"5","20","wolkig",494
"2/10/2016 21:00","107",184,"5","26","wolkig",291
"2/10/2016 22:00","152",220,"4","20","wolkig",372
"2/10/2016 23:00","95",118,"3","20","teilweise bewölkt",213
"2/11/2016 0:00","49",77,"4","20","teilweise bewölkt",126
"2/11/2016 1:00","27",72,"4","20","wolkig",99
"2/11/2016 2:00","5",36,"4","19","Klarer Himmel",41
"2/11/2016 3:00","9",36,"4","17","Klarer Himmel",45
"2/11/2016 4:00","11",17,"3","17","wolkig",28
"2/11/2016 5:00","29",15,"3","17","wolkig",44
"2/11/2016 6:00","92",44,"3","20","wolkig",136
"2/11/2016 7:00","488",218,"3","17","wolkig",706
"2/11/2016 8:00","512",332,"4","17","teilweise bewölkt",844
"2/11/2016 9:00","512",237,"4","17","teilweise bewölkt",749
"2/11/2016 10:00","439",297,"5","20","teilweise bewölkt",736
"2/11/2016 11:00","409",295,"6","19","teilweise bewölkt",704
"2/11/2016 12:00","394",297,"6","26","teilweise bewölkt",691
"2/11/2016 13:00","514",401,"6","28","teilweise bewölkt",915
"2/11/2016 14:00","473",442,"7","24","teilweise bewölkt",915
"2/11/2016 15:00","409",448,"7","24","teilweise bewölkt",857
"2/11/2016 16:00","456",448,"6","15","teilweise bewölkt",904
"2/11/2016 17:00","474",497,"6","9","wolkig",971
"2/11/2016 18:00","407",443,"4","7","wolkig",850
"2/11/2016 19:00","369",429,"4","7","wolkig",798
"2/11/2016 20:00","236",263,"4","7","wolkig",499
"2/11/2016 21:00","138",173,"3","6","wolkig",311
"2/11/2016 22:00","145",177,"2","4","wolkig",322
"2/11/2016 23:00","79",157,"4","6","wolkig",236
"2/12/2016 0:00","30",96,"3","4","wolkig",126
"2/12/2016 1:00","32",52,"3","7","wolkig",84
"2/12/2016 2:00","12",10,"1","4","teilweise bewölkt",22
"2/12/2016 3:00","9",18,"2","6","wolkig",27
"2/12/2016 4:00","9",26,"2","6","Nebel",35
"2/12/2016 5:00","27",18,"1","4","wolkig",45
"2/12/2016 6:00","95",33,"1","4","wolkig",128
"2/12/2016 7:00","438",206,"1","4","Nebel",644
"2/12/2016 8:00","500",257,"2","6","wolkig",757
"2/12/2016 9:00","465",232,"2","6","wolkig",697
"2/12/2016 10:00","408",244,"3","6","wolkig",652
"2/12/2016 11:00","331",322,"4","15","wolkig",653
"2/12/2016 12:00","374",359,"5","9","wolkig",733
"2/12/2016 13:00","562",425,"6","11","wolkig",987
"2/12/2016 14:00","327",384,"6","11","wolkig",711
"2/12/2016 15:00","465",429,"6","7","wolkig",894
"2/12/2016 16:00","423",366,"5","6","teilweise bewölkt",789
"2/12/2016 17:00","437",400,"4","6","wolkig",837
"2/12/2016 18:00","327",356,"3","6","teilweise bewölkt",683
"2/12/2016 19:00","368",281,"2","7","teilweise bewölkt",649
"2/12/2016 20:00","289",230,"1","6","Klarer Himmel",519
"2/12/2016 21:00","197",191,"1","7","Klarer Himmel",388
"2/12/2016 22:00","136",152,"0","6","Klarer Himmel",288
"2/12/2016 23:00","140",222,"0","6","Klarer Himmel",362
"2/13/2016 0:00","116",162,"0","7","Klarer Himmel",278
"2/13/2016 1:00","52",113,"-1","4","Klarer Himmel",165
"2/13/2016 2:00","29",83,"-2","4","Klarer Himmel",112
"2/13/2016 3:00","10",80,"-1","6","Klarer Himmel",90
"2/13/2016 4:00","11",61,"-2","4","Klarer Himmel",72
"2/13/2016 5:00","23",49,"-2","6","Nebel",72
"2/13/2016 6:00","30",30,"-2","6","Nebel",60
"2/13/2016 7:00","80",24,"-2","6","Klarer Himmel",104
"2/13/2016 8:00","189",63,"-1","7","Klarer Himmel",252
"2/13/2016 9:00","315",82,"1","9","Klarer Himmel",397
"2/13/2016 10:00","346",111,"4","7","Klarer Himmel",457
"2/13/2016 11:00","378",176,"4","11","Klarer Himmel",554
"2/13/2016 12:00","360",207,"5","9","Klarer Himmel",567
"2/13/2016 13:00","340",278,"7","13","Klarer Himmel",618
"2/13/2016 14:00","319",308,"7","15","Klarer Himmel",627
"2/13/2016 15:00","229",258,"6","13","Klarer Himmel",487
"2/13/2016 16:00","217",290,"6","9","Klarer Himmel",507
"2/13/2016 17:00","201",258,"5","7","Klarer Himmel",459
"2/13/2016 18:00","206",297,"5","6","wolkig",503
"2/13/2016 19:00","190",227,"5","9","wolkig",417
"2/13/2016 20:00","203",173,"4","9","wolkig",376
"2/13/2016 21:00","112",116,"4","9","Regen",228
"2/13/2016 22:00","93",121,"4","9","Regen",214
"2/13/2016 23:00","84",100,"3","9","Schnee",184
"2/14/2016 0:00","91",99,"3","9","Schnee",190
"2/14/2016 1:00","70",87,"2","11","Schnee",157
"2/14/2016 2:00","41",109,"2","13","Schnee",150
"2/14/2016 3:00","23",78,"2","15","Schnee",101
"2/14/2016 4:00","17",47,"2","15","Schnee",64
"2/14/2016 5:00","14",32,"1","11","Schnee",46
"2/14/2016 6:00","9",23,"2","9","Schnee",32
"2/14/2016 7:00","24",7,"2","13","Schnee",31
"2/14/2016 8:00","31",17,"2","13","Schnee",48
"2/14/2016 9:00","187",34,"2","17","Schnee",221
"2/14/2016 10:00","178",53,"2","15","Schnee",231
"2/14/2016 11:00","91",53,"2","17","Schnee",144
"2/14/2016 12:00","97",88,"2","13","Schnee",185
"2/14/2016 13:00","116",102,"2","13","Regen",218
"2/14/2016 14:00","122",112,"2","6","Schnee",234
"2/14/2016 15:00","88",108,"1","7","Regen",196
"2/14/2016 16:00","94",97,"0","4","Schnee",191
"2/14/2016 17:00","114",130,"0","6","Schnee",244
"2/14/2016 18:00","115",130,"0","6","Schnee",245
"2/14/2016 19:00","83",126,"0","6","Schnee",209
"2/14/2016 20:00","58",120,"0","6","Schnee",178
"2/14/2016 21:00","47",87,"1","7","Schnee",134
"2/14/2016 22:00","30",52,"0","11","Schnee",82
"2/14/2016 23:00","20",47,"1","11","Schnee",67
"2/15/2016 0:00","14",19,"1","9","Schnee",33
"2/15/2016 1:00","4",13,"1","9","Schnee",17
"2/15/2016 2:00","4",2,"1","17","Schnee",6
"2/15/2016 3:00","1",0,"1","17","Schnee",1
"2/15/2016 4:00","7",4,"1","17","Schnee",11
"2/15/2016 5:00","21",12,"1","17","Schnee",33
"2/15/2016 6:00","69",28,"0","19","Schnee",97
"2/15/2016 7:00","355",137,"0","19","Schnee",492
"2/15/2016 8:00","348",221,"1","19","Schnee",569
"2/15/2016 9:00","245",184,"1","19","Schnee",429
"2/15/2016 10:00","174",137,"1","22","wolkig",311
"2/15/2016 11:00","199",162,"1","20","wolkig",361
"2/15/2016 12:00","225",199,"1","19","wolkig",424
"2/15/2016 13:00","232",228,"1","22","wolkig",460
"2/15/2016 14:00","299",221,"1","22","wolkig",520
"2/15/2016 15:00","317",237,"1","20","wolkig",554
"2/15/2016 16:00","364",288,"1","15","wolkig",652
"2/15/2016 17:00","351",393,"0","7","teilweise bewölkt",744
"2/15/2016 18:00","315",363,"0","15","teilweise bewölkt",678
"2/15/2016 19:00","242",269,"0","11","wolkig",511
"2/15/2016 20:00","132",213,"-1","6","teilweise bewölkt",345
"2/15/2016 21:00","90",188,"-2","2","wolkig",278
"2/15/2016 22:00","53",122,"-2","4","wolkig",175
"2/15/2016 23:00","31",105,"-3","2","wolkig",136
"2/16/2016 0:00","22",78,"-3","6","wolkig",100
"2/16/2016 1:00","10",36,"-2","2","wolkig",46
"2/16/2016 2:00","14",15,"-3","4","teilweise bewölkt",29
"2/16/2016 3:00","7",14,"-3","2","wolkig",21
"2/16/2016 4:00","9",5,"-5","2","Nebel",14
"2/16/2016 5:00","27",16,"-5","2","Nebel",43
"2/16/2016 6:00","96",37,"-5","2","Nebel",133
"2/16/2016 7:00","413",193,"-6","2","Nebel",606
"2/16/2016 8:00","452",264,"-4","2","Nebel",716
"2/16/2016 9:00","408",270,"-2","2","",678
"2/16/2016 10:00","346",168,"1","2","Klarer Himmel",514
"2/16/2016 11:00","283",210,"2","4","teilweise bewölkt",493
"2/16/2016 12:00","316",279,"2","9","teilweise bewölkt",595
"2/16/2016 13:00","319",351,"4","4","teilweise bewölkt",670
"2/16/2016 14:00","447",319,"3","7","Klarer Himmel",766
"2/16/2016 15:00","344",307,"3","6","Klarer Himmel",651
"2/16/2016 16:00","392",434,"2","7","Klarer Himmel",826
"2/16/2016 17:00","443",514,"1","6","",957
"2/16/2016 18:00","371",409,"0","6","Klarer Himmel",780
"2/16/2016 19:00","313",354,"-1","6","Klarer Himmel",667
"2/16/2016 20:00","217",243,"-1","6","Klarer Himmel",460
"2/16/2016 21:00","113",206,"-2","6","Klarer Himmel",319
"2/16/2016 22:00","95",174,"-2","9","Klarer Himmel",269
"2/16/2016 23:00","61",124,"-2","7","Klarer Himmel",185
"2/17/2016 0:00","20",59,"-2","6","Klarer Himmel",79
"2/17/2016 1:00","12",43,"-3","4","Klarer Himmel",55
"2/17/2016 2:00","6",36,"-3","4","Klarer Himmel",42
"2/17/2016 3:00","6",15,"-4","6","Klarer Himmel",21
"2/17/2016 4:00","8",4,"-4","11","Klarer Himmel",12
"2/17/2016 5:00","34",6,"-3","7","Klarer Himmel",40
"2/17/2016 6:00","97",43,"-3","11","Klarer Himmel",140
"2/17/2016 7:00","464",179,"-3","4","Klarer Himmel",643
"2/17/2016 8:00","441",265,"-2","7","Klarer Himmel",706
"2/17/2016 9:00","398",211,"0","9","Klarer Himmel",609
"2/17/2016 10:00","323",218,"1","13","Klarer Himmel",541
"2/17/2016 11:00","356",239,"2","15","teilweise bewölkt",595
"2/17/2016 12:00","351",300,"3","11","teilweise bewölkt",651
"2/17/2016 13:00","337",355,"2","9","wolkig",692
"2/17/2016 14:00","404",345,"3","9","teilweise bewölkt",749
"2/17/2016 15:00","304",339,"3","11","wolkig",643
"2/17/2016 16:00","395",405,"2","9","teilweise bewölkt",800
"2/17/2016 17:00","418",422,"1","4","teilweise bewölkt",840
"2/17/2016 18:00","381",452,"-1","2","teilweise bewölkt",833
"2/17/2016 19:00","349",353,"-2","4","teilweise bewölkt",702
"2/17/2016 20:00","201",240,"-3","0","Klarer Himmel",441
"2/17/2016 21:00","108",182,"-3","0","Nebel",290
"2/17/2016 22:00","142",190,"-4","0","Nebel",332
"2/17/2016 23:00","87",131,"-3","4","Nebel",218
"2/18/2016 0:00","80",79,"-4","0","Nebel",159
"2/18/2016 1:00","21",91,"-2","6","",112
"2/18/2016 2:00","8",48,"-2","2","wolkig",56
"2/18/2016 3:00","9",27,"-1","4","wolkig",36
"2/18/2016 4:00","16",26,"-1","4","wolkig",42
"2/18/2016 5:00","30",19,"-1","2","wolkig",49
"2/18/2016 6:00","93",41,"0","7","Schnee",134
"2/18/2016 7:00","456",159,"0","7","Schnee",615
"2/18/2016 8:00","504",267,"1","9","Schnee",771
"2/18/2016 9:00","407",212,"1","7","wolkig",619
"2/18/2016 10:00","277",179,"2","6","wolkig",456
"2/18/2016 11:00","255",243,"3","15","Klarer Himmel",498
"2/18/2016 12:00","286",230,"4","11","wolkig",516
"2/18/2016 13:00","347",280,"4","17","wolkig",627
"2/18/2016 14:00","356",310,"5","19","wolkig",666
"2/18/2016 15:00","356",298,"5","11","wolkig",654
"2/18/2016 16:00","407",357,"4","9","wolkig",764
"2/18/2016 17:00","399",440,"2","2","Klarer Himmel",839
"2/18/2016 18:00","382",443,"0","2","Klarer Himmel",825
"2/18/2016 19:00","292",307,"0","4","wolkig",599
"2/18/2016 20:00","167",213,"0","4","wolkig",380
"2/18/2016 21:00","120",181,"0","2","wolkig",301
"2/18/2016 22:00","78",190,"0","6","wolkig",268
"2/18/2016 23:00","73",151,"0","2","wolkig",224
"2/19/2016 0:00","29",53,"0","2","Klarer Himmel",82
"2/19/2016 1:00","37",39,"0","2","wolkig",76
"2/19/2016 2:00","12",17,"0","2","wolkig",29
"2/19/2016 3:00","6",11,"0","6","Klarer Himmel",17
"2/19/2016 4:00","10",16,"0","2","Klarer Himmel",26
"2/19/2016 5:00","29",16,"0","2","wolkig",45
"2/19/2016 6:00","87",40,"0","4","wolkig",127
"2/19/2016 7:00","433",164,"1","4","Schnee",597
"2/19/2016 8:00","428",252,"1","6","Schnee",680
"2/19/2016 9:00","380",204,"2","9","",584
"2/19/2016 10:00","329",168,"2","9","wolkig",497
"2/19/2016 11:00","268",173,"3","11","wolkig",441
"2/19/2016 12:00","325",284,"3","19","Regen",609
"2/19/2016 13:00","314",357,"3","13","Regen",671
"2/19/2016 14:00","339",320,"3","9","wolkig",659
"2/19/2016 15:00","342",275,"3","13","wolkig",617
"2/19/2016 16:00","335",304,"3","9","wolkig",639
"2/19/2016 17:00","325",307,"3","7","wolkig",632
"2/19/2016 18:00","326",307,"1","6","",633
"2/19/2016 19:00","307",243,"2","11","",550
"2/19/2016 20:00","221",217,"1","13","",438
"2/19/2016 21:00","167",115,"1","13","",282
"2/19/2016 22:00","110",171,"1","13","Klarer Himmel",281
"2/19/2016 23:00","125",160,"2","15","Klarer Himmel",285
"2/20/2016 0:00","70",131,"2","17","Klarer Himmel",201
"2/20/2016 1:00","74",128,"3","20","Klarer Himmel",202
"2/20/2016 2:00","38",107,"4","20","Klarer Himmel",145
"2/20/2016 3:00","25",86,"4","22","Regen",111
"2/20/2016 4:00","16",55,"4","26","Regen",71
"2/20/2016 5:00","22",42,"5","30","wolkig",64
"2/20/2016 6:00","25",27,"4","26","Regen",52
"2/20/2016 7:00","44",50,"4","24","Regen",94
"2/20/2016 8:00","162",51,"5","24","Regen",213
"2/20/2016 9:00","176",42,"5","22","Regen",218
"2/20/2016 10:00","156",62,"6","20","Regen",218
"2/20/2016 11:00","217",127,"7","24","Regen",344
"2/20/2016 12:00","161",118,"8","22","wolkig",279
"2/20/2016 13:00","136",153,"8","22","wolkig",289
"2/20/2016 14:00","156",141,"9","28","wolkig",297
"2/20/2016 15:00","157",130,"9","24","wolkig",287
"2/20/2016 16:00","133",129,"9","24","Regen",262
"2/20/2016 17:00","133",136,"8","30","Regen",269
"2/20/2016 18:00","112",141,"7","19","Regen",253
"2/20/2016 19:00","150",180,"8","20","wolkig",330
"2/20/2016 20:00","139",135,"7","15","Regen",274
"2/20/2016 21:00","97",79,"9","28","Regen",176
"2/20/2016 22:00","78",89,"9","30","Regen",167
"2/20/2016 23:00","55",75,"10","35","Regen",130
"2/21/2016 0:00","68",66,"10","39","Regen",134
"2/21/2016 1:00","53",81,"10","30","Regen",134
"2/21/2016 2:00","34",73,"8","26","Regen",107
"2/21/2016 3:00","15",83,"8","24","Regen",98
"2/21/2016 4:00","15",47,"8","24","Regen",62
"2/21/2016 5:00","8",30,"8","20","wolkig",38
"2/21/2016 6:00","8",12,"8","28","wolkig",20
"2/21/2016 7:00","14",10,"8","19","Regen",24
"2/21/2016 8:00","21",20,"8","17","Regen",41
"2/21/2016 9:00","79",21,"8","11","Regen",100
"2/21/2016 10:00","101",38,"8","11","Regen",139
"2/21/2016 11:00","86",38,"11","30","Regen",124
"2/21/2016 12:00","80",54,"11","32","Regen",134
"2/21/2016 13:00","82",64,"11","37","Regen",146
"2/21/2016 14:00","94",77,"11","37","Regen",171
"2/21/2016 15:00","67",89,"11","37","Regen",156
"2/21/2016 16:00","102",99,"11","30","Regen",201
"2/21/2016 17:00","85",108,"12","39","wolkig",193
"2/21/2016 18:00","99",103,"12","35","Regen",202
"2/21/2016 19:00","56",123,"12","41","Regen",179
"2/21/2016 20:00","49",110,"11","33","Regen",159
"2/21/2016 21:00","34",55,"12","44","Regen",89
"2/21/2016 22:00","44",48,"11","44","Regen",92
"2/21/2016 23:00","29",40,"11","41","Regen",69
"2/22/2016 0:00","12",16,"11","43","Regen",28
"2/22/2016 1:00","5",11,"11","43","wolkig",16
"2/22/2016 2:00","1",3,"10","39","Regen",4
"2/22/2016 3:00","4",0,"10","41","Regen",4
"2/22/2016 4:00","10",2,"10","28","Regen",12
"2/22/2016 5:00","21",16,"10","26","Regen",37
"2/22/2016 6:00","78",32,"9","30","Regen",110
"2/22/2016 7:00","283",115,"9","20","Regen",398
"2/22/2016 8:00","375",216,"7","7","Regen",591
"2/22/2016 9:00","289",151,"7","11","Regen",440
"2/22/2016 10:00","150",132,"6","17","Regen",282
"2/22/2016 11:00","166",151,"6","13","Regen",317
"2/22/2016 12:00","170",184,"6","13","Regen",354
"2/22/2016 13:00","169",185,"6","17","Regen",354
"2/22/2016 14:00","161",151,"5","19","Regen",312
"2/22/2016 15:00","191",197,"5","26","Regen",388
"2/22/2016 16:00","236",250,"5","15","wolkig",486
"2/22/2016 17:00","344",342,"5","15","Regen",686
"2/22/2016 18:00","271",312,"5","17","Regen",583
"2/22/2016 19:00","220",247,"5","17","Regen",467
"2/22/2016 20:00","159",182,"4","19","wolkig",341
"2/22/2016 21:00","82",135,"4","15","wolkig",217
"2/22/2016 22:00","69",120,"4","17","wolkig",189
"2/22/2016 23:00","34",83,"4","15","wolkig",117
"2/23/2016 0:00","13",38,"4","15","wolkig",51
"2/23/2016 1:00","7",30,"4","15","wolkig",37
"2/23/2016 2:00","6",16,"4","15","wolkig",22
"2/23/2016 3:00","5",1,"4","15","wolkig",6
"2/23/2016 4:00","11",5,"4","9","wolkig",16
"2/23/2016 5:00","30",19,"3","11","wolkig",49
"2/23/2016 6:00","110",36,"3","11","wolkig",146
"2/23/2016 7:00","415",165,"3","11","teilweise bewölkt",580
"2/23/2016 8:00","473",242,"4","7","teilweise bewölkt",715
"2/23/2016 9:00","438",202,"5","19","teilweise bewölkt",640
"2/23/2016 10:00","261",168,"6","17","teilweise bewölkt",429
"2/23/2016 11:00","287",199,"6","20","teilweise bewölkt",486
"2/23/2016 12:00","312",285,"8","20","teilweise bewölkt",597
"2/23/2016 13:00","301",283,"8","22","wolkig",584
"2/23/2016 14:00","326",259,"7","19","Regen",585
"2/23/2016 15:00","334",338,"6","13","wolkig",672
"2/23/2016 16:00","327",397,"6","20","teilweise bewölkt",724
"2/23/2016 17:00","436",456,"5","17","teilweise bewölkt",892
"2/23/2016 18:00","420",375,"4","17","teilweise bewölkt",795
"2/23/2016 19:00","328",307,"4","17","wolkig",635
"2/23/2016 20:00","207",277,"4","15","wolkig",484
"2/23/2016 21:00","130",178,"3","15","teilweise bewölkt",308
"2/23/2016 22:00","141",236,"2","13","teilweise bewölkt",377
"2/23/2016 23:00","66",106,"2","15","teilweise bewölkt",172
"2/24/2016 0:00","36",61,"1","13","Klarer Himmel",97
"2/24/2016 1:00","12",46,"1","13","Klarer Himmel",58
"2/24/2016 2:00","6",22,"1","13","Klarer Himmel",28
"2/24/2016 3:00","3",5,"1","9","teilweise bewölkt",8
"2/24/2016 4:00","11",4,"1","13","teilweise bewölkt",15
"2/24/2016 5:00","28",14,"0","7","wolkig",42
"2/24/2016 6:00","108",41,"0","9","",149
"2/24/2016 7:00","435",174,"0","9","Nebel",609
"2/24/2016 8:00","551",273,"1","9","",824
"2/24/2016 9:00","394",227,"3","13","Klarer Himmel",621
"2/24/2016 10:00","375",192,"4","17","teilweise bewölkt",567
"2/24/2016 11:00","305",194,"5","19","teilweise bewölkt",499
"2/24/2016 12:00","356",297,"7","19","teilweise bewölkt",653
"2/24/2016 13:00","329",359,"7","19","teilweise bewölkt",688
"2/24/2016 14:00","291",313,"5","15","Klarer Himmel",604
"2/24/2016 15:00","320",300,"6","20","Klarer Himmel",620
"2/24/2016 16:00","392",379,"5","9","Klarer Himmel",771
"2/24/2016 17:00","469",487,"4","9","Klarer Himmel",956
"2/24/2016 18:00","418",431,"3","6","Klarer Himmel",849
"2/24/2016 19:00","388",313,"4","6","wolkig",701
"2/24/2016 20:00","228",249,"2","6","wolkig",477
"2/24/2016 21:00","163",216,"2","7","wolkig",379
"2/24/2016 22:00","138",202,"2","7","Klarer Himmel",340
"2/24/2016 23:00","109",136,"1","6","Klarer Himmel",245
"2/25/2016 0:00","64",56,"0","7","Klarer Himmel",120
"2/25/2016 1:00","42",68,"0","7","Klarer Himmel",110
"2/25/2016 2:00","12",49,"0","9","Klarer Himmel",61
"2/25/2016 3:00","4",33,"-1","4","Klarer Himmel",37
"2/25/2016 4:00","15",34,"-2","4","Nebel",49
"2/25/2016 5:00","36",22,"-2","4","Nebel",58
"2/25/2016 6:00","98",48,"-1","9","Nebel",146
"2/25/2016 7:00","419",178,"-1","7","Nebel",597
"2/25/2016 8:00","442",272,"0","9","teilweise bewölkt",714
"2/25/2016 9:00","405",259,"2","15","teilweise bewölkt",664
"2/25/2016 10:00","266",180,"3","17","teilweise bewölkt",446
"2/25/2016 11:00","271",202,"5","22","teilweise bewölkt",473
"2/25/2016 12:00","302",257,"5","24","teilweise bewölkt",559
"2/25/2016 13:00","326",305,"4","26","teilweise bewölkt",631
"2/25/2016 14:00","342",327,"6","19","teilweise bewölkt",669
"2/25/2016 15:00","351",335,"4","19","Regen",686
"2/25/2016 16:00","350",328,"3","19","teilweise bewölkt",678
"2/25/2016 17:00","420",369,"2","13","Regen",789
"2/25/2016 18:00","357",416,"2","15","teilweise bewölkt",773
"2/25/2016 19:00","313",294,"1","11","Klarer Himmel",607
"2/25/2016 20:00","194",219,"1","11","Klarer Himmel",413
"2/25/2016 21:00","152",193,"0","9","Klarer Himmel",345
"2/25/2016 22:00","87",188,"0","7","teilweise bewölkt",275
"2/25/2016 23:00","62",148,"0","9","wolkig",210
"2/26/2016 0:00","31",67,"0","9","teilweise bewölkt",98
"2/26/2016 1:00","10",35,"0","9","Nebel",45
"2/26/2016 2:00","6",17,"-1","9","Nebel",23
"2/26/2016 3:00","4",19,"-1","7","Nebel",23
"2/26/2016 4:00","14",6,"-1","7","teilweise bewölkt",20
"2/26/2016 5:00","30",10,"-1","9","Nebel",40
"2/26/2016 6:00","97",40,"-1","9","wolkig",137
"2/26/2016 7:00","365",145,"-1","9","wolkig",510
"2/26/2016 8:00","433",237,"-1","7","wolkig",670
"2/26/2016 9:00","334",166,"0","6","wolkig",500
"2/26/2016 10:00","274",157,"0","7","wolkig",431
"2/26/2016 11:00","238",199,"1","9","wolkig",437
"2/26/2016 12:00","392",262,"2","7","wolkig",654
"2/26/2016 13:00","271",301,"3","7","teilweise bewölkt",572
"2/26/2016 14:00","287",313,"4","4","teilweise bewölkt",600
"2/26/2016 15:00","322",326,"4","2","wolkig",648
"2/26/2016 16:00","352",262,"4","4","wolkig",614
"2/26/2016 17:00","333",294,"3","6","Klarer Himmel",627
"2/26/2016 18:00","259",279,"2","4","Klarer Himmel",538
"2/26/2016 19:00","248",224,"1","4","Klarer Himmel",472
"2/26/2016 20:00","180",167,"1","4","Klarer Himmel",347
"2/26/2016 21:00","150",155,"1","4","Klarer Himmel",305
"2/26/2016 22:00","100",167,"1","4","Klarer Himmel",267
"2/26/2016 23:00","90",147,"0","6","wolkig",237
"2/27/2016 0:00","86",90,"-1","4","",176
"2/27/2016 1:00","60",76,"-1","4","",136
"2/27/2016 2:00","27",78,"0","4","Klarer Himmel",105
"2/27/2016 3:00","28",64,"-1","6","Klarer Himmel",92
"2/27/2016 4:00","16",46,"-1","6","Klarer Himmel",62
"2/27/2016 5:00","13",25,"-1","6","Klarer Himmel",38
"2/27/2016 6:00","19",18,"-1","4","Klarer Himmel",37
"2/27/2016 7:00","58",33,"-2","6","Klarer Himmel",91
"2/27/2016 8:00","127",63,"0","7","Klarer Himmel",190
"2/27/2016 9:00","229",68,"2","11","Klarer Himmel",297
"2/27/2016 10:00","359",108,"4","13","Klarer Himmel",467
"2/27/2016 11:00","317",178,"4","17","Klarer Himmel",495
"2/27/2016 12:00","345",178,"5","22","teilweise bewölkt",523
"2/27/2016 13:00","312",224,"6","22","teilweise bewölkt",536
"2/27/2016 14:00","264",281,"5","22","teilweise bewölkt",545
"2/27/2016 15:00","247",217,"5","20","teilweise bewölkt",464
"2/27/2016 16:00","203",264,"5","15","teilweise bewölkt",467
"2/27/2016 17:00","189",289,"4","15","teilweise bewölkt",478
"2/27/2016 18:00","178",286,"1","9","Klarer Himmel",464
"2/27/2016 19:00","227",181,"0","9","Klarer Himmel",408
"2/27/2016 20:00","164",168,"0","11","Klarer Himmel",332
"2/27/2016 21:00","192",117,"1","13","Klarer Himmel",309
"2/27/2016 22:00","82",115,"0","11","Klarer Himmel",197
"2/27/2016 23:00","73",134,"0","15","Klarer Himmel",207
"2/28/2016 0:00","53",117,"0","11","Klarer Himmel",170
"2/28/2016 1:00","59",118,"-2","9","Klarer Himmel",177
"2/28/2016 2:00","55",91,"-2","11","Klarer Himmel",146
"2/28/2016 3:00","19",56,"-2","9","Klarer Himmel",75
"2/28/2016 4:00","12",33,"-3","9","Klarer Himmel",45
"2/28/2016 5:00","8",28,"-3","11","Klarer Himmel",36
"2/28/2016 6:00","8",19,"-3","7","Klarer Himmel",27
"2/28/2016 7:00","30",16,"-2","9","Klarer Himmel",46
"2/28/2016 8:00","34",34,"0","13","Klarer Himmel",68
"2/28/2016 9:00","129",38,"1","17","Klarer Himmel",167
"2/28/2016 10:00","181",72,"3","20","Klarer Himmel",253
"2/28/2016 11:00","151",93,"4","20","Klarer Himmel",244
"2/28/2016 12:00","136",118,"5","28","Klarer Himmel",254
"2/28/2016 13:00","169",139,"6","19","teilweise bewölkt",308
"2/28/2016 14:00","231",157,"6","20","Klarer Himmel",388
"2/28/2016 15:00","193",155,"5","26","Klarer Himmel",348
"2/28/2016 16:00","147",173,"5","17","Klarer Himmel",320
"2/28/2016 17:00","162",207,"4","17","Klarer Himmel",369
"2/28/2016 18:00","146",132,"3","17","Klarer Himmel",278
"2/28/2016 19:00","122",150,"2","7","Klarer Himmel",272
"2/28/2016 20:00","67",111,"-1","7","Klarer Himmel",178
"2/28/2016 21:00","58",91,"1","15","Klarer Himmel",149
"2/28/2016 22:00","49",49,"0","7","Klarer Himmel",98
"2/28/2016 23:00","22",84,"-1","9","Klarer Himmel",106
"2/29/2016 0:00","4",29,"0","13","Klarer Himmel",33
"2/29/2016 1:00","6",16,"-1","11","Klarer Himmel",22
"2/29/2016 2:00","5",6,"-1","15","Klarer Himmel",11
"2/29/2016 3:00","3",2,"-2","11","Klarer Himmel",5
"2/29/2016 4:00","15",2,"-2","9","Klarer Himmel",17
"2/29/2016 5:00","28",14,"-2","11","Klarer Himmel",42
"2/29/2016 6:00","100",36,"-2","13","Klarer Himmel",136
"2/29/2016 7:00","413",185,"-2","13","Klarer Himmel",598
"2/29/2016 8:00","482",230,"0","15","Klarer Himmel",712
"2/29/2016 9:00","378",259,"1","19","Klarer Himmel",637
"2/29/2016 10:00","316",190,"3","19","Klarer Himmel",506
"2/29/2016 11:00","229",201,"4","20","Klarer Himmel",430
"2/29/2016 12:00","325",286,"4","22","Klarer Himmel",611
"2/29/2016 13:00","316",309,"5","19","teilweise bewölkt",625
"2/29/2016 14:00","304",277,"5","19","Klarer Himmel",581
"2/29/2016 15:00","334",363,"5","20","Klarer Himmel",697
"2/29/2016 16:00","418",378,"4","20","teilweise bewölkt",796
"2/29/2016 17:00","456",482,"2","17","Klarer Himmel",938
"2/29/2016 18:00","345",420,"1","13","Klarer Himmel",765
"2/29/2016 19:00","329",307,"0","11","Klarer Himmel",636
"2/29/2016 20:00","167",215,"0","13","Klarer Himmel",382
"2/29/2016 21:00","112",156,"-1","7","Klarer Himmel",268
"2/29/2016 22:00","75",193,"-2","4","Klarer Himmel",268
"2/29/2016 23:00","42",109,"-3","2","",151
"3/1/2016 0:00","20",73,"-3","0","",93
"3/1/2016 1:00","7",38,"-4","4","",45
"3/1/2016 2:00","3",6,"-5","2","",9
"3/1/2016 3:00","5",5,"-5","2","Nebel",10
"3/1/2016 4:00","14",4,"-5","2","Nebel",18
"3/1/2016 5:00","21",13,"-6","2","Nebel",34
"3/1/2016 6:00","115",36,"-5","0","Nebel",151
"3/1/2016 7:00","426",178,"-5","4","Nebel",604
"3/1/2016 8:00","480",265,"-3","6","",745
"3/1/2016 9:00","393",204,"-1","9","",597
"3/1/2016 10:00","276",188,"1","13","",464
"3/1/2016 11:00","266",224,"2","13","Klarer Himmel",490
"3/1/2016 12:00","325",297,"3","17","Klarer Himmel",622
"3/1/2016 13:00","322",299,"4","20","wolkig",621
"3/1/2016 14:00","289",291,"4","17","wolkig",580
"3/1/2016 15:00","284",343,"4","20","Regen",627
"3/1/2016 16:00","323",332,"3","20","Regen",655
"3/1/2016 17:00","388",400,"2","17","Regen",788
"3/1/2016 18:00","318",351,"2","17","Regen",669
"3/1/2016 19:00","271",266,"3","20","Regen",537
"3/1/2016 20:00","167",196,"3","19","Regen",363
"3/1/2016 21:00","85",161,"3","20","Regen",246
"3/1/2016 22:00","76",147,"4","22","wolkig",223
"3/1/2016 23:00","37",86,"5","24","wolkig",123
"3/2/2016 0:00","18",59,"5","20","wolkig",77
"3/2/2016 1:00","17",43,"5","17","wolkig",60
"3/2/2016 2:00","12",17,"5","15","Regen",29
"3/2/2016 3:00","3",10,"6","20","Regen",13
"3/2/2016 4:00","12",2,"6","19","Regen",14
"3/2/2016 5:00","32",23,"7","20","wolkig",55
"3/2/2016 6:00","109",30,"7","24","wolkig",139
"3/2/2016 7:00","452",147,"7","22","wolkig",599
"3/2/2016 8:00","447",242,"7","28","wolkig",689
"3/2/2016 9:00","372",179,"7","20","Regen",551
"3/2/2016 10:00","188",110,"4","28","Regen",298
"3/2/2016 11:00","172",136,"5","28","wolkig",308
"3/2/2016 12:00","317",190,"6","28","wolkig",507
"3/2/2016 13:00","254",265,"7","30","teilweise bewölkt",519
"3/2/2016 14:00","244",253,"6","28","teilweise bewölkt",497
"3/2/2016 15:00","258",308,"7","20","teilweise bewölkt",566
"3/2/2016 16:00","333",295,"6","13","wolkig",628
"3/2/2016 17:00","364",345,"6","11","wolkig",709
"3/2/2016 18:00","357",402,"6","11","wolkig",759
"3/2/2016 19:00","301",283,"5","11","wolkig",584
"3/2/2016 20:00","190",195,"5","19","Regen",385
"3/2/2016 21:00","115",142,"4","15","teilweise bewölkt",257
"3/2/2016 22:00","138",190,"4","17","wolkig",328
"3/2/2016 23:00","77",97,"4","22","wolkig",174
"3/3/2016 0:00","54",74,"4","20","wolkig",128
"3/3/2016 1:00","17",72,"4","20","Regen",89
"3/3/2016 2:00","13",45,"3","20","Regen",58
"3/3/2016 3:00","12",35,"3","19","Regen",47
"3/3/2016 4:00","16",23,"3","19","Regen",39
"3/3/2016 5:00","42",27,"3","19","Regen",69
"3/3/2016 6:00","103",34,"3","19","wolkig",137
"3/3/2016 7:00","438",178,"3","19","wolkig",616
"3/3/2016 8:00","493",254,"3","17","wolkig",747
"3/3/2016 9:00","405",191,"4","22","wolkig",596
"3/3/2016 10:00","281",198,"5","19","wolkig",479
"3/3/2016 11:00","255",191,"5","19","wolkig",446
"3/3/2016 12:00","313",270,"6","24","wolkig",583
"3/3/2016 13:00","311",290,"5","24","wolkig",601
"3/3/2016 14:00","429",330,"2","20","Regen",759
"3/3/2016 15:00","299",331,"5","17","wolkig",630
"3/3/2016 16:00","401",451,"2","17","Regen",852
"3/3/2016 17:00","390",457,"4","13","teilweise bewölkt",847
"3/3/2016 18:00","374",369,"3","11","teilweise bewölkt",743
"3/3/2016 19:00","312",332,"2","7","teilweise bewölkt",644
"3/3/2016 20:00","225",195,"1","6","Klarer Himmel",420
"3/3/2016 21:00","174",179,"1","4","Nebel",353
"3/3/2016 22:00","125",155,"0","4","Nebel",280
"3/3/2016 23:00","81",125,"-2","7","Nebel",206
"3/4/2016 0:00","79",65,"-2","6","Nebel",144
"3/4/2016 1:00","42",55,"0","9","Nebel",97
"3/4/2016 2:00","10",41,"0","9","Klarer Himmel",51
"3/4/2016 3:00","5",64,"0","9","Klarer Himmel",69
"3/4/2016 4:00","14",43,"0","11","Klarer Himmel",57
"3/4/2016 5:00","33",41,"0","11","",74
"3/4/2016 6:00","91",35,"0","11","",126
"3/4/2016 7:00","414",167,"0","9","",581
"3/4/2016 8:00","376",240,"2","17","wolkig",616
"3/4/2016 9:00","334",185,"2","15","wolkig",519
"3/4/2016 10:00","244",142,"3","17","wolkig",386
"3/4/2016 11:00","234",179,"4","15","wolkig",413
"3/4/2016 12:00","267",253,"4","20","Regen",520
"3/4/2016 13:00","252",240,"4","24","Regen",492
"3/4/2016 14:00","175",280,"2","26","Regen",455
"3/4/2016 15:00","181",197,"2","22","Regen",378
"3/4/2016 16:00","191",166,"1","15","Regen",357
"3/4/2016 17:00","186",216,"2","15","Regen",402
"3/4/2016 18:00","171",211,"3","11","wolkig",382
"3/4/2016 19:00","197",174,"3","11","wolkig",371
"3/4/2016 20:00","159",114,"3","9","wolkig",273
"3/4/2016 21:00","107",120,"3","7","wolkig",227
"3/4/2016 22:00","79",123,"3","7","wolkig",202
"3/4/2016 23:00","84",100,"3","7","wolkig",184
"3/5/2016 0:00","89",70,"3","6","wolkig",159
"3/5/2016 1:00","50",77,"3","2","wolkig",127
"3/5/2016 2:00","35",83,"2","2","Nebel",118
"3/5/2016 3:00","14",56,"0","2","Nebel",70
"3/5/2016 4:00","9",35,"2","2","Nebel",44
"3/5/2016 5:00","19",41,"2","6","Nebel",60
"3/5/2016 6:00","21",17,"2","4","Nebel",38
"3/5/2016 7:00","50",17,"2","4","Nebel",67
"3/5/2016 8:00","95",38,"2","6","wolkig",133
"3/5/2016 9:00","196",67,"2","11","wolkig",263
"3/5/2016 10:00","213",107,"3","9","wolkig",320
"3/5/2016 11:00","211",111,"4","7","wolkig",322
"3/5/2016 12:00","254",148,"5","7","wolkig",402
"3/5/2016 13:00","265",175,"5","6","wolkig",440
"3/5/2016 14:00","193",200,"5","9","wolkig",393
"3/5/2016 15:00","206",181,"6","7","wolkig",387
"3/5/2016 16:00","203",185,"5","7","wolkig",388
"3/5/2016 17:00","207",176,"5","6","wolkig",383
"3/5/2016 18:00","218",208,"4","0","Klarer Himmel",426
"3/5/2016 19:00","150",127,"4","2","",277
"3/5/2016 20:00","148",168,"3","2","",316
"3/5/2016 21:00","140",97,"1","4","",237
"3/5/2016 22:00","114",131,"0","2","Nebel",245
"3/5/2016 23:00","68",114,"0","0","Nebel",182
"3/6/2016 0:00","68",132,"-2","0","Nebel",200
"3/6/2016 1:00","65",95,"-2","4","Nebel",160
"3/6/2016 2:00","35",91,"-2","4","Nebel",126
"3/6/2016 3:00","29",65,"-3","2","Nebel",94
"3/6/2016 4:00","8",32,"-2","0","Nebel",40
"3/6/2016 5:00","7",28,"-3","2","Nebel",35
"3/6/2016 6:00","11",15,"-3","2","Nebel",26
"3/6/2016 7:00","25",10,"-3","4","Nebel",35
"3/6/2016 8:00","39",26,"-1","2","Nebel",65
"3/6/2016 9:00","119",41,"2","2","Nebel",160
"3/6/2016 10:00","143",67,"4","4","",210
"3/6/2016 11:00","176",76,"5","4","teilweise bewölkt",252
"3/6/2016 12:00","180",79,"6","7","teilweise bewölkt",259
"3/6/2016 13:00","216",110,"6","2","teilweise bewölkt",326
"3/6/2016 14:00","141",149,"6","4","teilweise bewölkt",290
"3/6/2016 15:00","159",132,"7","6","teilweise bewölkt",291
"3/6/2016 16:00","151",225,"5","7","wolkig",376
"3/6/2016 17:00","138",159,"3","6","wolkig",297
"3/6/2016 18:00","160",125,"3","7","wolkig",285
"3/6/2016 19:00","159",122,"3","7","wolkig",281
"3/6/2016 20:00","68",131,"1","4","wolkig",199
"3/6/2016 21:00","54",64,"1","6","wolkig",118
"3/6/2016 22:00","43",141,"2","9","wolkig",184
"3/6/2016 23:00","19",53,"2","13","Regen",72
"3/7/2016 0:00","9",31,"2","11","teilweise bewölkt",40
"3/7/2016 1:00","7",14,"1","6","teilweise bewölkt",21
"3/7/2016 2:00","3",8,"1","6","Nebel",11
"3/7/2016 3:00","1",1,"1","7","Nebel",2
"3/7/2016 4:00","8",1,"1","6","wolkig",9
"3/7/2016 5:00","30",19,"1","7","Schnee",49
"3/7/2016 6:00","95",39,"1","6","wolkig",134
"3/7/2016 7:00","409",192,"2","6","wolkig",601
"3/7/2016 8:00","396",240,"2","7","Regen",636
"3/7/2016 9:00","351",166,"2","9","wolkig",517
"3/7/2016 10:00","247",170,"3","6","wolkig",417
"3/7/2016 11:00","223",171,"3","7","wolkig",394
"3/7/2016 12:00","293",212,"3","9","wolkig",505
"3/7/2016 13:00","247",245,"4","7","wolkig",492
"3/7/2016 14:00","272",263,"4","6","wolkig",535
"3/7/2016 15:00","271",313,"5","11","teilweise bewölkt",584
"3/7/2016 16:00","397",307,"5","6","teilweise bewölkt",704
"3/7/2016 17:00","433",441,"5","6","teilweise bewölkt",874
"3/7/2016 18:00","346",403,"2","2","teilweise bewölkt",749
"3/7/2016 19:00","307",275,"0","2","Klarer Himmel",582
"3/7/2016 20:00","161",183,"0","4","Klarer Himmel",344
"3/7/2016 21:00","110",158,"-1","2","Klarer Himmel",268
"3/7/2016 22:00","95",139,"-2","2","Nebel",234
"3/7/2016 23:00","21",118,"-2","2","Nebel",139
"3/8/2016 0:00","22",47,"-3","0","Nebel",69
"3/8/2016 1:00","9",28,"-3","0","Nebel",37
"3/8/2016 2:00","5",13,"-3","2","Nebel",18
"3/8/2016 3:00","4",3,"-4","2","Nebel",7
"3/8/2016 4:00","8",2,"-4","4","Nebel",10
"3/8/2016 5:00","28",19,"-4","0","Nebel",47
"3/8/2016 6:00","115",42,"-4","0","Nebel",157
"3/8/2016 7:00","401",193,"-2","4","teilweise bewölkt",594
"3/8/2016 8:00","407",285,"-1","4","Nebel",692
"3/8/2016 9:00","412",194,"0","7","wolkig",606
"3/8/2016 10:00","243",177,"2","7","Regen",420
"3/8/2016 11:00","249",181,"4","11","wolkig",430
"3/8/2016 12:00","254",243,"5","17","wolkig",497
"3/8/2016 13:00","280",242,"5","15","teilweise bewölkt",522
"3/8/2016 14:00","289",250,"6","19","teilweise bewölkt",539
"3/8/2016 15:00","258",291,"6","20","wolkig",549
"3/8/2016 16:00","380",390,"5","15","wolkig",770
"3/8/2016 17:00","404",442,"5","11","wolkig",846
"3/8/2016 18:00","368",381,"4","11","",749
"3/8/2016 19:00","306",299,"3","9","wolkig",605
"3/8/2016 20:00","175",196,"3","11","wolkig",371
"3/8/2016 21:00","125",171,"3","13","Klarer Himmel",296
"3/8/2016 22:00","91",172,"2","13","Klarer Himmel",263
"3/8/2016 23:00","54",104,"2","11","Klarer Himmel",158
"3/9/2016 0:00","20",54,"1","9","Klarer Himmel",74
"3/9/2016 1:00","8",34,"1","9","Klarer Himmel",42
"3/9/2016 2:00","3",8,"0","11","Klarer Himmel",11
"3/9/2016 3:00","6",9,"0","11","Klarer Himmel",15
"3/9/2016 4:00","5",5,"0","9","Klarer Himmel",10
"3/9/2016 5:00","32",15,"-1","9","Klarer Himmel",47
"3/9/2016 6:00","118",36,"-1","9","Klarer Himmel",154
"3/9/2016 7:00","427",184,"0","7","Klarer Himmel",611
"3/9/2016 8:00","463",295,"1","15","Klarer Himmel",758
"3/9/2016 9:00","408",207,"3","15","Klarer Himmel",615
"3/9/2016 10:00","279",167,"5","24","Klarer Himmel",446
"3/9/2016 11:00","294",198,"6","22","Klarer Himmel",492
"3/9/2016 12:00","314",259,"7","22","Klarer Himmel",573
"3/9/2016 13:00","340",273,"7","24","Klarer Himmel",613
"3/9/2016 14:00","323",294,"7","20","Klarer Himmel",617
"3/9/2016 15:00","346",318,"7","22","Klarer Himmel",664
"3/9/2016 16:00","369",399,"8","15","Klarer Himmel",768
"3/9/2016 17:00","451",445,"7","11","Klarer Himmel",896
"3/9/2016 18:00","414",467,"7","9","Klarer Himmel",881
"3/9/2016 19:00","368",335,"6","7","Klarer Himmel",703
"3/9/2016 20:00","222",210,"5","4","Klarer Himmel",432
"3/9/2016 21:00","123",169,"4","6","Klarer Himmel",292
"3/9/2016 22:00","114",196,"4","6","Klarer Himmel",310
"3/9/2016 23:00","67",112,"3","6","Klarer Himmel",179
"3/10/2016 0:00","66",78,"2","6","Klarer Himmel",144
"3/10/2016 1:00","29",66,"3","7","Klarer Himmel",95
"3/10/2016 2:00","5",28,"3","6","Klarer Himmel",33
"3/10/2016 3:00","14",55,"0","9","Klarer Himmel",69
"3/10/2016 4:00","12",14,"1","9","",26
"3/10/2016 5:00","39",21,"0","9","",60
"3/10/2016 6:00","109",43,"-1","7","",152
"3/10/2016 7:00","439",200,"0","7","",639
"3/10/2016 8:00","439",288,"2","11","",727
"3/10/2016 9:00","388",220,"3","17","",608
"3/10/2016 10:00","262",194,"5","13","Klarer Himmel",456
"3/10/2016 11:00","260",163,"6","13","wolkig",423
"3/10/2016 12:00","315",224,"6","15","wolkig",539
"3/10/2016 13:00","297",275,"7","13","wolkig",572
"3/10/2016 14:00","361",308,"6","15","wolkig",669
"3/10/2016 15:00","317",353,"7","13","wolkig",670
"3/10/2016 16:00","404",375,"7","11","wolkig",779
"3/10/2016 17:00","412",439,"7","7","wolkig",851
"3/10/2016 18:00","398",404,"6","9","wolkig",802
"3/10/2016 19:00","307",290,"5","9","wolkig",597
"3/10/2016 20:00","189",213,"5","6","wolkig",402
"3/10/2016 21:00","124",178,"5","4","wolkig",302
"3/10/2016 22:00","89",166,"6","9","wolkig",255
"3/10/2016 23:00","63",114,"5","11","wolkig",177
"3/11/2016 0:00","33",64,"4","9","wolkig",97
"3/11/2016 1:00","15",23,"2","9","teilweise bewölkt",38
"3/11/2016 2:00","5",12,"1","6","Nebel",17
"3/11/2016 3:00","6",12,"1","7","Nebel",18
"3/11/2016 4:00","9",14,"2","6","wolkig",23
"3/11/2016 5:00","29",15,"3","9","wolkig",44
"3/11/2016 6:00","119",34,"3","9","wolkig",153
"3/11/2016 7:00","405",181,"3","6","wolkig",586
"3/11/2016 8:00","428",280,"4","9","wolkig",708
"3/11/2016 9:00","300",174,"3","15","wolkig",474
"3/11/2016 10:00","238",187,"3","11","wolkig",425
"3/11/2016 11:00","244",162,"4","15","wolkig",406
"3/11/2016 12:00","275",212,"4","13","wolkig",487
"3/11/2016 13:00","307",315,"4","11","wolkig",622
"3/11/2016 14:00","349",293,"4","11","wolkig",642
"3/11/2016 15:00","316",286,"4","11","wolkig",602
"3/11/2016 16:00","308",293,"5","15","wolkig",601
"3/11/2016 17:00","325",336,"4","11","wolkig",661
"3/11/2016 18:00","311",300,"3","9","teilweise bewölkt",611
"3/11/2016 19:00","284",195,"2","6","Klarer Himmel",479
"3/11/2016 20:00","196",203,"2","7","Klarer Himmel",399
"3/11/2016 21:00","127",142,"2","4","teilweise bewölkt",269
"3/11/2016 22:00","132",140,"1","4","Klarer Himmel",272
"3/11/2016 23:00","85",105,"-1","4","Klarer Himmel",190
"3/12/2016 0:00","78",115,"0","4","Klarer Himmel",193
"3/12/2016 1:00","82",90,"-1","6","",172
"3/12/2016 2:00","40",68,"0","6","",108
"3/12/2016 3:00","9",62,"0","4","",71
"3/12/2016 4:00","6",38,"-2","6","",44
"3/12/2016 5:00","24",46,"-2","2","Nebel",70
"3/12/2016 6:00","30",21,"-2","2","Nebel",51
"3/12/2016 7:00","75",17,"-2","4","Nebel",92
"3/12/2016 8:00","118",57,"2","6","wolkig",175
"3/12/2016 9:00","261",66,"4","11","wolkig",327
"3/12/2016 10:00","281",106,"4","6","wolkig",387
"3/12/2016 11:00","281",178,"4","7","wolkig",459
"3/12/2016 12:00","272",173,"5","9","wolkig",445
"3/12/2016 13:00","271",215,"5","11","wolkig",486
"3/12/2016 14:00","221",244,"6","11","wolkig",465
"3/12/2016 15:00","191",234,"6","7","wolkig",425
"3/12/2016 16:00","165",199,"5","13","teilweise bewölkt",364
"3/12/2016 17:00","187",233,"5","11","teilweise bewölkt",420
"3/12/2016 18:00","167",197,"4","9","teilweise bewölkt",364
"3/12/2016 19:00","166",178,"3","7","teilweise bewölkt",344
"3/12/2016 20:00","159",148,"2","7","Klarer Himmel",307
"3/12/2016 21:00","93",95,"1","7","wolkig",188
"3/12/2016 22:00","88",101,"2","7","teilweise bewölkt",189
"3/12/2016 23:00","97",86,"2","9","teilweise bewölkt",183
"3/13/2016 0:00","72",123,"2","6","wolkig",195
"3/13/2016 1:00","57",90,"2","7","wolkig",147
"3/13/2016 2:00","43",72,"3","7","wolkig",115
"3/13/2016 3:00","18",60,"3","6","wolkig",78
"3/13/2016 4:00","5",57,"3","6","wolkig",62
"3/13/2016 5:00","21",22,"3","9","wolkig",43
"3/13/2016 6:00","13",19,"3","9","wolkig",32
"3/13/2016 7:00","25",13,"3","13","wolkig",38
"3/13/2016 8:00","44",33,"4","17","wolkig",77
"3/13/2016 9:00","96",30,"4","13","wolkig",126
"3/13/2016 10:00","155",55,"4","11","wolkig",210
"3/13/2016 11:00","116",71,"4","13","wolkig",187
"3/13/2016 12:00","110",113,"5","13","wolkig",223
"3/13/2016 13:00","181",136,"5","24","teilweise bewölkt",317
"3/13/2016 14:00","225",150,"5","19","wolkig",375
"3/13/2016 15:00","210",170,"5","11","teilweise bewölkt",380
"3/13/2016 16:00","180",173,"6","13","Klarer Himmel",353
"3/13/2016 17:00","182",172,"6","9","Klarer Himmel",354
"3/13/2016 18:00","154",176,"4","6","teilweise bewölkt",330
"3/13/2016 19:00","107",111,"4","15","teilweise bewölkt",218
"3/13/2016 20:00","91",116,"2","15","teilweise bewölkt",207
"3/13/2016 21:00","52",85,"2","11","wolkig",137
"3/13/2016 22:00","52",65,"2","17","wolkig",117
"3/13/2016 23:00","26",48,"1","17","wolkig",74
"3/14/2016 0:00","7",40,"1","7","wolkig",47
"3/14/2016 1:00","4",8,"1","6","wolkig",12
"3/14/2016 2:00","1",2,"0","6","Klarer Himmel",3
"3/14/2016 3:00","4",1,"-1","6","Klarer Himmel",5
"3/14/2016 4:00","9",4,"-1","6","Klarer Himmel",13
"3/14/2016 5:00","29",15,"-1","7","",44
"3/14/2016 6:00","111",41,"-1","7","",152
"3/14/2016 7:00","443",187,"-1","9","",630
"3/14/2016 8:00","433",315,"1","7","Klarer Himmel",748
"3/14/2016 9:00","365",234,"3","11","Klarer Himmel",599
"3/14/2016 10:00","283",223,"4","13","Klarer Himmel",506
"3/14/2016 11:00","261",256,"6","11","Klarer Himmel",517
"3/14/2016 12:00","339",278,"7","15","Klarer Himmel",617
"3/14/2016 13:00","299",258,"8","17","Klarer Himmel",557
"3/14/2016 14:00","348",280,"9","17","Klarer Himmel",628
"3/14/2016 15:00","334",336,"9","20","Klarer Himmel",670
"3/14/2016 16:00","407",436,"9","20","Klarer Himmel",843
"3/14/2016 17:00","482",431,"8","15","Klarer Himmel",913
"3/14/2016 18:00","407",482,"6","13","Klarer Himmel",889
"3/14/2016 19:00","292",338,"5","7","Klarer Himmel",630
"3/14/2016 20:00","176",212,"4","2","Klarer Himmel",388
"3/14/2016 21:00","139",168,"3","0","Klarer Himmel",307
"3/14/2016 22:00","85",142,"1","2","Klarer Himmel",227
"3/14/2016 23:00","46",78,"1","4","Klarer Himmel",124
"3/15/2016 0:00","18",51,"0","2","Klarer Himmel",69
"3/15/2016 1:00","7",30,"1","4","Klarer Himmel",37
"3/15/2016 2:00","7",26,"-1","4","",33
"3/15/2016 3:00","2",7,"-1","2","wolkig",9
"3/15/2016 4:00","11",4,"-1","7","wolkig",15
"3/15/2016 5:00","26",15,"2","4","wolkig",41
"3/15/2016 6:00","125",43,"2","4","Nebel",168
"3/15/2016 7:00","440",210,"2","2","Regen",650
"3/15/2016 8:00","448",312,"4","6","Regen",760
"3/15/2016 9:00","404",254,"4","13","wolkig",658
"3/15/2016 10:00","248",186,"5","11","wolkig",434
"3/15/2016 11:00","257",251,"6","11","wolkig",508
"3/15/2016 12:00","271",349,"6","11","wolkig",620
"3/15/2016 13:00","287",264,"6","11","wolkig",551
"3/15/2016 14:00","322",316,"7","15","wolkig",638
"3/15/2016 15:00","357",310,"8","19","wolkig",667
"3/15/2016 16:00","404",400,"7","13","Regen",804
"3/15/2016 17:00","453",450,"7","15","wolkig",903
"3/15/2016 18:00","389",393,"7","17","teilweise bewölkt",782
"3/15/2016 19:00","351",305,"5","17","teilweise bewölkt",656
"3/15/2016 20:00","175",229,"5","13","teilweise bewölkt",404
"3/15/2016 21:00","127",194,"5","17","Klarer Himmel",321
"3/15/2016 22:00","106",184,"4","11","Klarer Himmel",290
"3/15/2016 23:00","49",123,"3","11","Klarer Himmel",172
"3/16/2016 0:00","27",68,"2","9","Klarer Himmel",95
"3/16/2016 1:00","24",42,"1","7","Klarer Himmel",66
"3/16/2016 2:00","7",20,"2","9","wolkig",27
"3/16/2016 3:00","2",11,"3","11","wolkig",13
"3/16/2016 4:00","9",4,"3","15","wolkig",13
"3/16/2016 5:00","28",15,"3","11","wolkig",43
"3/16/2016 6:00","133",42,"3","17","wolkig",175
"3/16/2016 7:00","429",191,"3","13","wolkig",620
"3/16/2016 8:00","469",362,"4","20","teilweise bewölkt",831
"3/16/2016 9:00","457",248,"5","15","teilweise bewölkt",705
"3/16/2016 10:00","334",195,"6","15","wolkig",529
"3/16/2016 11:00","299",228,"6","19","wolkig",527
"3/16/2016 12:00","336",290,"7","19","wolkig",626
"3/16/2016 13:00","317",278,"7","19","wolkig",595
"3/16/2016 14:00","294",273,"8","19","teilweise bewölkt",567
"3/16/2016 15:00","337",362,"8","22","teilweise bewölkt",699
"3/16/2016 16:00","394",367,"8","17","teilweise bewölkt",761
"3/16/2016 17:00","458",462,"8","15","teilweise bewölkt",920
"3/16/2016 18:00","414",449,"6","9","teilweise bewölkt",863
"3/16/2016 19:00","382",306,"6","6","Klarer Himmel",688
"3/16/2016 20:00","270",223,"6","7","Klarer Himmel",493
"3/16/2016 21:00","147",190,"5","7","Klarer Himmel",337
"3/16/2016 22:00","130",149,"4","7","Klarer Himmel",279
"3/16/2016 23:00","131",180,"3","4","Klarer Himmel",311
"3/17/2016 0:00","55",111,"2","6","Klarer Himmel",166
"3/17/2016 1:00","47",89,"1","2","Klarer Himmel",136
"3/17/2016 2:00","22",56,"2","6","Klarer Himmel",78
"3/17/2016 3:00","6",47,"1","7","Klarer Himmel",53
"3/17/2016 4:00","22",41,"0","4","Klarer Himmel",63
"3/17/2016 5:00","33",19,"0","6","Klarer Himmel",52
"3/17/2016 6:00","107",45,"0","7","Klarer Himmel",152
"3/17/2016 7:00","459",194,"1","6","Klarer Himmel",653
"3/17/2016 8:00","480",300,"4","9","Klarer Himmel",780
"3/17/2016 9:00","397",202,"7","13","Klarer Himmel",599
"3/17/2016 10:00","276",233,"9","15","Klarer Himmel",509
"3/17/2016 11:00","324",219,"10","17","Klarer Himmel",543
"3/17/2016 12:00","333",272,"10","11","Klarer Himmel",605
"3/17/2016 13:00","316",343,"11","15","Klarer Himmel",659
"3/17/2016 14:00","400",346,"11","15","Klarer Himmel",746
"3/17/2016 15:00","391",395,"12","11","Klarer Himmel",786
"3/17/2016 16:00","414",449,"12","11","Klarer Himmel",863
"3/17/2016 17:00","447",484,"11","11","Klarer Himmel",931
"3/17/2016 18:00","409",435,"8","6","Klarer Himmel",844
"3/17/2016 19:00","303",347,"6","2","Klarer Himmel",650
"3/17/2016 20:00","221",239,"3","2","Klarer Himmel",460
"3/17/2016 21:00","136",198,"3","2","Klarer Himmel",334
"3/17/2016 22:00","136",169,"1","6","Klarer Himmel",305
"3/17/2016 23:00","82",148,"2","2","Klarer Himmel",230
"3/18/2016 0:00","30",97,"1","6","",127
"3/18/2016 1:00","24",81,"1","6","",105
"3/18/2016 2:00","14",38,"1","13","Nebel",52
"3/18/2016 3:00","3",20,"1","11","Nebel",23
"3/18/2016 4:00","17",18,"1","7","wolkig",35
"3/18/2016 5:00","33",19,"1","13","wolkig",52
"3/18/2016 6:00","102",41,"1","7","wolkig",143
"3/18/2016 7:00","384",180,"2","11","Regen",564
"3/18/2016 8:00","396",288,"3","11","Regen",684
"3/18/2016 9:00","344",197,"4","13","wolkig",541
"3/18/2016 10:00","260",129,"4","13","Regen",389
"3/18/2016 11:00","264",180,"5","11","wolkig",444
"3/18/2016 12:00","307",272,"5","13","wolkig",579
"3/18/2016 13:00","315",319,"6","13","wolkig",634
"3/18/2016 14:00","286",303,"6","15","wolkig",589
"3/18/2016 15:00","329",281,"6","13","wolkig",610
"3/18/2016 16:00","321",253,"6","15","wolkig",574
"3/18/2016 17:00","306",337,"6","13","wolkig",643
"3/18/2016 18:00","263",304,"5","9","wolkig",567
"3/18/2016 19:00","235",202,"5","11","Regen",437
"3/18/2016 20:00","218",163,"5","9","wolkig",381
"3/18/2016 21:00","126",128,"5","6","wolkig",254
"3/18/2016 22:00","93",152,"5","7","wolkig",245
"3/18/2016 23:00","96",150,"5","7","wolkig",246
"3/19/2016 0:00","65",116,"5","9","wolkig",181
"3/19/2016 1:00","59",74,"5","6","wolkig",133
"3/19/2016 2:00","41",58,"5","7","wolkig",99
"3/19/2016 3:00","16",56,"5","9","wolkig",72
"3/19/2016 4:00","11",32,"5","2","wolkig",43
"3/19/2016 5:00","17",30,"5","6","wolkig",47
"3/19/2016 6:00","27",22,"5","7","wolkig",49
"3/19/2016 7:00","50",22,"5","7","wolkig",72
"3/19/2016 8:00","115",46,"5","9","wolkig",161
"3/19/2016 9:00","242",75,"5","9","wolkig",317
"3/19/2016 10:00","294",88,"5","9","wolkig",382
"3/19/2016 11:00","259",128,"5","9","wolkig",387
"3/19/2016 12:00","271",160,"5","13","wolkig",431
"3/19/2016 13:00","251",162,"5","7","wolkig",413
"3/19/2016 14:00","216",206,"6","7","wolkig",422
"3/19/2016 15:00","196",185,"6","9","wolkig",381
"3/19/2016 16:00","161",193,"7","9","wolkig",354
"3/19/2016 17:00","158",217,"7","7","wolkig",375
"3/19/2016 18:00","188",236,"6","11","wolkig",424
"3/19/2016 19:00","185",168,"6","9","wolkig",353
"3/19/2016 20:00","183",166,"6","11","wolkig",349
"3/19/2016 21:00","158",107,"6","11","wolkig",265
"3/19/2016 22:00","94",88,"5","7","wolkig",182
"3/19/2016 23:00","87",105,"5","7","wolkig",192
"3/20/2016 0:00","94",109,"5","9","wolkig",203
"3/20/2016 1:00","93",103,"5","11","Regen",196
"3/20/2016 2:00","30",68,"5","11","Regen",98
"3/20/2016 3:00","25",45,"4","11","Regen",70
"3/20/2016 4:00","16",56,"4","11","Regen",72
"3/20/2016 5:00","14",35,"4","9","Regen",49
"3/20/2016 6:00","13",27,"4","9","wolkig",40
"3/20/2016 7:00","15",17,"4","13","wolkig",32
"3/20/2016 8:00","31",17,"5","13","wolkig",48
"3/20/2016 9:00","124",40,"6","13","wolkig",164
"3/20/2016 10:00","181",73,"6","15","Regen",254
"3/20/2016 11:00","205",83,"7","20","wolkig",288
"3/20/2016 12:00","138",132,"7","19","Regen",270
"3/20/2016 13:00","231",148,"7","19","wolkig",379
"3/20/2016 14:00","191",138,"7","17","Regen",329
"3/20/2016 15:00","181",167,"7","17","Regen",348
"3/20/2016 16:00","126",147,"7","17","Regen",273
"3/20/2016 17:00","143",168,"7","11","wolkig",311
"3/20/2016 18:00","125",145,"7","13","wolkig",270
"3/20/2016 19:00","103",113,"7","9","wolkig",216
"3/20/2016 20:00","65",116,"7","9","wolkig",181
"3/20/2016 21:00","46",63,"7","9","wolkig",109
"3/20/2016 22:00","41",77,"7","9","wolkig",118
"3/20/2016 23:00","38",67,"6","15","wolkig",105
"3/21/2016 0:00","10",23,"6","13","Regen",33
"3/21/2016 1:00","4",7,"6","13","wolkig",11
"3/21/2016 2:00","3",5,"6","11","Regen",8
"3/21/2016 3:00","1",1,"6","13","wolkig",2
"3/21/2016 4:00","9",5,"6","11","wolkig",14
"3/21/2016 5:00","26",17,"5","9","Regen",43
"3/21/2016 6:00","82",28,"5","7","Regen",110
"3/21/2016 7:00","236",140,"6","15","Regen",376
"3/21/2016 8:00","338",252,"6","13","Regen",590
"3/21/2016 9:00","302",177,"7","19","wolkig",479
"3/21/2016 10:00","221",162,"7","13","wolkig",383
"3/21/2016 11:00","240",172,"9","19","wolkig",412
"3/21/2016 12:00","253",187,"9","19","wolkig",440
"3/21/2016 13:00","263",221,"9","20","wolkig",484
"3/21/2016 14:00","267",197,"8","22","wolkig",464
"3/21/2016 15:00","276",252,"8","24","wolkig",528
"3/21/2016 16:00","295",336,"8","22","wolkig",631
"3/21/2016 17:00","365",391,"8","20","wolkig",756
"3/21/2016 18:00","353",300,"7","9","wolkig",653
"3/21/2016 19:00","192",225,"7","20","Regen",417
"3/21/2016 20:00","143",169,"6","11","wolkig",312
"3/21/2016 21:00","84",133,"6","15","wolkig",217
"3/21/2016 22:00","63",142,"6","17","wolkig",205
"3/21/2016 23:00","53",102,"6","13","wolkig",155
"3/22/2016 0:00","26",51,"6","13","wolkig",77
"3/22/2016 1:00","9",46,"6","15","wolkig",55
"3/22/2016 2:00","2",7,"6","13","Regen",9
"3/22/2016 3:00","9",7,"5","13","wolkig",16
"3/22/2016 4:00","12",4,"5","15","wolkig",16
"3/22/2016 5:00","27",16,"5","13","wolkig",43
"3/22/2016 6:00","90",37,"6","11","Regen",127
"3/22/2016 7:00","256",133,"6","13","Regen",389
"3/22/2016 8:00","360",264,"6","15","wolkig",624
"3/22/2016 9:00","342",197,"7","13","wolkig",539
"3/22/2016 10:00","284",169,"8","15","wolkig",453
"3/22/2016 11:00","282",161,"8","17","Regen",443
"3/22/2016 12:00","270",224,"8","11","Regen",494
"3/22/2016 13:00","239",255,"8","13","Regen",494
"3/22/2016 14:00","310",232,"9","7","Regen",542
"3/22/2016 15:00","302",248,"8","9","Regen",550
"3/22/2016 16:00","330",304,"8","9","Regen",634
"3/22/2016 17:00","341",412,"8","13","Regen",753
"3/22/2016 18:00","276",340,"7","17","Regen",616
"3/22/2016 19:00","252",243,"7","11","Regen",495
"3/22/2016 20:00","174",200,"7","11","Regen",374
"3/22/2016 21:00","130",131,"7","6","Regen",261
"3/22/2016 22:00","91",135,"7","9","Regen",226
"3/22/2016 23:00","57",100,"7","13","Regen",157
"3/23/2016 0:00","48",49,"6","13","Regen",97
"3/23/2016 1:00","12",31,"7","11","wolkig",43
"3/23/2016 2:00","5",25,"6","9","Regen",30
"3/23/2016 3:00","3",23,"6","13","Regen",26
"3/23/2016 4:00","12",8,"6","7","Regen",20
"3/23/2016 5:00","29",14,"6","9","wolkig",43
"3/23/2016 6:00","81",27,"6","11","Regen",108
"3/23/2016 7:00","258",117,"6","11","wolkig",375
"3/23/2016 8:00","370",236,"6","11","Regen",606
"3/23/2016 9:00","382",221,"7","13","wolkig",603
"3/23/2016 10:00","322",160,"7","11","wolkig",482
"3/23/2016 11:00","325",215,"8","20","wolkig",540
"3/23/2016 12:00","274",221,"8","13","teilweise bewölkt",495
"3/23/2016 13:00","261",252,"8","15","wolkig",513
"3/23/2016 14:00","274",231,"9","20","wolkig",505
"3/23/2016 15:00","286",303,"9","13","wolkig",589
"3/23/2016 16:00","323",317,"9","19","wolkig",640
"3/23/2016 17:00","382",403,"8","15","",785
"3/23/2016 18:00","393",349,"8","11","wolkig",742
"3/23/2016 19:00","267",297,"7","7","wolkig",564
"3/23/2016 20:00","225",197,"6","13","wolkig",422
"3/23/2016 21:00","132",130,"5","7","teilweise bewölkt",262
"3/23/2016 22:00","122",144,"5","7","wolkig",266
"3/23/2016 23:00","110",142,"4","6","wolkig",252
"3/24/2016 0:00","55",95,"3","4","wolkig",150
"3/24/2016 1:00","35",86,"3","6","wolkig",121
"3/24/2016 2:00","27",61,"3","6","wolkig",88
"3/24/2016 3:00","17",64,"3","7","wolkig",81
"3/24/2016 4:00","16",34,"2","6","wolkig",50
"3/24/2016 5:00","28",29,"1","2","wolkig",57
"3/24/2016 6:00","78",32,"2","0","wolkig",110
"3/24/2016 7:00","245",132,"4","4","wolkig",377
"3/24/2016 8:00","267",210,"5","6","wolkig",477
"3/24/2016 9:00","276",163,"5","7","wolkig",439
"3/24/2016 10:00","230",150,"6","6","wolkig",380
"3/24/2016 11:00","247",165,"6","9","Regen",412
"3/24/2016 12:00","325",175,"7","9","Regen",500
"3/24/2016 13:00","280",211,"8","15","wolkig",491
"3/24/2016 14:00","320",247,"8","13","wolkig",567
"3/24/2016 15:00","282",259,"8","13","wolkig",541
"3/24/2016 16:00","293",273,"8","9","",566
"3/24/2016 17:00","340",313,"8","7","wolkig",653
"3/24/2016 18:00","307",297,"8","13","wolkig",604
"3/24/2016 19:00","209",207,"8","11","Regen",416
"3/24/2016 20:00","152",142,"8","13","Regen",294
"3/24/2016 21:00","103",112,"7","11","Regen",215
"3/24/2016 22:00","56",88,"7","11","Regen",144
"3/24/2016 23:00","47",83,"6","9","Regen",130
"3/25/2016 0:00","34",60,"6","11","Regen",94
"3/25/2016 1:00","34",64,"6","9","Regen",98
"3/25/2016 2:00","21",43,"6","9","Regen",64
"3/25/2016 3:00","10",23,"6","15","Regen",33
"3/25/2016 4:00","8",10,"6","15","Regen",18
"3/25/2016 5:00","2",6,"6","15","Regen",8
"3/25/2016 6:00","19",9,"6","17","Regen",28
"3/25/2016 7:00","18",10,"6","15","Regen",28
"3/25/2016 8:00","26",10,"7","17","Regen",36
"3/25/2016 9:00","41",28,"7","17","Regen",69
"3/25/2016 10:00","41",30,"7","17","Regen",71
"3/25/2016 11:00","43",24,"7","19","Regen",67
"3/25/2016 12:00","63",38,"8","15","Regen",101
"3/25/2016 13:00","35",43,"8","13","Regen",78
"3/25/2016 14:00","63",35,"8","13","Regen",98
"3/25/2016 15:00","58",34,"8","13","Regen",92
"3/25/2016 16:00","46",56,"8","11","wolkig",102
"3/25/2016 17:00","75",57,"8","9","wolkig",132
"3/25/2016 18:00","88",81,"8","6","wolkig",169
"3/25/2016 19:00","52",51,"7","6","wolkig",103
"3/25/2016 20:00","67",56,"6","9","wolkig",123
"3/25/2016 21:00","35",46,"6","9","wolkig",81
"3/25/2016 22:00","39",41,"7","11","wolkig",80
"3/25/2016 23:00","27",29,"7","17","wolkig",56
"3/26/2016 0:00","28",33,"7","6","wolkig",61
"3/26/2016 1:00","21",32,"6","7","wolkig",53
"3/26/2016 2:00","15",18,"6","2","wolkig",33
"3/26/2016 3:00","2",7,"4","2","Nebel",9
"3/26/2016 4:00","8",6,"3","7","Nebel",14
"3/26/2016 5:00","16",10,"1","6","Nebel",26
"3/26/2016 6:00","24",9,"3","9","Nebel",33
"3/26/2016 7:00","45",12,"5","7","Nebel",57
"3/26/2016 8:00","100",51,"7","13","teilweise bewölkt",151
"3/26/2016 9:00","200",61,"9","13","teilweise bewölkt",261
"3/26/2016 10:00","260",92,"10","19","teilweise bewölkt",352
"3/26/2016 11:00","276",150,"12","20","teilweise bewölkt",426
"3/26/2016 12:00","287",211,"13","24","teilweise bewölkt",498
"3/26/2016 13:00","227",175,"14","19","Klarer Himmel",402
"3/26/2016 14:00","250",231,"14","20","wolkig",481
"3/26/2016 15:00","182",222,"15","22","Klarer Himmel",404
"3/26/2016 16:00","186",173,"15","32","Klarer Himmel",359
"3/26/2016 17:00","141",233,"14","22","Klarer Himmel",374
"3/26/2016 18:00","125",173,"13","17","Klarer Himmel",298
"3/26/2016 19:00","106",142,"12","17","Klarer Himmel",248
"3/26/2016 20:00","104",92,"12","19","Klarer Himmel",196
"3/26/2016 21:00","84",43,"11","19","Klarer Himmel",127
"3/26/2016 22:00","55",62,"10","15","Klarer Himmel",117
"3/26/2016 23:00","58",71,"10","20","Klarer Himmel",129
"3/27/2016 0:00","39",53,"9","13","Klarer Himmel",92
"3/27/2016 1:00","26",70,"9","9","Klarer Himmel",96
"3/27/2016 3:00","0",0,"","","",0
"3/27/2016 3:00","9",51,"9","9","Klarer Himmel",60
"3/27/2016 4:00","19",44,"10","17","Klarer Himmel",63
"3/27/2016 5:00","11",28,"10","15","Klarer Himmel",39
"3/27/2016 6:00","11",21,"10","7","Regen",32
"3/27/2016 7:00","22",15,"9","9","wolkig",37
"3/27/2016 8:00","12",19,"9","28","Regen",31
"3/27/2016 9:00","37",17,"8","19","Regen",54
"3/27/2016 10:00","35",18,"8","24","Regen",53
"3/27/2016 11:00","45",11,"8","19","wolkig",56
"3/27/2016 12:00","46",30,"9","24","wolkig",76
"3/27/2016 13:00","39",44,"10","20","wolkig",83
"3/27/2016 14:00","63",64,"11","32","teilweise bewölkt",127
"3/27/2016 15:00","60",56,"12","28","wolkig",116
"3/27/2016 16:00","82",74,"12","19","Regen",156
"3/27/2016 17:00","63",65,"12","24","wolkig",128
"3/27/2016 18:00","71",53,"12","19","teilweise bewölkt",124
"3/27/2016 19:00","60",94,"11","13","Klarer Himmel",154
"3/27/2016 20:00","61",64,"10","15","Klarer Himmel",125
"3/27/2016 21:00","48",67,"9","19","Klarer Himmel",115
"3/27/2016 22:00","37",38,"9","19","Klarer Himmel",75
"3/27/2016 23:00","32",28,"8","15","teilweise bewölkt",60
"3/28/2016 0:00","28",25,"8","17","Klarer Himmel",53
"3/28/2016 1:00","28",20,"7","13","Klarer Himmel",48
"3/28/2016 2:00","6",22,"8","17","Klarer Himmel",28
"3/28/2016 3:00","8",24,"8","19","Klarer Himmel",32
"3/28/2016 4:00","2",23,"7","19","Klarer Himmel",25
"3/28/2016 5:00","5",12,"8","20","Klarer Himmel",17
"3/28/2016 6:00","8",11,"8","24","Klarer Himmel",19
"3/28/2016 7:00","18",9,"8","20","Klarer Himmel",27
"3/28/2016 8:00","23",11,"9","28","Klarer Himmel",34
"3/28/2016 9:00","43",19,"9","43","Regen",62
"3/28/2016 10:00","41",23,"10","28","Regen",64
"3/28/2016 11:00","65",52,"11","35","wolkig",117
"3/28/2016 12:00","82",45,"12","37","wolkig",127
"3/28/2016 13:00","65",65,"12","37","wolkig",130
"3/28/2016 14:00","69",46,"11","32","Regen",115
"3/28/2016 15:00","34",40,"9","19","wolkig",74
"3/28/2016 16:00","52",61,"10","15","wolkig",113
"3/28/2016 17:00","68",61,"10","24","teilweise bewölkt",129
"3/28/2016 18:00","73",81,"10","19","teilweise bewölkt",154
"3/28/2016 19:00","101",87,"10","19","teilweise bewölkt",188
"3/28/2016 20:00","68",60,"9","15","wolkig",128
"3/28/2016 21:00","40",49,"9","15","teilweise bewölkt",89
"3/28/2016 22:00","34",52,"8","17","teilweise bewölkt",86
"3/28/2016 23:00","29",44,"8","11","wolkig",73
"3/29/2016 0:00","20",22,"8","19","wolkig",42
"3/29/2016 1:00","9",18,"7","26","Regen",27
"3/29/2016 2:00","4",10,"7","15","Regen",14
"3/29/2016 3:00","1",8,"6","22","wolkig",9
"3/29/2016 4:00","11",7,"6","22","wolkig",18
"3/29/2016 5:00","25",18,"6","24","wolkig",43
"3/29/2016 6:00","61",27,"6","24","wolkig",88
"3/29/2016 7:00","202",129,"6","24","Regen",331
"3/29/2016 8:00","292",182,"7","26","wolkig",474
"3/29/2016 9:00","280",157,"7","24","wolkig",437
"3/29/2016 10:00","210",126,"7","28","wolkig",336
"3/29/2016 11:00","239",159,"8","28","Regen",398
"3/29/2016 12:00","210",184,"8","20","wolkig",394
"3/29/2016 13:00","221",184,"9","26","wolkig",405
"3/29/2016 14:00","215",194,"10","28","wolkig",409
"3/29/2016 15:00","232",218,"11","37","wolkig",450
"3/29/2016 16:00","274",239,"9","26","Regen",513
"3/29/2016 17:00","309",330,"10","26","wolkig",639
"3/29/2016 18:00","305",312,"10","26","wolkig",617
"3/29/2016 19:00","247",259,"9","20","teilweise bewölkt",506
"3/29/2016 20:00","139",199,"8","11","teilweise bewölkt",338
"3/29/2016 21:00","93",141,"7","7","teilweise bewölkt",234
"3/29/2016 22:00","85",117,"5","7","Klarer Himmel",202
"3/29/2016 23:00","73",89,"6","9","Klarer Himmel",162
"3/30/2016 0:00","28",55,"6","9","Klarer Himmel",83
"3/30/2016 1:00","12",50,"6","11","Klarer Himmel",62
"3/30/2016 2:00","5",11,"7","15","Regen",16
"3/30/2016 3:00","4",8,"7","17","Regen",12
"3/30/2016 4:00","11",6,"8","17","wolkig",17
"3/30/2016 5:00","35",17,"9","15","wolkig",52
"3/30/2016 6:00","94",30,"9","22","wolkig",124
"3/30/2016 7:00","231",112,"7","24","wolkig",343
"3/30/2016 8:00","373",231,"8","22","wolkig",604
"3/30/2016 9:00","359",197,"8","26","wolkig",556
"3/30/2016 10:00","296",171,"9","28","wolkig",467
"3/30/2016 11:00","327",196,"10","28","wolkig",523
"3/30/2016 12:00","324",244,"11","28","wolkig",568
"3/30/2016 13:00","319",245,"11","32","wolkig",564
"3/30/2016 14:00","300",269,"11","28","wolkig",569
"3/30/2016 15:00","308",293,"12","30","wolkig",601
"3/30/2016 16:00","339",340,"12","32","wolkig",679
"3/30/2016 17:00","366",408,"12","30","wolkig",774
"3/30/2016 18:00","336",426,"11","22","wolkig",762
"3/30/2016 19:00","322",295,"10","20","wolkig",617
"3/30/2016 20:00","243",201,"9","9","wolkig",444
"3/30/2016 21:00","150",163,"8","7","wolkig",313
"3/30/2016 22:00","95",154,"8","6","Klarer Himmel",249
"3/30/2016 23:00","89",143,"7","4","wolkig",232
"3/31/2016 0:00","69",96,"6","2","Klarer Himmel",165
"3/31/2016 1:00","32",59,"5","2","Klarer Himmel",91
"3/31/2016 2:00","14",66,"5","2","Klarer Himmel",80
"3/31/2016 3:00","14",31,"5","2","Klarer Himmel",45
"3/31/2016 4:00","17",48,"5","0","Klarer Himmel",65
"3/31/2016 5:00","37",37,"4","2","Klarer Himmel",74
"3/31/2016 6:00","66",36,"4","2","Klarer Himmel",102
"3/31/2016 7:00","216",148,"4","4","wolkig",364
"3/31/2016 8:00","348",242,"6","2","Klarer Himmel",590
"3/31/2016 9:00","356",209,"7","4","wolkig",565
"3/31/2016 10:00","283",153,"8","4","wolkig",436
"3/31/2016 11:00","294",163,"9","11","wolkig",457
"3/31/2016 12:00","306",209,"10","11","wolkig",515
"3/31/2016 13:00","266",254,"10","19","wolkig",520
"3/31/2016 14:00","307",251,"10","17","wolkig",558
"3/31/2016 15:00","326",293,"11","17","wolkig",619
"3/31/2016 16:00","363",354,"10","17","wolkig",717
"3/31/2016 17:00","322",368,"10","17","wolkig",690
"3/31/2016 18:00","333",373,"9","17","wolkig",706
"3/31/2016 19:00","284",285,"9","15","wolkig",569
"3/31/2016 20:00","190",207,"8","9","wolkig",397
"3/31/2016 21:00","107",158,"8","17","wolkig",265
"3/31/2016 22:00","89",168,"7","17","Klarer Himmel",257
"3/31/2016 23:00","81",118,"7","17","Klarer Himmel",199
"4/1/2016 0:00","31",94,"6","20","Klarer Himmel",125
"4/1/2016 1:00","13",34,"6","19","Klarer Himmel",47
"4/1/2016 2:00","11",9,"6","11","Klarer Himmel",20
"4/1/2016 3:00","11",7,"5","9","Klarer Himmel",18
"4/1/2016 4:00","14",5,"5","13","Klarer Himmel",19
"4/1/2016 5:00","20",20,"3","9","teilweise bewölkt",40
"4/1/2016 6:00","86",23,"2","6","Klarer Himmel",109
"4/1/2016 7:00","269",129,"2","4","Klarer Himmel",398
"4/1/2016 8:00","405",261,"5","9","Klarer Himmel",666
"4/1/2016 9:00","333",230,"6","9","Klarer Himmel",563
"4/1/2016 10:00","259",207,"8","6","Klarer Himmel",466
"4/1/2016 11:00","263",193,"9","6","teilweise bewölkt",456
"4/1/2016 12:00","411",230,"11","7","teilweise bewölkt",641
"4/1/2016 13:00","334",313,"12","9","teilweise bewölkt",647
"4/1/2016 14:00","343",304,"13","9","teilweise bewölkt",647
"4/1/2016 15:00","394",303,"13","9","teilweise bewölkt",697
"4/1/2016 16:00","399",371,"14","6","Klarer Himmel",770
"4/1/2016 17:00","366",394,"13","13","Klarer Himmel",760
"4/1/2016 18:00","321",375,"12","6","Klarer Himmel",696
"4/1/2016 19:00","278",311,"11","4","Klarer Himmel",589
"4/1/2016 20:00","281",215,"10","6","Klarer Himmel",496
"4/1/2016 21:00","183",186,"9","6","Klarer Himmel",369
"4/1/2016 22:00","125",147,"8","6","Klarer Himmel",272
"4/1/2016 23:00","116",122,"8","6","Klarer Himmel",238
"4/2/2016 0:00","86",196,"7","6","Klarer Himmel",282
"4/2/2016 1:00","63",125,"6","4","Klarer Himmel",188
"4/2/2016 2:00","39",66,"6","6","Klarer Himmel",105
"4/2/2016 3:00","29",68,"5","6","Klarer Himmel",97
"4/2/2016 4:00","32",50,"5","6","Klarer Himmel",82
"4/2/2016 5:00","26",46,"5","7","Klarer Himmel",72
"4/2/2016 6:00","24",23,"4","6","Klarer Himmel",47
"4/2/2016 7:00","44",18,"4","6","Klarer Himmel",62
"4/2/2016 8:00","124",64,"6","7","Klarer Himmel",188
"4/2/2016 9:00","239",75,"8","13","Klarer Himmel",314
"4/2/2016 10:00","337",113,"10","9","Klarer Himmel",450
"4/2/2016 11:00","358",180,"11","9","Klarer Himmel",538
"4/2/2016 12:00","404",226,"13","11","Klarer Himmel",630
"4/2/2016 13:00","396",260,"14","11","teilweise bewölkt",656
"4/2/2016 14:00","408",334,"14","13","teilweise bewölkt",742
"4/2/2016 15:00","331",285,"14","13","Klarer Himmel",616
"4/2/2016 16:00","261",300,"15","9","Klarer Himmel",561
"4/2/2016 17:00","246",341,"15","7","Klarer Himmel",587
"4/2/2016 18:00","256",295,"14","4","Klarer Himmel",551
"4/2/2016 19:00","244",271,"14","6","Klarer Himmel",515
"4/2/2016 20:00","207",194,"12","6","Klarer Himmel",401
"4/2/2016 21:00","126",160,"12","6","Klarer Himmel",286
"4/2/2016 22:00","95",135,"13","6","Klarer Himmel",230
"4/2/2016 23:00","86",114,"13","6","Klarer Himmel",200
"4/3/2016 0:00","98",143,"12","7","Klarer Himmel",241
"4/3/2016 1:00","96",136,"12","2","Klarer Himmel",232
"4/3/2016 2:00","50",106,"11","6","Klarer Himmel",156
"4/3/2016 3:00","28",104,"12","6","Regen",132
"4/3/2016 4:00","28",40,"11","4","Klarer Himmel",68
"4/3/2016 5:00","9",30,"11","6","Klarer Himmel",39
"4/3/2016 6:00","20",19,"11","6","Klarer Himmel",39
"4/3/2016 7:00","23",11,"11","4","Klarer Himmel",34
"4/3/2016 8:00","70",21,"12","9","Klarer Himmel",91
"4/3/2016 9:00","78",51,"13","6","Klarer Himmel",129
"4/3/2016 10:00","148",93,"14","9","Klarer Himmel",241
"4/3/2016 11:00","136",94,"15","11","wolkig",230
"4/3/2016 12:00","205",130,"16","7","wolkig",335
"4/3/2016 13:00","203",157,"17","11","Klarer Himmel",360
"4/3/2016 14:00","306",188,"19","13","Klarer Himmel",494
"4/3/2016 15:00","330",232,"20","9","wolkig",562
"4/3/2016 16:00","378",253,"20","19","wolkig",631
"4/3/2016 17:00","294",312,"20","9","wolkig",606
"4/3/2016 18:00","231",317,"20","7","wolkig",548
"4/3/2016 19:00","171",256,"19","2","wolkig",427
"4/3/2016 20:00","99",229,"18","6","wolkig",328
"4/3/2016 21:00","61",127,"18","11","Klarer Himmel",188
"4/3/2016 22:00","51",141,"17","13","Klarer Himmel",192
"4/3/2016 23:00","39",74,"16","11","Regen",113
"4/4/2016 0:00","15",39,"15","11","Regen",54
"4/4/2016 1:00","11",19,"15","11","Regen",30
"4/4/2016 2:00","5",6,"14","7","Regen",11
"4/4/2016 3:00","5",0,"13","9","Klarer Himmel",5
"4/4/2016 4:00","11",4,"14","13","Klarer Himmel",15
"4/4/2016 5:00","35",17,"14","11","Klarer Himmel",52
"4/4/2016 6:00","124",38,"13","15","Klarer Himmel",162
"4/4/2016 7:00","503",223,"14","13","wolkig",726
"4/4/2016 8:00","515",401,"15","13","wolkig",916
"4/4/2016 9:00","375",306,"17","19","teilweise bewölkt",681
"4/4/2016 10:00","341",260,"17","19","teilweise bewölkt",601
"4/4/2016 11:00","382",244,"18","19","wolkig",626
"4/4/2016 12:00","389",333,"19","22","teilweise bewölkt",722
"4/4/2016 13:00","358",364,"18","32","wolkig",722
"4/4/2016 14:00","415",367,"15","32","wolkig",782
"4/4/2016 15:00","386",449,"16","22","wolkig",835
"4/4/2016 16:00","442",439,"16","19","wolkig",881
"4/4/2016 17:00","524",524,"15","19","wolkig",1048
"4/4/2016 18:00","412",490,"15","11","wolkig",902
"4/4/2016 19:00","378",418,"14","7","Klarer Himmel",796
"4/4/2016 20:00","242",284,"11","2","Klarer Himmel",526
"4/4/2016 21:00","170",196,"9","4","Klarer Himmel",366
"4/4/2016 22:00","122",199,"11","6","Klarer Himmel",321
"4/4/2016 23:00","63",123,"11","6","Klarer Himmel",186
"4/5/2016 0:00","33",79,"10","6","teilweise bewölkt",112
"4/5/2016 1:00","9",42,"10","4","teilweise bewölkt",51
"4/5/2016 2:00","16",22,"11","6","Klarer Himmel",38
"4/5/2016 3:00","7",22,"11","4","Klarer Himmel",29
"4/5/2016 4:00","11",12,"12","4","wolkig",23
"4/5/2016 5:00","34",13,"12","6","wolkig",47
"4/5/2016 6:00","120",32,"12","6","wolkig",152
"4/5/2016 7:00","445",209,"11","11","wolkig",654
"4/5/2016 8:00","524",410,"12","11","Regen",934
"4/5/2016 9:00","383",258,"12","11","Regen",641
"4/5/2016 10:00","262",194,"13","9","Regen",456
"4/5/2016 11:00","248",242,"13","11","Regen",490
"4/5/2016 12:00","235",246,"12","9","Regen",481
"4/5/2016 13:00","261",326,"12","9","Regen",587
"4/5/2016 14:00","316",238,"12","17","Regen",554
"4/5/2016 15:00","355",313,"11","17","Regen",668
"4/5/2016 16:00","322",356,"11","15","Regen",678
"4/5/2016 17:00","418",438,"11","11","Regen",856
"4/5/2016 18:00","327",386,"11","11","Regen",713
"4/5/2016 19:00","452",318,"11","6","wolkig",770
"4/5/2016 20:00","249",221,"10","9","teilweise bewölkt",470
"4/5/2016 21:00","140",158,"10","9","",298
"4/5/2016 22:00","111",229,"9","11","",340
"4/5/2016 23:00","55",146,"8","7","",201
"4/6/2016 0:00","35",82,"8","6","",117
"4/6/2016 1:00","19",38,"7","7","",57
"4/6/2016 2:00","5",47,"7","9","Nebel",52
"4/6/2016 3:00","4",10,"7","11","Nebel",14
"4/6/2016 4:00","10",14,"8","13","wolkig",24
"4/6/2016 5:00","33",19,"8","15","wolkig",52
"4/6/2016 6:00","114",35,"8","15","wolkig",149
"4/6/2016 7:00","478",197,"8","15","wolkig",675
"4/6/2016 8:00","447",363,"8","15","wolkig",810
"4/6/2016 9:00","468",251,"8","17","wolkig",719
"4/6/2016 10:00","326",241,"9","19","wolkig",567
"4/6/2016 11:00","318",274,"9","20","wolkig",592
"4/6/2016 12:00","323",312,"11","20","wolkig",635
"4/6/2016 13:00","354",340,"12","30","teilweise bewölkt",694
"4/6/2016 14:00","378",344,"12","30","wolkig",722
"4/6/2016 15:00","403",408,"12","33","wolkig",811
"4/6/2016 16:00","419",398,"12","28","Regen",817
"4/6/2016 17:00","482",524,"12","26","Regen",1006
"4/6/2016 18:00","444",488,"12","26","Regen",932
"4/6/2016 19:00","364",357,"11","20","wolkig",721
"4/6/2016 20:00","271",274,"11","22","Regen",545
"4/6/2016 21:00","170",213,"9","20","Regen",383
"4/6/2016 22:00","141",205,"8","46","Regen",346
"4/6/2016 23:00","123",144,"7","20","Klarer Himmel",267
"4/7/2016 0:00","108",107,"7","17","Regen",215
"4/7/2016 1:00","36",91,"7","15","wolkig",127
"4/7/2016 2:00","15",88,"6","13","teilweise bewölkt",103
"4/7/2016 3:00","3",72,"6","15","teilweise bewölkt",75
"4/7/2016 4:00","20",74,"6","22","teilweise bewölkt",94
"4/7/2016 5:00","36",36,"6","17","Klarer Himmel",72
"4/7/2016 6:00","121",49,"6","15","teilweise bewölkt",170
"4/7/2016 7:00","433",207,"6","13","teilweise bewölkt",640
"4/7/2016 8:00","474",335,"6","20","teilweise bewölkt",809
"4/7/2016 9:00","396",264,"7","22","teilweise bewölkt",660
"4/7/2016 10:00","314",225,"8","26","teilweise bewölkt",539
"4/7/2016 11:00","314",233,"9","30","teilweise bewölkt",547
"4/7/2016 12:00","333",281,"10","30","teilweise bewölkt",614
"4/7/2016 13:00","357",373,"10","28","wolkig",730
"4/7/2016 14:00","410",348,"11","33","teilweise bewölkt",758
"4/7/2016 15:00","392",388,"11","30","teilweise bewölkt",780
"4/7/2016 16:00","435",407,"12","30","teilweise bewölkt",842
"4/7/2016 17:00","518",472,"11","22","teilweise bewölkt",990
"4/7/2016 18:00","509",522,"10","24","teilweise bewölkt",1031
"4/7/2016 19:00","346",420,"8","13","teilweise bewölkt",766
"4/7/2016 20:00","279",269,"8","11","teilweise bewölkt",548
"4/7/2016 21:00","167",183,"7","13","Klarer Himmel",350
"4/7/2016 22:00","119",163,"7","13","Klarer Himmel",282
"4/7/2016 23:00","139",214,"7","15","Klarer Himmel",353
"4/8/2016 0:00","37",105,"6","13","Klarer Himmel",142
"4/8/2016 1:00","38",57,"5","9","Klarer Himmel",95
"4/8/2016 2:00","16",41,"5","7","Klarer Himmel",57
"4/8/2016 3:00","13",19,"3","6","teilweise bewölkt",32
"4/8/2016 4:00","15",16,"3","6","teilweise bewölkt",31
"4/8/2016 5:00","31",21,"4","7","wolkig",52
"4/8/2016 6:00","132",37,"5","13","wolkig",169
"4/8/2016 7:00","467",190,"5","9","wolkig",657
"4/8/2016 8:00","448",318,"6","11","wolkig",766
"4/8/2016 9:00","351",217,"6","11","wolkig",568
"4/8/2016 10:00","310",194,"7","13","wolkig",504
"4/8/2016 11:00","324",200,"8","9","wolkig",524
"4/8/2016 12:00","354",256,"9","13","wolkig",610
"4/8/2016 13:00","340",386,"10","13","wolkig",726
"4/8/2016 14:00","404",355,"11","11","wolkig",759
"4/8/2016 15:00","403",353,"11","13","wolkig",756
"4/8/2016 16:00","392",339,"11","13","wolkig",731
"4/8/2016 17:00","434",402,"11","13","wolkig",836
"4/8/2016 18:00","369",378,"11","7","wolkig",747
"4/8/2016 19:00","380",358,"10","6","wolkig",738
"4/8/2016 20:00","248",269,"7","4","teilweise bewölkt",517
"4/8/2016 21:00","171",230,"7","4","Klarer Himmel",401
"4/8/2016 22:00","135",162,"7","4","Klarer Himmel",297
"4/8/2016 23:00","98",180,"5","2","Klarer Himmel",278
"4/9/2016 0:00","81",141,"4","4","Klarer Himmel",222
"4/9/2016 1:00","84",123,"3","2","Klarer Himmel",207
"4/9/2016 2:00","77",113,"2","2","Nebel",190
"4/9/2016 3:00","33",75,"2","2","Nebel",108
"4/9/2016 4:00","21",59,"1","2","Nebel",80
"4/9/2016 5:00","24",38,"2","6","Nebel",62
"4/9/2016 6:00","43",19,"2","6","Nebel",62
"4/9/2016 7:00","68",35,"3","4","Nebel",103
"4/9/2016 8:00","157",74,"5","4","",231
"4/9/2016 9:00","280",84,"7","7","",364
"4/9/2016 10:00","387",149,"10","11","Klarer Himmel",536
"4/9/2016 11:00","407",201,"12","11","teilweise bewölkt",608
"4/9/2016 12:00","497",241,"13","9","teilweise bewölkt",738
"4/9/2016 13:00","490",336,"13","7","teilweise bewölkt",826
"4/9/2016 14:00","406",340,"14","15","teilweise bewölkt",746
"4/9/2016 15:00","383",363,"15","11","Klarer Himmel",746
"4/9/2016 16:00","349",410,"15","9","Klarer Himmel",759
"4/9/2016 17:00","345",376,"15","9","teilweise bewölkt",721
"4/9/2016 18:00","339",414,"14","13","Klarer Himmel",753
"4/9/2016 19:00","394",359,"13","6","Klarer Himmel",753
"4/9/2016 20:00","259",291,"12","6","Klarer Himmel",550
"4/9/2016 21:00","220",222,"11","6","Klarer Himmel",442
"4/9/2016 22:00","154",199,"11","7","Klarer Himmel",353
"4/9/2016 23:00","110",211,"10","7","Klarer Himmel",321
"4/10/2016 0:00","152",177,"10","7","Klarer Himmel",329
"4/10/2016 1:00","89",158,"10","6","Klarer Himmel",247
"4/10/2016 2:00","59",111,"10","7","Klarer Himmel",170
"4/10/2016 3:00","46",105,"10","6","Klarer Himmel",151
"4/10/2016 4:00","32",68,"10","7","Klarer Himmel",100
"4/10/2016 5:00","17",53,"10","9","Klarer Himmel",70
"4/10/2016 6:00","36",19,"10","7","Klarer Himmel",55
"4/10/2016 7:00","27",20,"9","6","Klarer Himmel",47
"4/10/2016 8:00","59",25,"10","9","Klarer Himmel",84
"4/10/2016 9:00","131",45,"12","11","Klarer Himmel",176
"4/10/2016 10:00","194",87,"13","9","wolkig",281
"4/10/2016 11:00","229",101,"14","9","wolkig",330
"4/10/2016 12:00","314",210,"15","9","wolkig",524
"4/10/2016 13:00","314",254,"16","13","wolkig",568
"4/10/2016 14:00","432",278,"16","9","teilweise bewölkt",710
"4/10/2016 15:00","424",345,"17","11","teilweise bewölkt",769
"4/10/2016 16:00","362",327,"17","15","teilweise bewölkt",689
"4/10/2016 17:00","380",414,"16","11","teilweise bewölkt",794
"4/10/2016 18:00","345",411,"15","7","Klarer Himmel",756
"4/10/2016 19:00","279",361,"15","7","Klarer Himmel",640
"4/10/2016 20:00","173",304,"13","6","Klarer Himmel",477
"4/10/2016 21:00","129",229,"12","7","Klarer Himmel",358
"4/10/2016 22:00","109",150,"11","7","Klarer Himmel",259
"4/10/2016 23:00","33",84,"11","9","Klarer Himmel",117
"4/11/2016 0:00","17",45,"10","11","Klarer Himmel",62
"4/11/2016 1:00","6",15,"9","11","Klarer Himmel",21
"4/11/2016 2:00","1",16,"8","11","Klarer Himmel",17
"4/11/2016 3:00","2",0,"8","13","Klarer Himmel",2
"4/11/2016 4:00","12",6,"8","9","Klarer Himmel",18
"4/11/2016 5:00","32",12,"7","11","Klarer Himmel",44
"4/11/2016 6:00","124",43,"7","11","Klarer Himmel",167
"4/11/2016 7:00","614",269,"7","11","Klarer Himmel",883
"4/11/2016 8:00","659",445,"9","15","Klarer Himmel",1104
"4/11/2016 9:00","536",446,"10","17","Klarer Himmel",982
"4/11/2016 10:00","532",379,"11","19","Klarer Himmel",911
"4/11/2016 11:00","551",514,"12","17","teilweise bewölkt",1065
"4/11/2016 12:00","594",492,"13","13","teilweise bewölkt",1086
"4/11/2016 13:00","669",669,"14","19","Klarer Himmel",1338
"4/11/2016 14:00","617",552,"16","15","Klarer Himmel",1169
"4/11/2016 15:00","734",676,"16","17","Klarer Himmel",1410
"4/11/2016 16:00","816",637,"16","15","Klarer Himmel",1453
"4/11/2016 17:00","886",839,"16","13","Klarer Himmel",1725
"4/11/2016 18:00","756",786,"16","17","Klarer Himmel",1542
"4/11/2016 19:00","589",653,"14","13","Klarer Himmel",1242
"4/11/2016 20:00","416",555,"13","9","Klarer Himmel",971
"4/11/2016 21:00","211",413,"12","9","Klarer Himmel",624
"4/11/2016 22:00","132",310,"11","7","Klarer Himmel",442
"4/11/2016 23:00","98",220,"10","9","Klarer Himmel",318
"4/12/2016 0:00","40",88,"9","7","Klarer Himmel",128
"4/12/2016 1:00","16",77,"9","9","Klarer Himmel",93
"4/12/2016 2:00","7",36,"9","7","Klarer Himmel",43
"4/12/2016 3:00","6",31,"8","7","Klarer Himmel",37
"4/12/2016 4:00","9",16,"8","6","Klarer Himmel",25
"4/12/2016 5:00","32",19,"8","11","",51
"4/12/2016 6:00","143",50,"8","7","",193
"4/12/2016 7:00","640",318,"8","7","Regen",958
"4/12/2016 8:00","700",535,"9","4","",1235
"4/12/2016 9:00","716",535,"10","7","",1251
"4/12/2016 10:00","576",528,"13","4","teilweise bewölkt",1104
"4/12/2016 11:00","616",458,"15","9","Klarer Himmel",1074
"4/12/2016 12:00","589",530,"16","7","teilweise bewölkt",1119
"4/12/2016 13:00","678",633,"18","9","teilweise bewölkt",1311
"4/12/2016 14:00","616",567,"18","6","teilweise bewölkt",1183
"4/12/2016 15:00","730",673,"18","7","Klarer Himmel",1403
"4/12/2016 16:00","731",758,"18","7","Klarer Himmel",1489
"4/12/2016 17:00","877",802,"18","4","Klarer Himmel",1679
"4/12/2016 18:00","716",732,"18","6","Klarer Himmel",1448
"4/12/2016 19:00","637",613,"16","4","Klarer Himmel",1250
"4/12/2016 20:00","542",565,"15","6","Klarer Himmel",1107
"4/12/2016 21:00","244",329,"12","22","",573
"4/12/2016 22:00","163",362,"11","13","Regen",525
"4/12/2016 23:00","175",253,"10","4","wolkig",428
"4/13/2016 0:00","67",124,"10","13","wolkig",191
"4/13/2016 1:00","10",81,"10","9","wolkig",91
"4/13/2016 2:00","12",48,"9","6","wolkig",60
"4/13/2016 3:00","5",73,"8","2","Nebel",78
"4/13/2016 4:00","9",71,"9","7","wolkig",80
"4/13/2016 5:00","31",22,"8","6","wolkig",53
"4/13/2016 6:00","136",42,"8","6","Nebel",178
"4/13/2016 7:00","862",338,"8","7","teilweise bewölkt",1200
"4/13/2016 8:00","723",573,"9","4","wolkig",1296
"4/13/2016 9:00","693",421,"10","4","wolkig",1114
"4/13/2016 10:00","643",581,"11","4","wolkig",1224
"4/13/2016 11:00","582",475,"12","4","wolkig",1057
"4/13/2016 12:00","657",564,"13","6","wolkig",1221
"4/13/2016 13:00","694",595,"13","6","wolkig",1289
"4/13/2016 14:00","609",628,"14","4","wolkig",1237
"4/13/2016 15:00","683",611,"14","6","wolkig",1294
"4/13/2016 16:00","671",700,"14","9","wolkig",1371
"4/13/2016 17:00","804",762,"14","9","wolkig",1566
"4/13/2016 18:00","682",688,"14","7","wolkig",1370
"4/13/2016 19:00","854",619,"13","6","wolkig",1473
"4/13/2016 20:00","540",579,"10","24","Regen",1119
"4/13/2016 21:00","310",460,"9","2","wolkig",770
"4/13/2016 22:00","217",472,"9","6","wolkig",689
"4/13/2016 23:00","257",328,"9","2","wolkig",585
"4/14/2016 0:00","197",192,"8","4","wolkig",389
"4/14/2016 1:00","91",195,"7","2","Nebel",286
"4/14/2016 2:00","73",158,"6","7","Nebel",231
"4/14/2016 3:00","73",166,"6","4","Nebel",239
"4/14/2016 4:00","81",79,"4","4","Nebel",160
"4/14/2016 5:00","58",53,"3","6","Nebel",111
"4/14/2016 6:00","117",44,"4","2","Nebel",161
"4/14/2016 7:00","542",287,"4","2","Nebel",829
"4/14/2016 8:00","672",563,"7","6","",1235
"4/14/2016 9:00","672",402,"10","4","Klarer Himmel",1074
"4/14/2016 10:00","570",407,"13","4","Klarer Himmel",977
"4/14/2016 11:00","610",480,"14","7","teilweise bewölkt",1090
"4/14/2016 12:00","571",505,"14","13","teilweise bewölkt",1076
"4/14/2016 13:00","636",640,"16","13","teilweise bewölkt",1276
"4/14/2016 14:00","562",605,"15","15","Klarer Himmel",1167
"4/14/2016 15:00","805",638,"16","13","teilweise bewölkt",1443
"4/14/2016 16:00","790",633,"15","15","teilweise bewölkt",1423
"4/14/2016 17:00","732",742,"14","11","wolkig",1474
"4/14/2016 18:00","621",691,"14","6","wolkig",1312
"4/14/2016 19:00","541",600,"14","4","Klarer Himmel",1141
"4/14/2016 20:00","451",442,"11","4","Klarer Himmel",893
"4/14/2016 21:00","247",361,"8","4","Klarer Himmel",608
"4/14/2016 22:00","150",250,"7","4","Klarer Himmel",400
"4/14/2016 23:00","172",313,"8","4","Klarer Himmel",485
"4/15/2016 0:00","75",109,"10","2","wolkig",184
"4/15/2016 1:00","30",52,"10","7","Regen",82
"4/15/2016 2:00","5",50,"9","6","Klarer Himmel",55
"4/15/2016 3:00","5",30,"8","11","Klarer Himmel",35
"4/15/2016 4:00","13",21,"8","11","Klarer Himmel",34
"4/15/2016 5:00","28",21,"10","13","Regen",49
"4/15/2016 6:00","96",31,"9","4","Regen",127
"4/15/2016 7:00","385",167,"9","4","Regen",552
"4/15/2016 8:00","440",345,"9","6","Regen",785
"4/15/2016 9:00","456",273,"9","6","wolkig",729
"4/15/2016 10:00","380",408,"10","7","wolkig",788
"4/15/2016 11:00","449",275,"12","15","Regen",724
"4/15/2016 12:00","416",371,"11","17","Regen",787
"4/15/2016 13:00","383",363,"12","20","Regen",746
"4/15/2016 14:00","414",363,"11","32","Regen",777
"4/15/2016 15:00","380",325,"12","24","Regen",705
"4/15/2016 16:00","352",333,"12","19","wolkig",685
"4/15/2016 17:00","415",373,"12","28","Klarer Himmel",788
"4/15/2016 18:00","415",366,"13","17","teilweise bewölkt",781
"4/15/2016 19:00","465",362,"12","9","teilweise bewölkt",827
"4/15/2016 20:00","531",285,"8","6","teilweise bewölkt",816
"4/15/2016 21:00","315",289,"9","2","wolkig",604
"4/15/2016 22:00","185",317,"7","6","Klarer Himmel",502
"4/15/2016 23:00","112",257,"6","4","Klarer Himmel",369
"4/16/2016 0:00","146",177,"6","6","Klarer Himmel",323
"4/16/2016 1:00","88",179,"7","4","teilweise bewölkt",267
"4/16/2016 2:00","38",142,"8","7","teilweise bewölkt",180
"4/16/2016 3:00","33",84,"9","7","wolkig",117
"4/16/2016 4:00","25",59,"9","13","wolkig",84
"4/16/2016 5:00","24",36,"10","17","teilweise bewölkt",60
"4/16/2016 6:00","38",21,"11","17","wolkig",59
"4/16/2016 7:00","105",21,"11","24","wolkig",126
"4/16/2016 8:00","143",69,"10","32","Regen",212
"4/16/2016 9:00","269",104,"11","15","wolkig",373
"4/16/2016 10:00","287",108,"12","37","teilweise bewölkt",395
"4/16/2016 11:00","333",155,"13","28","teilweise bewölkt",488
"4/16/2016 12:00","364",222,"13","28","teilweise bewölkt",586
"4/16/2016 13:00","353",259,"15","26","Regen",612
"4/16/2016 14:00","252",247,"11","35","Regen",499
"4/16/2016 15:00","283",320,"13","32","Regen",603
"4/16/2016 16:00","272",247,"12","22","Regen",519
"4/16/2016 17:00","197",284,"11","19","Regen",481
"4/16/2016 18:00","261",272,"11","22","Regen",533
"4/16/2016 19:00","233",240,"10","19","wolkig",473
"4/16/2016 20:00","298",218,"9","17","wolkig",516
"4/16/2016 21:00","207",178,"8","15","wolkig",385
"4/16/2016 22:00","144",194,"7","9","wolkig",338
"4/16/2016 23:00","79",162,"6","6","wolkig",241
"4/17/2016 0:00","112",124,"6","7","teilweise bewölkt",236
"4/17/2016 1:00","123",115,"5","6","Klarer Himmel",238
"4/17/2016 2:00","54",134,"3","6","Klarer Himmel",188
"4/17/2016 3:00","43",100,"3","6","teilweise bewölkt",143
"4/17/2016 4:00","29",65,"4","6","wolkig",94
"4/17/2016 5:00","20",52,"4","4","wolkig",72
"4/17/2016 6:00","13",18,"5","7","wolkig",31
"4/17/2016 7:00","26",16,"5","7","Regen",42
"4/17/2016 8:00","62",23,"6","13","Regen",85
"4/17/2016 9:00","144",38,"7","13","Regen",182
"4/17/2016 10:00","172",99,"7","13","wolkig",271
"4/17/2016 11:00","203",151,"9","19","teilweise bewölkt",354
"4/17/2016 12:00","248",194,"10","19","teilweise bewölkt",442
"4/17/2016 13:00","273",223,"10","17","teilweise bewölkt",496
"4/17/2016 14:00","351",208,"9","20","Regen",559
"4/17/2016 15:00","351",231,"10","20","teilweise bewölkt",582
"4/17/2016 16:00","354",234,"9","15","Regen",588
"4/17/2016 17:00","338",283,"9","17","Regen",621
"4/17/2016 18:00","349",339,"8","15","teilweise bewölkt",688
"4/17/2016 19:00","253",297,"8","9","teilweise bewölkt",550
"4/17/2016 20:00","155",269,"7","6","teilweise bewölkt",424
"4/17/2016 21:00","113",147,"4","2","Klarer Himmel",260
"4/17/2016 22:00","66",153,"4","2","Klarer Himmel",219
"4/17/2016 23:00","61",78,"3","4","teilweise bewölkt",139
"4/18/2016 0:00","20",50,"3","6","teilweise bewölkt",70
"4/18/2016 1:00","8",20,"2","2","Klarer Himmel",28
"4/18/2016 2:00","5",5,"2","2","Klarer Himmel",10
"4/18/2016 3:00","3",5,"0","2","Klarer Himmel",8
"4/18/2016 4:00","16",5,"0","2","Nebel",21
"4/18/2016 5:00","33",11,"0","4","Nebel",44
"4/18/2016 6:00","123",48,"0","2","Nebel",171
"4/18/2016 7:00","556",268,"2","4","Klarer Himmel",824
"4/18/2016 8:00","751",534,"6","11","Klarer Himmel",1285
"4/18/2016 9:00","593",457,"8","20","Klarer Himmel",1050
"4/18/2016 10:00","564",452,"9","20","teilweise bewölkt",1016
"4/18/2016 11:00","550",478,"11","24","teilweise bewölkt",1028
"4/18/2016 12:00","532",599,"11","28","teilweise bewölkt",1131
"4/18/2016 13:00","637",661,"11","24","wolkig",1298
"4/18/2016 14:00","610",525,"11","22","wolkig",1135
"4/18/2016 15:00","767",639,"12","24","wolkig",1406
"4/18/2016 16:00","660",662,"12","28","wolkig",1322
"4/18/2016 17:00","826",864,"12","30","wolkig",1690
"4/18/2016 18:00","632",678,"11","28","wolkig",1310
"4/18/2016 19:00","599",644,"11","20","wolkig",1243
"4/18/2016 20:00","293",400,"10","20","teilweise bewölkt",693
"4/18/2016 21:00","195",254,"9","17","Klarer Himmel",449
"4/18/2016 22:00","152",300,"9","20","wolkig",452
"4/18/2016 23:00","93",123,"9","17","Klarer Himmel",216
"4/19/2016 0:00","33",71,"9","17","Klarer Himmel",104
"4/19/2016 1:00","15",37,"9","15","wolkig",52
"4/19/2016 2:00","6",7,"8","22","wolkig",13
"4/19/2016 3:00","6",3,"8","15","wolkig",9
"4/19/2016 4:00","10",7,"8","17","wolkig",17
"4/19/2016 5:00","30",9,"8","15","wolkig",39
"4/19/2016 6:00","124",33,"8","17","Klarer Himmel",157
"4/19/2016 7:00","646",315,"8","17","Klarer Himmel",961
"4/19/2016 8:00","885",566,"9","17","wolkig",1451
"4/19/2016 9:00","666",607,"10","22","wolkig",1273
"4/19/2016 10:00","612",588,"11","22","wolkig",1200
"4/19/2016 11:00","625",486,"12","19","teilweise bewölkt",1111
"4/19/2016 12:00","590",560,"13","17","wolkig",1150
"4/19/2016 13:00","651",592,"14","20","wolkig",1243
"4/19/2016 14:00","613",603,"13","19","teilweise bewölkt",1216
"4/19/2016 15:00","741",571,"12","19","teilweise bewölkt",1312
"4/19/2016 16:00","644",869,"13","24","teilweise bewölkt",1513
"4/19/2016 17:00","815",759,"13","26","teilweise bewölkt",1574
"4/19/2016 18:00","743",729,"12","24","teilweise bewölkt",1472
"4/19/2016 19:00","704",552,"10","20","teilweise bewölkt",1256
"4/19/2016 20:00","454",497,"8","17","teilweise bewölkt",951
"4/19/2016 21:00","228",332,"7","13","Klarer Himmel",560
"4/19/2016 22:00","192",400,"7","11","teilweise bewölkt",592
"4/19/2016 23:00","122",199,"6","11","teilweise bewölkt",321
"4/20/2016 0:00","37",84,"5","6","Klarer Himmel",121
"4/20/2016 1:00","23",72,"4","4","Klarer Himmel",95
"4/20/2016 2:00","19",29,"2","6","Klarer Himmel",48
"4/20/2016 3:00","5",39,"2","4","Klarer Himmel",44
"4/20/2016 4:00","14",16,"1","0","teilweise bewölkt",30
"4/20/2016 5:00","46",12,"1","4","Nebel",58
"4/20/2016 6:00","132",42,"1","4","Nebel",174
"4/20/2016 7:00","747",256,"3","2","teilweise bewölkt",1003
"4/20/2016 8:00","821",659,"6","7","teilweise bewölkt",1480
"4/20/2016 9:00","694",458,"8","11","teilweise bewölkt",1152
"4/20/2016 10:00","659",574,"9","9","teilweise bewölkt",1233
"4/20/2016 11:00","603",475,"10","11","teilweise bewölkt",1078
"4/20/2016 12:00","612",558,"10","11","teilweise bewölkt",1170
"4/20/2016 13:00","613",650,"11","9","teilweise bewölkt",1263
"4/20/2016 14:00","699",588,"12","7","Klarer Himmel",1287
"4/20/2016 15:00","741",691,"13","9","Klarer Himmel",1432
"4/20/2016 16:00","711",699,"13","11","Klarer Himmel",1410
"4/20/2016 17:00","753",850,"13","15","Klarer Himmel",1603
"4/20/2016 18:00","679",828,"13","11","Klarer Himmel",1507
"4/20/2016 19:00","713",602,"12","11","Klarer Himmel",1315
"4/20/2016 20:00","497",494,"9","7","Klarer Himmel",991
"4/20/2016 21:00","270",288,"9","13","Klarer Himmel",558
"4/20/2016 22:00","202",365,"8","15","Klarer Himmel",567
"4/20/2016 23:00","178",245,"6","9","Klarer Himmel",423
"4/21/2016 0:00","132",117,"5","7","Klarer Himmel",249
"4/21/2016 1:00","45",113,"4","4","Klarer Himmel",158
"4/21/2016 2:00","12",89,"3","4","Klarer Himmel",101
"4/21/2016 3:00","18",74,"3","2","Klarer Himmel",92
"4/21/2016 4:00","14",89,"2","6","Klarer Himmel",103
"4/21/2016 5:00","48",57,"3","6","Klarer Himmel",105
"4/21/2016 6:00","122",57,"3","2","Klarer Himmel",179
"4/21/2016 7:00","535",298,"5","6","Klarer Himmel",833
"4/21/2016 8:00","683",560,"7","6","Klarer Himmel",1243
"4/21/2016 9:00","617",431,"10","6","Klarer Himmel",1048
"4/21/2016 10:00","613",478,"11","9","Klarer Himmel",1091
"4/21/2016 11:00","627",464,"12","9","Klarer Himmel",1091
"4/21/2016 12:00","564",555,"14","9","Klarer Himmel",1119
"4/21/2016 13:00","699",627,"14","9","Klarer Himmel",1326
"4/21/2016 14:00","677",639,"16","9","Klarer Himmel",1316
"4/21/2016 15:00","804",691,"16","13","Klarer Himmel",1495
"4/21/2016 16:00","795",702,"16","13","Klarer Himmel",1497
"4/21/2016 17:00","831",835,"16","9","Klarer Himmel",1666
"4/21/2016 18:00","735",773,"15","15","Klarer Himmel",1508
"4/21/2016 19:00","565",717,"14","13","Klarer Himmel",1282
"4/21/2016 20:00","333",529,"11","9","Klarer Himmel",862
"4/21/2016 21:00","237",376,"8","7","Klarer Himmel",613
"4/21/2016 22:00","177",300,"9","17","Klarer Himmel",477
"4/21/2016 23:00","168",195,"8","20","Klarer Himmel",363
"4/22/2016 0:00","50",109,"6","11","Klarer Himmel",159
"4/22/2016 1:00","14",64,"4","4","Klarer Himmel",78
"4/22/2016 2:00","17",30,"4","2","Klarer Himmel",47
"4/22/2016 3:00","6",18,"2","9","Klarer Himmel",24
"4/22/2016 4:00","9",10,"2","2","Klarer Himmel",19
"4/22/2016 5:00","43",21,"2","2","Nebel",64
"4/22/2016 6:00","115",34,"2","4","Nebel",149
"4/22/2016 7:00","532",228,"5","6","Klarer Himmel",760
"4/22/2016 8:00","711",475,"7","15","wolkig",1186
"4/22/2016 9:00","620",381,"8","22","wolkig",1001
"4/22/2016 10:00","460",404,"9","13","wolkig",864
"4/22/2016 11:00","540",346,"10","7","wolkig",886
"4/22/2016 12:00","523",462,"11","11","wolkig",985
"4/22/2016 13:00","487",573,"12","11","Klarer Himmel",1060
"4/22/2016 14:00","549",568,"13","4","Klarer Himmel",1117
"4/22/2016 15:00","528",452,"13","15","Klarer Himmel",980
"4/22/2016 16:00","523",476,"13","13","Klarer Himmel",999
"4/22/2016 17:00","521",526,"13","13","Klarer Himmel",1047
"4/22/2016 18:00","494",479,"12","15","Klarer Himmel",973
"4/22/2016 19:00","412",395,"11","15","Klarer Himmel",807
"4/22/2016 20:00","333",306,"10","17","Klarer Himmel",639
"4/22/2016 21:00","176",305,"9","15","Klarer Himmel",481
"4/22/2016 22:00","146",232,"8","15","Klarer Himmel",378
"4/22/2016 23:00","158",184,"7","15","Klarer Himmel",342
"4/23/2016 0:00","136",195,"6","11","Klarer Himmel",331
"4/23/2016 1:00","109",157,"6","7","Klarer Himmel",266
"4/23/2016 2:00","59",127,"5","7","Klarer Himmel",186
"4/23/2016 3:00","52",127,"5","7","Klarer Himmel",179
"4/23/2016 4:00","20",61,"4","7","Klarer Himmel",81
"4/23/2016 5:00","21",46,"4","4","Klarer Himmel",67
"4/23/2016 6:00","34",10,"4","6","Klarer Himmel",44
"4/23/2016 7:00","132",25,"4","11","wolkig",157
"4/23/2016 8:00","149",79,"6","15","wolkig",228
"4/23/2016 9:00","256",89,"6","15","wolkig",345
"4/23/2016 10:00","275",137,"6","13","teilweise bewölkt",412
"4/23/2016 11:00","265",163,"7","15","teilweise bewölkt",428
"4/23/2016 12:00","317",214,"7","20","teilweise bewölkt",531
"4/23/2016 13:00","281",267,"9","17","wolkig",548
"4/23/2016 14:00","307",232,"9","13","teilweise bewölkt",539
"4/23/2016 15:00","241",240,"7","20","teilweise bewölkt",481
"4/23/2016 16:00","224",303,"9","22","teilweise bewölkt",527
"4/23/2016 17:00","214",249,"8","19","teilweise bewölkt",463
"4/23/2016 18:00","215",248,"7","9","teilweise bewölkt",463
"4/23/2016 19:00","228",191,"6","17","Regen",419
"4/23/2016 20:00","208",184,"5","13","teilweise bewölkt",392
"4/23/2016 21:00","163",132,"5","11","teilweise bewölkt",295
"4/23/2016 22:00","123",127,"3","6","teilweise bewölkt",250
"4/23/2016 23:00","94",141,"3","9","teilweise bewölkt",235
"4/24/2016 0:00","96",188,"2","11","teilweise bewölkt",284
"4/24/2016 1:00","55",127,"2","11","Klarer Himmel",182
"4/24/2016 2:00","53",135,"3","13","wolkig",188
"4/24/2016 3:00","38",101,"2","11","teilweise bewölkt",139
"4/24/2016 4:00","34",49,"2","13","teilweise bewölkt",83
"4/24/2016 5:00","13",24,"1","13","teilweise bewölkt",37
"4/24/2016 6:00","22",25,"1","15","teilweise bewölkt",47
"4/24/2016 7:00","26",19,"2","17","teilweise bewölkt",45
"4/24/2016 8:00","53",34,"4","19","teilweise bewölkt",87
"4/24/2016 9:00","127",51,"5","24","teilweise bewölkt",178
"4/24/2016 10:00","176",88,"6","19","teilweise bewölkt",264
"4/24/2016 11:00","127",78,"5","22","teilweise bewölkt",205
"4/24/2016 12:00","125",127,"5","4","teilweise bewölkt",252
"4/24/2016 13:00","174",137,"6","19","teilweise bewölkt",311
"4/24/2016 14:00","188",149,"8","24","teilweise bewölkt",337
"4/24/2016 15:00","167",142,"7","30","teilweise bewölkt",309
"4/24/2016 16:00","188",171,"5","6","teilweise bewölkt",359
"4/24/2016 17:00","201",209,"6","7","teilweise bewölkt",410
"4/24/2016 18:00","159",211,"6","20","wolkig",370
"4/24/2016 19:00","140",193,"6","9","teilweise bewölkt",333
"4/24/2016 20:00","103",176,"4","13","Regen",279
"4/24/2016 21:00","92",134,"4","19","teilweise bewölkt",226
"4/24/2016 22:00","56",116,"1","11","teilweise bewölkt",172
"4/24/2016 23:00","38",97,"1","11","teilweise bewölkt",135
"4/25/2016 0:00","9",35,"1","7","wolkig",44
"4/25/2016 1:00","16",8,"1","9","teilweise bewölkt",24
"4/25/2016 2:00","2",1,"0","9","Klarer Himmel",3
"4/25/2016 3:00","1",4,"1","9","teilweise bewölkt",5
"4/25/2016 4:00","13",3,"0","7","teilweise bewölkt",16
"4/25/2016 5:00","26",15,"1","9","Nebel",41
"4/25/2016 6:00","115",36,"1","13","teilweise bewölkt",151
"4/25/2016 7:00","475",198,"2","11","Klarer Himmel",673
"4/25/2016 8:00","679",463,"4","19","teilweise bewölkt",1142
"4/25/2016 9:00","539",416,"6","19","wolkig",955
"4/25/2016 10:00","506",428,"6","28","wolkig",934
"4/25/2016 11:00","468",407,"7","24","teilweise bewölkt",875
"4/25/2016 12:00","482",492,"9","28","wolkig",974
"4/25/2016 13:00","565",552,"8","32","Regen",1117
"4/25/2016 14:00","469",472,"8","22","wolkig",941
"4/25/2016 15:00","563",575,"7","32","Regen",1138
"4/25/2016 16:00","517",581,"6","22","Regen",1098
"4/25/2016 17:00","617",571,"4","19","Regen",1188
"4/25/2016 18:00","542",498,"4","13","Regen",1040
"4/25/2016 19:00","479",384,"3","17","Regen",863
"4/25/2016 20:00","213",301,"3","7","wolkig",514
"4/25/2016 21:00","125",196,"3","9","wolkig",321
"4/25/2016 22:00","111",163,"4","17","wolkig",274
"4/25/2016 23:00","48",122,"3","13","wolkig",170
"4/26/2016 0:00","28",127,"3","17","wolkig",155
"4/26/2016 1:00","12",108,"2","15","teilweise bewölkt",120
"4/26/2016 2:00","11",63,"2","13","teilweise bewölkt",74
"4/26/2016 3:00","7",49,"1","15","Klarer Himmel",56
"4/26/2016 4:00","11",25,"1","13","Klarer Himmel",36
"4/26/2016 5:00","34",18,"1","13","Klarer Himmel",52
"4/26/2016 6:00","120",44,"1","19","Schnee",164
"4/26/2016 7:00","545",250,"3","22","wolkig",795
"4/26/2016 8:00","787",499,"3","30","Schnee",1286
"4/26/2016 9:00","414",467,"3","28","Regen",881
"4/26/2016 10:00","538",426,"4","30","wolkig",964
"4/26/2016 11:00","443",397,"5","33","Regen",840
"4/26/2016 12:00","463",453,"2","9","Schnee",916
"4/26/2016 13:00","566",506,"6","30","Regen",1072
"4/26/2016 14:00","499",487,"1","13","Schnee",986
"4/26/2016 15:00","518",482,"6","28","teilweise bewölkt",1000
"4/26/2016 16:00","609",680,"7","22","wolkig",1289
"4/26/2016 17:00","697",663,"6","30","wolkig",1360
"4/26/2016 18:00","616",614,"5","22","Regen",1230
"4/26/2016 19:00","578",468,"4","26","Regen",1046
"4/26/2016 20:00","315",367,"4","26","wolkig",682
"4/26/2016 21:00","174",329,"4","22","teilweise bewölkt",503
"4/26/2016 22:00","113",254,"4","32","wolkig",367
"4/26/2016 23:00","76",183,"4","28","Regen",259
"4/27/2016 0:00","37",69,"4","32","wolkig",106
"4/27/2016 1:00","23",31,"3","20","teilweise bewölkt",54
"4/27/2016 2:00","36",11,"3","19","wolkig",47
"4/27/2016 3:00","33",7,"2","13","teilweise bewölkt",40
"4/27/2016 4:00","31",2,"3","11","wolkig",33
"4/27/2016 5:00","35",11,"3","9","wolkig",46
"4/27/2016 6:00","117",30,"3","11","Regen",147
"4/27/2016 7:00","504",161,"3","19","Regen",665
"4/27/2016 8:00","531",420,"4","17","Regen",951
"4/27/2016 9:00","486",326,"3","22","Regen",812
"4/27/2016 10:00","502",431,"5","20","wolkig",933
"4/27/2016 11:00","436",357,"7","20","Regen",793
"4/27/2016 12:00","483",440,"8","24","Regen",923
"4/27/2016 13:00","487",472,"4","30","Regen",959
"4/27/2016 14:00","475",475,"4","9","wolkig",950
"4/27/2016 15:00","487",492,"8","22","Regen",979
"4/27/2016 16:00","491",563,"9","24","wolkig",1054
"4/27/2016 17:00","639",565,"9","20","wolkig",1204
"4/27/2016 18:00","542",535,"5","24","Regen",1077
"4/27/2016 19:00","515",452,"6","7","wolkig",967
"4/27/2016 20:00","341",366,"5","9","wolkig",707
"4/27/2016 21:00","184",219,"5","7","teilweise bewölkt",403
"4/27/2016 22:00","155",271,"4","17","teilweise bewölkt",426
"4/27/2016 23:00","156",209,"4","11","Klarer Himmel",365
"4/28/2016 0:00","94",131,"2","9","Klarer Himmel",225
"4/28/2016 1:00","44",49,"2","11","Klarer Himmel",93
"4/28/2016 2:00","31",41,"2","11","Klarer Himmel",72
"4/28/2016 3:00","20",50,"2","13","Klarer Himmel",70
"4/28/2016 4:00","28",51,"1","11","Klarer Himmel",79
"4/28/2016 5:00","36",47,"2","9","teilweise bewölkt",83
"4/28/2016 6:00","133",32,"1","11","teilweise bewölkt",165
"4/28/2016 7:00","458",221,"2","11","teilweise bewölkt",679
"4/28/2016 8:00","727",510,"5","19","teilweise bewölkt",1237
"4/28/2016 9:00","630",420,"7","17","teilweise bewölkt",1050
"4/28/2016 10:00","554",368,"7","13","teilweise bewölkt",922
"4/28/2016 11:00","542",374,"6","20","Regen",916
"4/28/2016 12:00","482",551,"7","9","wolkig",1033
"4/28/2016 13:00","519",613,"8","22","Regen",1132
"4/28/2016 14:00","499",483,"11","9","teilweise bewölkt",982
"4/28/2016 15:00","676",566,"10","17","teilweise bewölkt",1242
"4/28/2016 16:00","643",587,"10","20","Regen",1230
"4/28/2016 17:00","613",603,"9","13","wolkig",1216
"4/28/2016 18:00","627",620,"7","13","wolkig",1247
"4/28/2016 19:00","481",571,"6","9","wolkig",1052
"4/28/2016 20:00","314",349,"6","13","Klarer Himmel",663
"4/28/2016 21:00","248",216,"5","9","Klarer Himmel",464
"4/28/2016 22:00","244",223,"5","9","Klarer Himmel",467
"4/28/2016 23:00","141",195,"5","9","Klarer Himmel",336
"4/29/2016 0:00","67",112,"4","9","Klarer Himmel",179
"4/29/2016 1:00","23",47,"3","7","",70
"4/29/2016 2:00","18",66,"3","11","",84
"4/29/2016 3:00","9",52,"3","15","Klarer Himmel",61
"4/29/2016 4:00","18",49,"3","15","Klarer Himmel",67
"4/29/2016 5:00","30",20,"4","17","Klarer Himmel",50
"4/29/2016 6:00","117",33,"4","17","Klarer Himmel",150
"4/29/2016 7:00","427",217,"6","20","Klarer Himmel",644
"4/29/2016 8:00","689",419,"8","19","Klarer Himmel",1108
"4/29/2016 9:00","491",342,"10","26","wolkig",833
"4/29/2016 10:00","451",424,"10","33","wolkig",875
"4/29/2016 11:00","453",298,"10","26","wolkig",751
"4/29/2016 12:00","456",469,"11","26","Regen",925
"4/29/2016 13:00","480",453,"11","26","Regen",933
"4/29/2016 14:00","384",433,"8","17","Regen",817
"4/29/2016 15:00","392",328,"8","13","Regen",720
"4/29/2016 16:00","395",316,"9","20","Regen",711
"4/29/2016 17:00","435",379,"9","17","Regen",814
"4/29/2016 18:00","405",367,"8","19","Regen",772
"4/29/2016 19:00","277",284,"7","11","Regen",561
"4/29/2016 20:00","289",217,"7","11","wolkig",506
"4/29/2016 21:00","221",164,"7","17","wolkig",385
"4/29/2016 22:00","131",142,"7","13","Klarer Himmel",273
"4/29/2016 23:00","100",116,"7","9","Klarer Himmel",216
"4/30/2016 0:00","97",169,"6","7","Klarer Himmel",266
"4/30/2016 1:00","52",109,"6","7","Klarer Himmel",161
"4/30/2016 2:00","49",98,"6","7","Klarer Himmel",147
"4/30/2016 3:00","30",114,"7","7","Regen",144
"4/30/2016 4:00","12",68,"6","13","Regen",80
"4/30/2016 5:00","16",39,"5","6","Regen",55
"4/30/2016 6:00","27",29,"5","4","Regen",56
"4/30/2016 7:00","68",22,"5","6","Regen",90
"4/30/2016 8:00","98",49,"6","9","Regen",147
"4/30/2016 9:00","199",70,"7","7","Regen",269
"4/30/2016 10:00","229",100,"8","6","Regen",329
"4/30/2016 11:00","254",129,"8","6","Regen",383
"4/30/2016 12:00","326",184,"9","4","Regen",510
"4/30/2016 13:00","246",199,"8","6","Regen",445
"4/30/2016 14:00","295",263,"10","7","wolkig",558
"4/30/2016 15:00","252",287,"10","6","wolkig",539
"4/30/2016 16:00","191",271,"10","4","wolkig",462
"4/30/2016 17:00","221",301,"11","2","wolkig",522
"4/30/2016 18:00","228",273,"10","7","wolkig",501
"4/30/2016 19:00","306",236,"10","6","wolkig",542
"4/30/2016 20:00","257",250,"9","4","wolkig",507
"4/30/2016 21:00","180",111,"9","17","wolkig",291
"4/30/2016 22:00","131",109,"8","17","Klarer Himmel",240
"4/30/2016 23:00","143",123,"6","15","Klarer Himmel",266
"5/1/2016 0:00","178",135,"6","15","Klarer Himmel",313
"5/1/2016 1:00","129",180,"6","13","wolkig",309
"5/1/2016 2:00","45",160,"6","11","wolkig",205
"5/1/2016 3:00","38",129,"6","13","wolkig",167
"5/1/2016 4:00","25",142,"5","13","wolkig",167
"5/1/2016 5:00","18",53,"5","13","wolkig",71
"5/1/2016 6:00","19",25,"5","9","wolkig",44
"5/1/2016 7:00","40",14,"6","17","wolkig",54
"5/1/2016 8:00","48",24,"7","17","wolkig",72
"5/1/2016 9:00","97",43,"8","17","wolkig",140
"5/1/2016 10:00","235",71,"9","19","wolkig",306
"5/1/2016 11:00","253",159,"11","20","teilweise bewölkt",412
"5/1/2016 12:00","384",195,"12","19","teilweise bewölkt",579
"5/1/2016 13:00","483",220,"13","17","teilweise bewölkt",703
"5/1/2016 14:00","490",251,"13","19","teilweise bewölkt",741
"5/1/2016 15:00","472",333,"14","19","teilweise bewölkt",805
"5/1/2016 16:00","394",340,"14","17","teilweise bewölkt",734
"5/1/2016 17:00","311",411,"14","19","Klarer Himmel",722
"5/1/2016 18:00","253",355,"14","15","Klarer Himmel",608
"5/1/2016 19:00","230",371,"13","15","Klarer Himmel",601
"5/1/2016 20:00","173",306,"11","11","Klarer Himmel",479
"5/1/2016 21:00","123",251,"9","6","Klarer Himmel",374
"5/1/2016 22:00","67",196,"7","4","Klarer Himmel",263
"5/1/2016 23:00","47",92,"7","2","Klarer Himmel",139
"5/2/2016 0:00","36",58,"6","2","Klarer Himmel",94
"5/2/2016 1:00","8",16,"5","2","Klarer Himmel",24
"5/2/2016 2:00","6",10,"4","0","Klarer Himmel",16
"5/2/2016 3:00","3",1,"3","2","Klarer Himmel",4
"5/2/2016 4:00","4",8,"3","2","Klarer Himmel",12
"5/2/2016 5:00","38",13,"2","2","Nebel",51
"5/2/2016 6:00","129",43,"3","2","Nebel",172
"5/2/2016 7:00","551",256,"6","0","Klarer Himmel",807
"5/2/2016 8:00","688",452,"9","6","Klarer Himmel",1140
"5/2/2016 9:00","493",400,"12","4","Klarer Himmel",893
"5/2/2016 10:00","589",448,"14","2","",1037
"5/2/2016 11:00","522",420,"16","7","teilweise bewölkt",942
"5/2/2016 12:00","556",546,"18","11","teilweise bewölkt",1102
"5/2/2016 13:00","548",563,"18","9","Klarer Himmel",1111
"5/2/2016 14:00","604",405,"19","9","Klarer Himmel",1009
"5/2/2016 15:00","737",676,"19","6","Klarer Himmel",1413
"5/2/2016 16:00","773",677,"19","9","Klarer Himmel",1450
"5/2/2016 17:00","853",905,"19","11","Klarer Himmel",1758
"5/2/2016 18:00","639",824,"19","7","Klarer Himmel",1463
"5/2/2016 19:00","571",689,"17","7","Klarer Himmel",1260
"5/2/2016 20:00","370",472,"15","7","Klarer Himmel",842
"5/2/2016 21:00","250",354,"13","4","Klarer Himmel",604
"5/2/2016 22:00","170",248,"12","6","Klarer Himmel",418
"5/2/2016 23:00","106",149,"11","2","Klarer Himmel",255
"5/3/2016 0:00","25",78,"13","7","Klarer Himmel",103
"5/3/2016 1:00","19",32,"13","9","Klarer Himmel",51
"5/3/2016 2:00","7",9,"12","9","Klarer Himmel",16
"5/3/2016 3:00","5",3,"12","7","wolkig",8
"5/3/2016 4:00","5",3,"12","7","wolkig",8
"5/3/2016 5:00","30",7,"12","7","wolkig",37
"5/3/2016 6:00","119",39,"9","17","Regen",158
"5/3/2016 7:00","349",191,"8","11","Regen",540
"5/3/2016 8:00","685",450,"9","11","wolkig",1135
"5/3/2016 9:00","553",489,"9","20","wolkig",1042
"5/3/2016 10:00","566",465,"11","17","teilweise bewölkt",1031
"5/3/2016 11:00","534",412,"13","19","teilweise bewölkt",946
"5/3/2016 12:00","581",536,"12","26","Regen",1117
"5/3/2016 13:00","544",532,"14","17","teilweise bewölkt",1076
"5/3/2016 14:00","548",535,"14","24","teilweise bewölkt",1083
"5/3/2016 15:00","596",590,"14","26","teilweise bewölkt",1186
"5/3/2016 16:00","666",669,"14","24","teilweise bewölkt",1335
"5/3/2016 17:00","780",791,"14","20","Klarer Himmel",1571
"5/3/2016 18:00","730",656,"14","22","Klarer Himmel",1386
"5/3/2016 19:00","678",568,"12","26","Klarer Himmel",1246
"5/3/2016 20:00","454",520,"11","13","Klarer Himmel",974
"5/3/2016 21:00","225",324,"10","11","Klarer Himmel",549
"5/3/2016 22:00","192",354,"8","9","Klarer Himmel",546
"5/3/2016 23:00","126",243,"6","4","Klarer Himmel",369
"5/4/2016 0:00","39",98,"5","4","Klarer Himmel",137
"5/4/2016 1:00","12",43,"4","2","Klarer Himmel",55
"5/4/2016 2:00","10",11,"3","0","Klarer Himmel",21
"5/4/2016 3:00","0",9,"2","2","Klarer Himmel",9
"5/4/2016 4:00","9",2,"2","4","Nebel",11
"5/4/2016 5:00","39",11,"1","0","Nebel",50
"5/4/2016 6:00","151",37,"1","0","Nebel",188
"5/4/2016 7:00","660",285,"5","2","Klarer Himmel",945
"5/4/2016 8:00","758",600,"9","2","teilweise bewölkt",1358
"5/4/2016 9:00","636",445,"10","9","teilweise bewölkt",1081
"5/4/2016 10:00","657",512,"10","6","teilweise bewölkt",1169
"5/4/2016 11:00","599",422,"12","11","teilweise bewölkt",1021
"5/4/2016 12:00","654",555,"12","6","teilweise bewölkt",1209
"5/4/2016 13:00","609",558,"13","9","teilweise bewölkt",1167
"5/4/2016 14:00","578",638,"13","11","Klarer Himmel",1216
"5/4/2016 15:00","621",628,"15","6","Klarer Himmel",1249
"5/4/2016 16:00","657",687,"15","6","Klarer Himmel",1344
"5/4/2016 17:00","722",743,"15","9","Klarer Himmel",1465
"5/4/2016 18:00","630",651,"15","6","Klarer Himmel",1281
"5/4/2016 19:00","646",578,"14","7","Klarer Himmel",1224
"5/4/2016 20:00","417",479,"12","4","Klarer Himmel",896
"5/4/2016 21:00","280",408,"10","4","Klarer Himmel",688
"5/4/2016 22:00","220",347,"7","4","Klarer Himmel",567
"5/4/2016 23:00","179",280,"8","4","Klarer Himmel",459
"5/5/2016 0:00","283",235,"7","4","Klarer Himmel",518
"5/5/2016 1:00","189",214,"6","6","Klarer Himmel",403
"5/5/2016 2:00","91",151,"4","4","Klarer Himmel",242
"5/5/2016 3:00","90",136,"5","6","Klarer Himmel",226
"5/5/2016 4:00","71",96,"4","4","Klarer Himmel",167
"5/5/2016 5:00","36",59,"3","4","Klarer Himmel",95
"5/5/2016 6:00","34",22,"7","7","Klarer Himmel",56
"5/5/2016 7:00","77",18,"9","7","Klarer Himmel",95
"5/5/2016 8:00","114",46,"11","9","Klarer Himmel",160
"5/5/2016 9:00","192",84,"13","9","Klarer Himmel",276
"5/5/2016 10:00","246",132,"14","17","Klarer Himmel",378
"5/5/2016 11:00","215",202,"16","17","Klarer Himmel",417
"5/5/2016 12:00","350",260,"17","11","Klarer Himmel",610
"5/5/2016 13:00","350",257,"18","11","Klarer Himmel",607
"5/5/2016 14:00","498",298,"18","13","Klarer Himmel",796
"5/5/2016 15:00","423",299,"18","19","Klarer Himmel",722
"5/5/2016 16:00","417",331,"19","13","Klarer Himmel",748
"5/5/2016 17:00","368",424,"19","15","Klarer Himmel",792
"5/5/2016 18:00","363",399,"19","13","Klarer Himmel",762
"5/5/2016 19:00","238",397,"18","7","Klarer Himmel",635
"5/5/2016 20:00","175",332,"17","6","Klarer Himmel",507
"5/5/2016 21:00","158",206,"15","7","Klarer Himmel",364
"5/5/2016 22:00","113",203,"14","6","Klarer Himmel",316
"5/5/2016 23:00","76",152,"13","7","Klarer Himmel",228
"5/6/2016 0:00","43",112,"13","7","Klarer Himmel",155
"5/6/2016 1:00","23",57,"13","7","Klarer Himmel",80
"5/6/2016 2:00","8",23,"12","7","Klarer Himmel",31
"5/6/2016 3:00","6",10,"12","7","Klarer Himmel",16
"5/6/2016 4:00","10",13,"11","7","Klarer Himmel",23
"5/6/2016 5:00","26",11,"11","7","Klarer Himmel",37
"5/6/2016 6:00","89",30,"12","7","Klarer Himmel",119
"5/6/2016 7:00","304",133,"13","9","Klarer Himmel",437
"5/6/2016 8:00","495",319,"15","11","Klarer Himmel",814
"5/6/2016 9:00","483",237,"17","17","Klarer Himmel",720
"5/6/2016 10:00","505",375,"18","17","Klarer Himmel",880
"5/6/2016 11:00","543",350,"20","13","Klarer Himmel",893
"5/6/2016 12:00","521",424,"21","19","Klarer Himmel",945
"5/6/2016 13:00","534",493,"23","20","Klarer Himmel",1027
"5/6/2016 14:00","482",505,"23","19","Klarer Himmel",987
"5/6/2016 15:00","522",481,"24","19","Klarer Himmel",1003
"5/6/2016 16:00","528",478,"25","17","Klarer Himmel",1006
"5/6/2016 17:00","525",573,"25","19","Klarer Himmel",1098
"5/6/2016 18:00","508",499,"24","17","Klarer Himmel",1007
"5/6/2016 19:00","519",463,"24","13","Klarer Himmel",982
"5/6/2016 20:00","305",364,"22","7","Klarer Himmel",669
"5/6/2016 21:00","199",274,"19","6","Klarer Himmel",473
"5/6/2016 22:00","143",330,"18","6","Klarer Himmel",473
"5/6/2016 23:00","106",213,"17","6","Klarer Himmel",319
"5/7/2016 0:00","90",254,"16","7","Klarer Himmel",344
"5/7/2016 1:00","73",167,"16","6","Klarer Himmel",240
"5/7/2016 2:00","51",94,"15","6","Klarer Himmel",145
"5/7/2016 3:00","30",97,"14","6","Klarer Himmel",127
"5/7/2016 4:00","22",45,"14","7","Klarer Himmel",67
"5/7/2016 5:00","25",28,"13","7","Klarer Himmel",53
"5/7/2016 6:00","41",21,"14","9","Klarer Himmel",62
"5/7/2016 7:00","119",26,"16","9","Klarer Himmel",145
"5/7/2016 8:00","194",80,"18","11","Klarer Himmel",274
"5/7/2016 9:00","308",133,"20","9","Klarer Himmel",441
"5/7/2016 10:00","425",202,"22","11","Klarer Himmel",627
"5/7/2016 11:00","465",216,"23","17","Klarer Himmel",681
"5/7/2016 12:00","503",289,"24","17","Klarer Himmel",792
"5/7/2016 13:00","410",334,"25","19","Klarer Himmel",744
"5/7/2016 14:00","385",365,"25","17","Klarer Himmel",750
"5/7/2016 15:00","414",437,"25","17","Klarer Himmel",851
"5/7/2016 16:00","298",427,"25","22","Klarer Himmel",725
"5/7/2016 17:00","356",420,"25","17","Klarer Himmel",776
"5/7/2016 18:00","356",402,"25","15","Klarer Himmel",758
"5/7/2016 19:00","359",354,"24","11","Klarer Himmel",713
"5/7/2016 20:00","256",368,"22","7","Klarer Himmel",624
"5/7/2016 21:00","202",267,"20","9","Klarer Himmel",469
"5/7/2016 22:00","193",222,"20","9","Klarer Himmel",415
"5/7/2016 23:00","213",215,"18","7","Klarer Himmel",428
"5/8/2016 0:00","126",169,"18","11","Klarer Himmel",295
"5/8/2016 1:00","82",128,"17","9","Klarer Himmel",210
"5/8/2016 2:00","26",127,"16","7","Klarer Himmel",153
"5/8/2016 3:00","13",78,"16","9","Klarer Himmel",91
"5/8/2016 4:00","15",34,"15","9","Klarer Himmel",49
"5/8/2016 5:00","18",28,"15","13","Klarer Himmel",46
"5/8/2016 6:00","22",20,"16","11","Klarer Himmel",42
"5/8/2016 7:00","29",19,"17","11","Klarer Himmel",48
"5/8/2016 8:00","35",38,"18","15","Klarer Himmel",73
"5/8/2016 9:00","175",56,"20","15","Klarer Himmel",231
"5/8/2016 10:00","258",147,"22","17","Klarer Himmel",405
"5/8/2016 11:00","215",141,"23","20","Klarer Himmel",356
"5/8/2016 12:00","383",197,"23","20","Klarer Himmel",580
"5/8/2016 13:00","378",246,"23","19","Klarer Himmel",624
"5/8/2016 14:00","349",280,"24","19","Klarer Himmel",629
"5/8/2016 15:00","385",310,"25","19","Klarer Himmel",695
"5/8/2016 16:00","328",397,"25","19","Klarer Himmel",725
"5/8/2016 17:00","312",374,"24","19","Klarer Himmel",686
"5/8/2016 18:00","252",346,"24","17","Klarer Himmel",598
"5/8/2016 19:00","216",331,"23","17","Klarer Himmel",547
"5/8/2016 20:00","215",269,"21","11","Klarer Himmel",484
"5/8/2016 21:00","110",197,"20","9","Klarer Himmel",307
"5/8/2016 22:00","94",236,"19","9","Klarer Himmel",330
"5/8/2016 23:00","47",120,"18","9","Klarer Himmel",167
"5/9/2016 0:00","27",36,"18","13","Klarer Himmel",63
"5/9/2016 1:00","12",18,"17","11","Klarer Himmel",30
"5/9/2016 2:00","2",10,"17","11","Klarer Himmel",12
"5/9/2016 3:00","0",1,"16","11","Klarer Himmel",1
"5/9/2016 4:00","5",4,"16","9","Klarer Himmel",9
"5/9/2016 5:00","29",14,"16","11","Klarer Himmel",43
"5/9/2016 6:00","134",43,"16","9","Klarer Himmel",177
"5/9/2016 7:00","559",265,"18","11","Klarer Himmel",824
"5/9/2016 8:00","703",552,"19","15","Klarer Himmel",1255
"5/9/2016 9:00","540",395,"19","13","Klarer Himmel",935
"5/9/2016 10:00","558",474,"21","13","Klarer Himmel",1032
"5/9/2016 11:00","484",492,"22","19","Klarer Himmel",976
"5/9/2016 12:00","571",597,"22","17","Klarer Himmel",1168
"5/9/2016 13:00","517",541,"23","17","Klarer Himmel",1058
"5/9/2016 14:00","586",600,"24","17","Klarer Himmel",1186
"5/9/2016 15:00","691",779,"25","20","Klarer Himmel",1470
"5/9/2016 16:00","673",727,"25","22","Klarer Himmel",1400
"5/9/2016 17:00","857",888,"25","20","Klarer Himmel",1745
"5/9/2016 18:00","815",848,"24","17","Klarer Himmel",1663
"5/9/2016 19:00","650",589,"23","11","Klarer Himmel",1239
"5/9/2016 20:00","436",500,"21","7","Klarer Himmel",936
"5/9/2016 21:00","245",392,"20","7","Klarer Himmel",637
"5/9/2016 22:00","159",365,"19","7","Klarer Himmel",524
"5/9/2016 23:00","110",203,"18","9","Klarer Himmel",313
"5/10/2016 0:00","61",76,"18","7","Klarer Himmel",137
"5/10/2016 1:00","15",31,"17","9","Klarer Himmel",46
"5/10/2016 2:00","7",16,"17","9","Klarer Himmel",23
"5/10/2016 3:00","7",7,"16","7","Klarer Himmel",14
"5/10/2016 4:00","12",2,"16","7","Klarer Himmel",14
"5/10/2016 5:00","31",21,"16","9","wolkig",52
"5/10/2016 6:00","145",56,"16","9","Klarer Himmel",201
"5/10/2016 7:00","623",317,"17","9","Klarer Himmel",940
"5/10/2016 8:00","824",618,"19","13","Klarer Himmel",1442
"5/10/2016 9:00","659",631,"21","11","Klarer Himmel",1290
"5/10/2016 10:00","656",548,"22","13","Klarer Himmel",1204
"5/10/2016 11:00","556",466,"23","20","Klarer Himmel",1022
"5/10/2016 12:00","599",641,"24","20","Klarer Himmel",1240
"5/10/2016 13:00","583",602,"24","13","Klarer Himmel",1185
"5/10/2016 14:00","629",672,"24","13","Klarer Himmel",1301
"5/10/2016 15:00","686",712,"24","15","Klarer Himmel",1398
"5/10/2016 16:00","782",731,"24","13","Klarer Himmel",1513
"5/10/2016 17:00","1014",831,"24","9","Klarer Himmel",1845
"5/10/2016 18:00","760",855,"23","9","Klarer Himmel",1615
"5/10/2016 19:00","716",716,"22","7","Klarer Himmel",1432
"5/10/2016 20:00","426",488,"21","7","Klarer Himmel",914
"5/10/2016 21:00","280",392,"21","9","Klarer Himmel",672
"5/10/2016 22:00","219",381,"20","9","Klarer Himmel",600
"5/10/2016 23:00","116",249,"19","6","Klarer Himmel",365
"5/11/2016 0:00","56",132,"19","6","Klarer Himmel",188
"5/11/2016 1:00","18",91,"18","4","Klarer Himmel",109
"5/11/2016 2:00","12",34,"18","4","Klarer Himmel",46
"5/11/2016 3:00","9",10,"17","4","Klarer Himmel",19
"5/11/2016 4:00","14",13,"17","6","Klarer Himmel",27
"5/11/2016 5:00","39",15,"16","6","Klarer Himmel",54
"5/11/2016 6:00","152",62,"16","6","Klarer Himmel",214
"5/11/2016 7:00","736",284,"18","7","Klarer Himmel",1020
"5/11/2016 8:00","737",676,"19","7","Klarer Himmel",1413
"5/11/2016 9:00","661",492,"19","7","Klarer Himmel",1153
"5/11/2016 10:00","646",599,"22","9","",1245
"5/11/2016 11:00","638",497,"23","11","teilweise bewölkt",1135
"5/11/2016 12:00","683",584,"23","17","Klarer Himmel",1267
"5/11/2016 13:00","612",607,"24","15","Klarer Himmel",1219
"5/11/2016 14:00","597",638,"25","17","Klarer Himmel",1235
"5/11/2016 15:00","627",673,"26","15","Klarer Himmel",1300
"5/11/2016 16:00","758",739,"25","19","Klarer Himmel",1497
"5/11/2016 17:00","827",757,"25","20","Klarer Himmel",1584
"5/11/2016 18:00","796",749,"24","17","Klarer Himmel",1545
"5/11/2016 19:00","711",647,"22","13","Klarer Himmel",1358
"5/11/2016 20:00","446",504,"21","13","Klarer Himmel",950
"5/11/2016 21:00","289",430,"20","11","Klarer Himmel",719
"5/11/2016 22:00","263",445,"19","7","Klarer Himmel",708
"5/11/2016 23:00","177",287,"18","9","Klarer Himmel",464
"5/12/2016 0:00","164",182,"17","7","Klarer Himmel",346
"5/12/2016 1:00","50",151,"16","7","Klarer Himmel",201
"5/12/2016 2:00","30",81,"15","11","Klarer Himmel",111
"5/12/2016 3:00","33",65,"15","9","Klarer Himmel",98
"5/12/2016 4:00","20",39,"15","9","Klarer Himmel",59
"5/12/2016 5:00","37",36,"14","13","Klarer Himmel",73
"5/12/2016 6:00","156",55,"15","15","Klarer Himmel",211
"5/12/2016 7:00","573",305,"16","13","Klarer Himmel",878
"5/12/2016 8:00","646",638,"18","15","Klarer Himmel",1284
"5/12/2016 9:00","602",453,"20","19","Klarer Himmel",1055
"5/12/2016 10:00","569",543,"21","19","Klarer Himmel",1112
"5/12/2016 11:00","601",491,"22","19","Klarer Himmel",1092
"5/12/2016 12:00","585",580,"24","17","Klarer Himmel",1165
"5/12/2016 13:00","582",658,"24","22","Klarer Himmel",1240
"5/12/2016 14:00","673",641,"24","20","Klarer Himmel",1314
"5/12/2016 15:00","727",641,"24","19","Klarer Himmel",1368
"5/12/2016 16:00","757",675,"25","15","Klarer Himmel",1432
"5/12/2016 17:00","756",775,"23","17","Klarer Himmel",1531
"5/12/2016 18:00","682",734,"24","17","Klarer Himmel",1416
"5/12/2016 19:00","586",574,"23","15","Klarer Himmel",1160
"5/12/2016 20:00","407",482,"21","7","Klarer Himmel",889
"5/12/2016 21:00","294",340,"19","11","Klarer Himmel",634
"5/12/2016 22:00","194",294,"19","19","Klarer Himmel",488
"5/12/2016 23:00","259",289,"18","17","Klarer Himmel",548
"5/13/2016 0:00","168",128,"17","11","Klarer Himmel",296
"5/13/2016 1:00","58",113,"16","11","Klarer Himmel",171
"5/13/2016 2:00","18",100,"15","15","Klarer Himmel",118
"5/13/2016 3:00","4",89,"14","17","Klarer Himmel",93
"5/13/2016 4:00","19",51,"13","13","Klarer Himmel",70
"5/13/2016 5:00","32",36,"11","11","Klarer Himmel",68
"5/13/2016 6:00","113",55,"12","11","Klarer Himmel",168
"5/13/2016 7:00","483",241,"13","17","Klarer Himmel",724
"5/13/2016 8:00","662",432,"15","15","Klarer Himmel",1094
"5/13/2016 9:00","462",383,"17","9","Klarer Himmel",845
"5/13/2016 10:00","442",399,"19","13","Klarer Himmel",841
"5/13/2016 11:00","513",386,"20","24","Klarer Himmel",899
"5/13/2016 12:00","539",419,"22","17","Klarer Himmel",958
"5/13/2016 13:00","534",526,"22","22","Klarer Himmel",1060
"5/13/2016 14:00","492",548,"22","24","Klarer Himmel",1040
"5/13/2016 15:00","539",499,"23","22","Klarer Himmel",1038
"5/13/2016 16:00","496",450,"21","24","Klarer Himmel",946
"5/13/2016 17:00","519",491,"22","24","Klarer Himmel",1010
"5/13/2016 18:00","491",421,"21","26","Klarer Himmel",912
"5/13/2016 19:00","453",388,"19","24","Klarer Himmel",841
"5/13/2016 20:00","336",329,"16","20","Klarer Himmel",665
"5/13/2016 21:00","240",298,"13","22","Klarer Himmel",538
"5/13/2016 22:00","160",212,"11","24","Klarer Himmel",372
"5/13/2016 23:00","154",174,"9","20","Klarer Himmel",328
"5/14/2016 0:00","86",160,"9","19","wolkig",246
"5/14/2016 1:00","76",164,"8","20","wolkig",240
"5/14/2016 2:00","47",81,"8","15","wolkig",128
"5/14/2016 3:00","33",72,"8","15","wolkig",105
"5/14/2016 4:00","21",62,"8","13","wolkig",83
"5/14/2016 5:00","22",43,"7","11","wolkig",65
"5/14/2016 6:00","34",24,"7","9","wolkig",58
"5/14/2016 7:00","127",39,"8","17","wolkig",166
"5/14/2016 8:00","169",65,"8","19","wolkig",234
"5/14/2016 9:00","227",83,"9","19","wolkig",310
"5/14/2016 10:00","320",126,"10","20","wolkig",446
"5/14/2016 11:00","317",159,"10","19","teilweise bewölkt",476
"5/14/2016 12:00","325",217,"11","20","wolkig",542
"5/14/2016 13:00","264",255,"11","22","wolkig",519
"5/14/2016 14:00","233",248,"12","19","teilweise bewölkt",481
"5/14/2016 15:00","238",250,"11","20","teilweise bewölkt",488
"5/14/2016 16:00","189",196,"9","20","Regen",385
"5/14/2016 17:00","171",220,"10","20","Regen",391
"5/14/2016 18:00","175",252,"9","20","Regen",427
"5/14/2016 19:00","170",180,"9","20","Regen",350
"5/14/2016 20:00","178",185,"8","15","teilweise bewölkt",363
"5/14/2016 21:00","109",116,"7","19","teilweise bewölkt",225
"5/14/2016 22:00","85",126,"7","17","Regen",211
"5/14/2016 23:00","80",105,"5","15","teilweise bewölkt",185
"5/15/2016 0:00","77",89,"5","19","Klarer Himmel",166
"5/15/2016 1:00","76",83,"5","15","teilweise bewölkt",159
"5/15/2016 2:00","40",63,"5","13","teilweise bewölkt",103
"5/15/2016 3:00","20",68,"5","15","teilweise bewölkt",88
"5/15/2016 4:00","8",46,"4","15","teilweise bewölkt",54
"5/15/2016 5:00","13",33,"4","15","teilweise bewölkt",46
"5/15/2016 6:00","16",11,"6","19","teilweise bewölkt",27
"5/15/2016 7:00","31",22,"7","20","teilweise bewölkt",53
"5/15/2016 8:00","28",16,"8","22","wolkig",44
"5/15/2016 9:00","101",53,"9","22","teilweise bewölkt",154
"5/15/2016 10:00","145",90,"10","26","wolkig",235
"5/15/2016 11:00","122",106,"8","13","teilweise bewölkt",228
"5/15/2016 12:00","118",101,"8","15","teilweise bewölkt",219
"5/15/2016 13:00","99",85,"12","24","teilweise bewölkt",184
"5/15/2016 14:00","122",88,"10","22","Regen",210
"5/15/2016 15:00","120",102,"12","28","teilweise bewölkt",222
"5/15/2016 16:00","111",106,"10","20","Regen",217
"5/15/2016 17:00","143",117,"9","9","wolkig",260
"5/15/2016 18:00","150",139,"10","11","wolkig",289
"5/15/2016 19:00","101",133,"9","22","wolkig",234
"5/15/2016 20:00","106",110,"8","15","teilweise bewölkt",216
"5/15/2016 21:00","93",83,"7","11","teilweise bewölkt",176
"5/15/2016 22:00","76",78,"6","9","Klarer Himmel",154
"5/15/2016 23:00","52",85,"5","7","Klarer Himmel",137
"5/16/2016 0:00","61",62,"4","6","Klarer Himmel",123
"5/16/2016 1:00","37",51,"3","6","Klarer Himmel",88
"5/16/2016 2:00","11",34,"3","7","Klarer Himmel",45
"5/16/2016 3:00","3",18,"2","7","Klarer Himmel",21
"5/16/2016 4:00","10",24,"3","6","Nebel",34
"5/16/2016 5:00","8",9,"3","6","Nebel",17
"5/16/2016 6:00","7",9,"3","2","Nebel",16
"5/16/2016 7:00","30",17,"6","9","teilweise bewölkt",47
"5/16/2016 8:00","51",23,"8","9","wolkig",74
"5/16/2016 9:00","95",59,"9","13","wolkig",154
"5/16/2016 10:00","107",120,"10","15","teilweise bewölkt",227
"5/16/2016 11:00","163",94,"11","9","teilweise bewölkt",257
"5/16/2016 12:00","141",127,"11","11","teilweise bewölkt",268
"5/16/2016 13:00","166",154,"12","13","wolkig",320
"5/16/2016 14:00","184",167,"12","19","wolkig",351
"5/16/2016 15:00","199",129,"13","20","wolkig",328
"5/16/2016 16:00","155",162,"12","22","wolkig",317
"5/16/2016 17:00","139",185,"12","26","wolkig",324
"5/16/2016 18:00","187",169,"12","13","teilweise bewölkt",356
"5/16/2016 19:00","146",137,"11","17","wolkig",283
"5/16/2016 20:00","136",134,"11","13","wolkig",270
"5/16/2016 21:00","61",103,"10","17","wolkig",164
"5/16/2016 22:00","59",101,"9","15","Klarer Himmel",160
"5/16/2016 23:00","64",90,"9","11","Klarer Himmel",154
"5/17/2016 0:00","16",43,"9","11","wolkig",59
"5/17/2016 1:00","9",25,"9","11","wolkig",34
"5/17/2016 2:00","6",14,"8","11","wolkig",20
"5/17/2016 3:00","2",3,"8","11","wolkig",5
"5/17/2016 4:00","8",7,"9","13","wolkig",15
"5/17/2016 5:00","35",19,"9","11","wolkig",54
"5/17/2016 6:00","125",47,"9","11","wolkig",172
"5/17/2016 7:00","295",163,"9","11","wolkig",458
"5/17/2016 8:00","486",316,"10","11","wolkig",802
"5/17/2016 9:00","335",242,"11","11","wolkig",577
"5/17/2016 10:00","315",192,"12","11","teilweise bewölkt",507
"5/17/2016 11:00","301",235,"14","20","teilweise bewölkt",536
"5/17/2016 12:00","310",267,"15","19","wolkig",577
"5/17/2016 13:00","300",305,"15","19","wolkig",605
"5/17/2016 14:00","325",309,"15","17","teilweise bewölkt",634
"5/17/2016 15:00","383",318,"17","17","teilweise bewölkt",701
"5/17/2016 16:00","402",421,"16","17","wolkig",823
"5/17/2016 17:00","477",555,"17","26","wolkig",1032
"5/17/2016 18:00","431",499,"16","17","wolkig",930
"5/17/2016 19:00","368",360,"16","9","teilweise bewölkt",728
"5/17/2016 20:00","250",271,"15","6","Klarer Himmel",521
"5/17/2016 21:00","199",166,"12","9","teilweise bewölkt",365
"5/17/2016 22:00","166",154,"13","6","teilweise bewölkt",320
"5/17/2016 23:00","64",100,"12","11","Klarer Himmel",164
"5/18/2016 0:00","26",77,"11","7","Klarer Himmel",103
"5/18/2016 1:00","11",42,"9","2","Klarer Himmel",53
"5/18/2016 2:00","6",16,"8","4","teilweise bewölkt",22
"5/18/2016 3:00","7",14,"10","7","wolkig",21
"5/18/2016 4:00","11",11,"10","7","teilweise bewölkt",22
"5/18/2016 5:00","44",19,"10","4","Klarer Himmel",63
"5/18/2016 6:00","126",50,"10","6","Klarer Himmel",176
"5/18/2016 7:00","483",203,"11","7","wolkig",686
"5/18/2016 8:00","557",366,"12","7","wolkig",923
"5/18/2016 9:00","450",294,"15","15","wolkig",744
"5/18/2016 10:00","364",259,"16","15","teilweise bewölkt",623
"5/18/2016 11:00","363",293,"17","17","wolkig",656
"5/18/2016 12:00","286",323,"18","15","wolkig",609
"5/18/2016 13:00","338",357,"18","17","wolkig",695
"5/18/2016 14:00","345",386,"18","13","Regen",731
"5/18/2016 15:00","348",368,"18","6","wolkig",716
"5/18/2016 16:00","415",419,"18","9","wolkig",834
"5/18/2016 17:00","522",544,"19","15","wolkig",1066
"5/18/2016 18:00","448",493,"16","17","Regen",941
"5/18/2016 19:00","397",370,"15","9","wolkig",767
"5/18/2016 20:00","265",326,"15","4","",591
"5/18/2016 21:00","153",178,"14","6","wolkig",331
"5/18/2016 22:00","141",183,"14","6","wolkig",324
"5/18/2016 23:00","134",162,"14","4","wolkig",296
"5/19/2016 0:00","79",129,"12","4","Regen",208
"5/19/2016 1:00","31",75,"13","6","wolkig",106
"5/19/2016 2:00","11",32,"12","6","Klarer Himmel",43
"5/19/2016 3:00","15",42,"11","2","Klarer Himmel",57
"5/19/2016 4:00","13",50,"10","2","Klarer Himmel",63
"5/19/2016 5:00","44",37,"8","2","Nebel",81
"5/19/2016 6:00","136",55,"9","0","Nebel",191
"5/19/2016 7:00","514",222,"12","2","Regen",736
"5/19/2016 8:00","548",338,"13","15","Klarer Himmel",886
"5/19/2016 9:00","347",246,"13","13","wolkig",593
"5/19/2016 10:00","286",265,"15","11","wolkig",551
"5/19/2016 11:00","310",262,"16","11","wolkig",572
"5/19/2016 12:00","357",320,"17","13","wolkig",677
"5/19/2016 13:00","390",347,"17","15","wolkig",737
"5/19/2016 14:00","374",374,"18","20","wolkig",748
"5/19/2016 15:00","404",429,"18","19","wolkig",833
"5/19/2016 16:00","477",503,"18","17","teilweise bewölkt",980
"5/19/2016 17:00","552",532,"19","19","teilweise bewölkt",1084
"5/19/2016 18:00","516",515,"18","17","teilweise bewölkt",1031
"5/19/2016 19:00","344",427,"18","15","teilweise bewölkt",771
"5/19/2016 20:00","282",339,"17","11","Klarer Himmel",621
"5/19/2016 21:00","161",219,"14","7","Klarer Himmel",380
"5/19/2016 22:00","138",238,"10","6","Klarer Himmel",376
"5/19/2016 23:00","117",202,"10","4","Klarer Himmel",319
"5/20/2016 0:00","32",106,"10","7","Klarer Himmel",138
"5/20/2016 1:00","23",35,"10","11","Klarer Himmel",58
"5/20/2016 2:00","13",23,"10","11","Klarer Himmel",36
"5/20/2016 3:00","3",14,"10","9","Klarer Himmel",17
"5/20/2016 4:00","14",17,"11","11","Klarer Himmel",31
"5/20/2016 5:00","37",20,"10","11","Klarer Himmel",57
"5/20/2016 6:00","127",43,"11","13","Klarer Himmel",170
"5/20/2016 7:00","511",199,"12","15","wolkig",710
"5/20/2016 8:00","474",276,"12","15","Regen",750
"5/20/2016 9:00","380",238,"12","15","wolkig",618
"5/20/2016 10:00","295",249,"14","13","Regen",544
"5/20/2016 11:00","327",228,"14","22","wolkig",555
"5/20/2016 12:00","336",332,"15","24","wolkig",668
"5/20/2016 13:00","367",390,"16","20","wolkig",757
"5/20/2016 14:00","347",404,"14","15","Regen",751
"5/20/2016 15:00","392",362,"15","20","Regen",754
"5/20/2016 16:00","369",348,"15","9","wolkig",717
"5/20/2016 17:00","422",356,"15","13","wolkig",778
"5/20/2016 18:00","394",330,"15","11","wolkig",724
"5/20/2016 19:00","360",290,"15","9","wolkig",650
"5/20/2016 20:00","284",260,"15","9","Klarer Himmel",544
"5/20/2016 21:00","191",200,"14","9","Klarer Himmel",391
"5/20/2016 22:00","149",212,"14","9","wolkig",361
"5/20/2016 23:00","115",149,"14","9","wolkig",264
"5/21/2016 0:00","106",186,"14","9","Klarer Himmel",292
"5/21/2016 1:00","66",145,"14","13","wolkig",211
"5/21/2016 2:00","54",94,"14","13","wolkig",148
"5/21/2016 3:00","29",50,"12","7","Klarer Himmel",79
"5/21/2016 4:00","25",60,"12","7","Klarer Himmel",85
"5/21/2016 5:00","34",31,"11","6","Nebel",65
"5/21/2016 6:00","74",40,"12","7","",114
"5/21/2016 7:00","153",32,"14","9","Klarer Himmel",185
"5/21/2016 8:00","311",83,"15","15","Klarer Himmel",394
"5/21/2016 9:00","396",119,"17","15","wolkig",515
"5/21/2016 10:00","504",246,"18","15","wolkig",750
"5/21/2016 11:00","514",261,"19","17","wolkig",775
"5/21/2016 12:00","518",366,"20","19","wolkig",884
"5/21/2016 13:00","453",402,"22","19","wolkig",855
"5/21/2016 14:00","421",453,"23","19","Klarer Himmel",874
"5/21/2016 15:00","407",443,"23","22","wolkig",850
"5/21/2016 16:00","394",453,"22","20","Klarer Himmel",847
"5/21/2016 17:00","357",433,"23","19","Klarer Himmel",790
"5/21/2016 18:00","424",515,"23","15","Klarer Himmel",939
"5/21/2016 19:00","404",426,"22","13","Klarer Himmel",830
"5/21/2016 20:00","243",285,"20","6","Klarer Himmel",528
"5/21/2016 21:00","184",193,"19","6","Klarer Himmel",377
"5/21/2016 22:00","158",200,"17","4","Klarer Himmel",358
"5/21/2016 23:00","239",304,"18","9","Klarer Himmel",543
"5/22/2016 0:00","149",210,"18","7","Klarer Himmel",359
"5/22/2016 1:00","107",159,"17","7","Klarer Himmel",266
"5/22/2016 2:00","69",171,"16","9","Klarer Himmel",240
"5/22/2016 3:00","55",128,"15","7","Klarer Himmel",183
"5/22/2016 4:00","22",91,"14","7","Klarer Himmel",113
"5/22/2016 5:00","18",46,"14","7","Klarer Himmel",64
"5/22/2016 6:00","21",36,"15","9","Klarer Himmel",57
"5/22/2016 7:00","24",12,"17","11","Klarer Himmel",36
"5/22/2016 8:00","62",31,"19","13","Klarer Himmel",93
"5/22/2016 9:00","155",68,"21","13","Klarer Himmel",223
"5/22/2016 10:00","240",106,"23","13","Klarer Himmel",346
"5/22/2016 11:00","222",121,"24","20","Klarer Himmel",343
"5/22/2016 12:00","236",162,"23","22","wolkig",398
"5/22/2016 13:00","236",219,"22","32","wolkig",455
"5/22/2016 14:00","233",197,"23","24","wolkig",430
"5/22/2016 15:00","214",289,"22","20","Regen",503
"5/22/2016 16:00","190",193,"20","22","Klarer Himmel",383
"5/22/2016 17:00","191",257,"19","17","Regen",448
"5/22/2016 18:00","101",187,"17","20","Regen",288
"5/22/2016 19:00","105",154,"16","6","Regen",259
"5/22/2016 20:00","110",160,"15","4","wolkig",270
"5/22/2016 21:00","66",118,"15","7","Klarer Himmel",184
"5/22/2016 22:00","47",123,"15","7","Regen",170
"5/22/2016 23:00","30",85,"15","7","wolkig",115
"5/23/2016 0:00","21",26,"15","7","wolkig",47
"5/23/2016 1:00","7",18,"15","7","wolkig",25
"5/23/2016 2:00","4",10,"15","4","Regen",14
"5/23/2016 3:00","3",6,"15","6","Klarer Himmel",9
"5/23/2016 4:00","4",5,"15","4","Nebel",9
"5/23/2016 5:00","28",11,"15","6","wolkig",39
"5/23/2016 6:00","111",48,"15","4","wolkig",159
"5/23/2016 7:00","479",229,"15","6","wolkig",708
"5/23/2016 8:00","582",434,"15","11","Regen",1016
"5/23/2016 9:00","367",367,"15","11","Regen",734
"5/23/2016 10:00","385",391,"16","13","Regen",776
"5/23/2016 11:00","390",363,"15","17","wolkig",753
"5/23/2016 12:00","437",439,"15","15","wolkig",876
"5/23/2016 13:00","465",468,"15","15","wolkig",933
"5/23/2016 14:00","447",483,"15","13","wolkig",930
"5/23/2016 15:00","527",531,"15","13","wolkig",1058
"5/23/2016 16:00","586",580,"15","11","wolkig",1166
"5/23/2016 17:00","695",825,"15","7","wolkig",1520
"5/23/2016 18:00","557",660,"13","20","Regen",1217
"5/23/2016 19:00","416",496,"12","17","Regen",912
"5/23/2016 20:00","321",361,"12","17","Regen",682
"5/23/2016 21:00","191",224,"11","20","wolkig",415
"5/23/2016 22:00","106",183,"11","17","wolkig",289
"5/23/2016 23:00","68",129,"11","20","wolkig",197
"5/24/2016 0:00","38",83,"11","15","wolkig",121
"5/24/2016 1:00","24",34,"11","17","wolkig",58
"5/24/2016 2:00","7",19,"10","19","wolkig",26
"5/24/2016 3:00","3",8,"10","17","wolkig",11
"5/24/2016 4:00","6",4,"10","15","wolkig",10
"5/24/2016 5:00","26",10,"10","17","wolkig",36
"5/24/2016 6:00","126",42,"10","13","wolkig",168
"5/24/2016 7:00","524",258,"10","17","wolkig",782
"5/24/2016 8:00","874",545,"10","15","wolkig",1419
"5/24/2016 9:00","503",512,"11","17","wolkig",1015
"5/24/2016 10:00","548",524,"11","19","wolkig",1072
"5/24/2016 11:00","468",390,"11","15","wolkig",858
"5/24/2016 12:00","611",550,"12","15","wolkig",1161
"5/24/2016 13:00","627",502,"11","19","Regen",1129
"5/24/2016 14:00","541",565,"11","15","wolkig",1106
"5/24/2016 15:00","614",608,"12","17","wolkig",1222
"5/24/2016 16:00","650",639,"12","15","Regen",1289
"5/24/2016 17:00","819",712,"11","17","Regen",1531
"5/24/2016 18:00","733",642,"11","7","wolkig",1375
"5/24/2016 19:00","626",499,"11","9","wolkig",1125
"5/24/2016 20:00","358",399,"10","9","wolkig",757
"5/24/2016 21:00","254",315,"10","11","wolkig",569
"5/24/2016 22:00","168",293,"10","6","wolkig",461
"5/24/2016 23:00","85",187,"10","7","wolkig",272
"5/25/2016 0:00","33",112,"10","9","wolkig",145
"5/25/2016 1:00","18",61,"10","6","wolkig",79
"5/25/2016 2:00","4",16,"10","6","Regen",20
"5/25/2016 3:00","4",3,"10","6","wolkig",7
"5/25/2016 4:00","9",3,"10","9","wolkig",12
"5/25/2016 5:00","36",15,"10","7","wolkig",51
"5/25/2016 6:00","142",35,"10","7","wolkig",177
"5/25/2016 7:00","668",236,"10","7","wolkig",904
"5/25/2016 8:00","762",540,"11","7","wolkig",1302
"5/25/2016 9:00","585",476,"11","7","wolkig",1061
"5/25/2016 10:00","624",580,"12","7","wolkig",1204
"5/25/2016 11:00","572",412,"13","9","wolkig",984
"5/25/2016 12:00","544",549,"13","9","wolkig",1093
"5/25/2016 13:00","606",523,"14","9","wolkig",1129
"5/25/2016 14:00","554",564,"15","11","wolkig",1118
"5/25/2016 15:00","650",589,"15","11","wolkig",1239
"5/25/2016 16:00","651",628,"16","9","wolkig",1279
"5/25/2016 17:00","726",685,"16","6","wolkig",1411
"5/25/2016 18:00","678",599,"15","4","wolkig",1277
"5/25/2016 19:00","631",547,"15","4","wolkig",1178
"5/25/2016 20:00","465",431,"14","2","wolkig",896
"5/25/2016 21:00","360",308,"13","4","wolkig",668
"5/25/2016 22:00","249",304,"13","2","wolkig",553
"5/25/2016 23:00","272",264,"13","4","wolkig",536
"5/26/2016 0:00","318",226,"13","4","wolkig",544
"5/26/2016 1:00","179",234,"12","6","wolkig",413
"5/26/2016 2:00","100",245,"11","2","wolkig",345
"5/26/2016 3:00","65",245,"12","4","wolkig",310
"5/26/2016 4:00","31",165,"12","4","wolkig",196
"5/26/2016 5:00","30",90,"12","2","wolkig",120
"5/26/2016 6:00","35",36,"12","4","wolkig",71
"5/26/2016 7:00","73",32,"13","4","wolkig",105
"5/26/2016 8:00","95",51,"15","2","Klarer Himmel",146
"5/26/2016 9:00","172",63,"17","4","teilweise bewölkt",235
"5/26/2016 10:00","253",144,"17","4","teilweise bewölkt",397
"5/26/2016 11:00","200",153,"18","9","teilweise bewölkt",353
"5/26/2016 12:00","274",190,"19","6","teilweise bewölkt",464
"5/26/2016 13:00","241",235,"19","6","Klarer Himmel",476
"5/26/2016 14:00","311",266,"18","9","wolkig",577
"5/26/2016 15:00","361",268,"18","11","wolkig",629
"5/26/2016 16:00","333",296,"19","7","wolkig",629
"5/26/2016 17:00","332",355,"20","6","teilweise bewölkt",687
"5/26/2016 18:00","357",338,"20","6","teilweise bewölkt",695
"5/26/2016 19:00","343",338,"19","11","wolkig",681
"5/26/2016 20:00","210",267,"17","13","Klarer Himmel",477
"5/26/2016 21:00","191",229,"16","7","Klarer Himmel",420
"5/26/2016 22:00","142",230,"15","9","Klarer Himmel",372
"5/26/2016 23:00","97",202,"14","9","",299
"5/27/2016 0:00","47",134,"14","9","",181
"5/27/2016 1:00","25",85,"13","11","",110
"5/27/2016 2:00","22",40,"12","9","",62
"5/27/2016 3:00","10",13,"12","7","",23
"5/27/2016 4:00","13",8,"12","9","",21
"5/27/2016 5:00","35",13,"11","7","",48
"5/27/2016 6:00","95",29,"13","7","",124
"5/27/2016 7:00","273",116,"13","11","",389
"5/27/2016 8:00","503",248,"14","13","",751
"5/27/2016 9:00","405",240,"15","11","wolkig",645
"5/27/2016 10:00","478",377,"16","13","wolkig",855
"5/27/2016 11:00","455",257,"16","15","wolkig",712
"5/27/2016 12:00","466",343,"16","19","wolkig",809
"5/27/2016 13:00","412",336,"18","15","wolkig",748
"5/27/2016 14:00","435",431,"18","13","wolkig",866
"5/27/2016 15:00","413",419,"19","15","wolkig",832
"5/27/2016 16:00","377",377,"19","11","wolkig",754
"5/27/2016 17:00","420",414,"20","13","wolkig",834
"5/27/2016 18:00","404",426,"21","11","teilweise bewölkt",830
"5/27/2016 19:00","451",379,"19","11","wolkig",830
"5/27/2016 20:00","333",258,"19","6","wolkig",591
"5/27/2016 21:00","189",210,"17","6","teilweise bewölkt",399
"5/27/2016 22:00","151",242,"15","4","Klarer Himmel",393
"5/27/2016 23:00","116",254,"14","4","Klarer Himmel",370
"5/28/2016 0:00","104",236,"14","2","Klarer Himmel",340
"5/28/2016 1:00","65",179,"14","6","Klarer Himmel",244
"5/28/2016 2:00","37",128,"14","6","Klarer Himmel",165
"5/28/2016 3:00","17",71,"14","6","",88
"5/28/2016 4:00","16",42,"14","2","",58
"5/28/2016 5:00","26",20,"14","4","",46
"5/28/2016 6:00","45",18,"15","6","",63
"5/28/2016 7:00","111",22,"16","4","",133
"5/28/2016 8:00","190",79,"18","7","teilweise bewölkt",269
"5/28/2016 9:00","286",119,"20","6","teilweise bewölkt",405
"5/28/2016 10:00","411",189,"20","13","teilweise bewölkt",600
"5/28/2016 11:00","390",235,"22","9","teilweise bewölkt",625
"5/28/2016 12:00","460",270,"22","11","teilweise bewölkt",730
"5/28/2016 13:00","429",298,"23","7","teilweise bewölkt",727
"5/28/2016 14:00","426",370,"23","7","teilweise bewölkt",796
"5/28/2016 15:00","362",336,"22","15","teilweise bewölkt",698
"5/28/2016 16:00","318",319,"21","20","wolkig",637
"5/28/2016 17:00","311",417,"21","15","teilweise bewölkt",728
"5/28/2016 18:00","266",244,"21","9","Regen",510
"5/28/2016 19:00","233",218,"21","6","wolkig",451
"5/28/2016 20:00","264",270,"20","6","Klarer Himmel",534
"5/28/2016 21:00","141",199,"18","6","Klarer Himmel",340
"5/28/2016 22:00","99",178,"17","7","Klarer Himmel",277
"5/28/2016 23:00","83",266,"17","6","Klarer Himmel",349
"5/29/2016 0:00","119",206,"16","7","Klarer Himmel",325
"5/29/2016 1:00","50",184,"16","6","Klarer Himmel",234
"5/29/2016 2:00","45",163,"16","7","teilweise bewölkt",208
"5/29/2016 3:00","31",136,"16","4","Regen",167
"5/29/2016 4:00","25",76,"16","9","Regen",101
"5/29/2016 5:00","12",56,"15","7","wolkig",68
"5/29/2016 6:00","20",27,"16","9","Regen",47
"5/29/2016 7:00","21",16,"16","13","wolkig",37
"5/29/2016 8:00","45",29,"16","11","wolkig",74
"5/29/2016 9:00","117",60,"16","13","Regen",177
"5/29/2016 10:00","135",93,"17","9","Regen",228
"5/29/2016 11:00","131",87,"18","20","wolkig",218
"5/29/2016 12:00","170",111,"17","15","wolkig",281
"5/29/2016 13:00","219",172,"17","13","wolkig",391
"5/29/2016 14:00","189",141,"17","13","wolkig",330
"5/29/2016 15:00","199",156,"17","22","wolkig",355
"5/29/2016 16:00","203",172,"17","20","wolkig",375
"5/29/2016 17:00","209",246,"16","17","wolkig",455
"5/29/2016 18:00","183",214,"16","13","wolkig",397
"5/29/2016 19:00","165",216,"16","13","wolkig",381
"5/29/2016 20:00","107",197,"16","9","wolkig",304
"5/29/2016 21:00","79",143,"16","9","wolkig",222
"5/29/2016 22:00","78",145,"16","9","wolkig",223
"5/29/2016 23:00","41",85,"16","7","wolkig",126
"5/30/2016 0:00","18",39,"16","9","wolkig",57
"5/30/2016 1:00","6",18,"16","9","wolkig",24
"5/30/2016 2:00","3",13,"16","17","wolkig",16
"5/30/2016 3:00","5",7,"16","13","wolkig",12
"5/30/2016 4:00","11",2,"16","22","wolkig",13
"5/30/2016 5:00","27",10,"15","7","wolkig",37
"5/30/2016 6:00","121",42,"15","15","wolkig",163
"5/30/2016 7:00","482",199,"16","19","wolkig",681
"5/30/2016 8:00","590",458,"16","11","wolkig",1048
"5/30/2016 9:00","420",347,"17","13","wolkig",767
"5/30/2016 10:00","462",446,"19","20","wolkig",908
"5/30/2016 11:00","391",375,"20","11","wolkig",766
"5/30/2016 12:00","471",527,"22","20","wolkig",998
"5/30/2016 13:00","465",475,"23","22","wolkig",940
"5/30/2016 14:00","479",415,"24","22","wolkig",894
"5/30/2016 15:00","639",502,"24","13","teilweise bewölkt",1141
"5/30/2016 16:00","586",644,"25","13","wolkig",1230
"5/30/2016 17:00","685",709,"21","13","Regen",1394
"5/30/2016 18:00","674",650,"21","7","Regen",1324
"5/30/2016 19:00","399",452,"19","11","Gewitter",851
"5/30/2016 20:00","248",354,"19","6","wolkig",602
"5/30/2016 21:00","175",229,"18","7","teilweise bewölkt",404
"5/30/2016 22:00","121",336,"18","7","teilweise bewölkt",457
"5/30/2016 23:00","75",121,"17","6","Klarer Himmel",196
"5/31/2016 0:00","27",62,"16","4","Klarer Himmel",89
"5/31/2016 1:00","12",45,"16","6","Klarer Himmel",57
"5/31/2016 2:00","6",16,"15","6","Klarer Himmel",22
"5/31/2016 3:00","4",13,"15","4","Klarer Himmel",17
"5/31/2016 4:00","6",7,"14","6","teilweise bewölkt",13
"5/31/2016 5:00","33",13,"14","4","Nebel",46
"5/31/2016 6:00","144",49,"15","6","teilweise bewölkt",193
"5/31/2016 7:00","520",275,"17","7","teilweise bewölkt",795
"5/31/2016 8:00","762",566,"18","7","teilweise bewölkt",1328
"5/31/2016 9:00","587",491,"20","9","teilweise bewölkt",1078
"5/31/2016 10:00","637",584,"20","11","teilweise bewölkt",1221
"5/31/2016 11:00","563",475,"19","13","wolkig",1038
"5/31/2016 12:00","523",609,"20","11","wolkig",1132
"5/31/2016 13:00","635",604,"21","13","wolkig",1239
"5/31/2016 14:00","570",617,"22","7","wolkig",1187
"5/31/2016 15:00","684",599,"23","7","wolkig",1283
"5/31/2016 16:00","747",783,"23","7","Klarer Himmel",1530
"5/31/2016 17:00","811",865,"23","7","Klarer Himmel",1676
"5/31/2016 18:00","752",855,"24","7","Klarer Himmel",1607
"5/31/2016 19:00","783",605,"23","4","Klarer Himmel",1388
"5/31/2016 20:00","467",423,"23","2","Klarer Himmel",890
"5/31/2016 21:00","274",338,"21","6","Klarer Himmel",612
"5/31/2016 22:00","207",400,"21","6","Klarer Himmel",607
"5/31/2016 23:00","119",268,"19","7","Klarer Himmel",387
"6/1/2016 0:00","40",139,"18","6","wolkig",179
"6/1/2016 1:00","25",102,"17","4","Gewitter",127
"6/1/2016 2:00","18",22,"16","9","wolkig",40
"6/1/2016 3:00","7",6,"16","6","Klarer Himmel",13
"6/1/2016 4:00","4",4,"15","0","Nebel",8
"6/1/2016 5:00","33",14,"16","4","wolkig",47
"6/1/2016 6:00","135",39,"16","6","wolkig",174
"6/1/2016 7:00","596",204,"17","6","wolkig",800
"6/1/2016 8:00","682",564,"18","6","wolkig",1246
"6/1/2016 9:00","533",424,"19","7","wolkig",957
"6/1/2016 10:00","604",518,"19","13","wolkig",1122
"6/1/2016 11:00","522",433,"19","11","Regen",955
"6/1/2016 12:00","488",525,"20","9","wolkig",1013
"6/1/2016 13:00","539",474,"21","9","wolkig",1013
"6/1/2016 14:00","454",592,"22","17","wolkig",1046
"6/1/2016 15:00","528",520,"23","11","wolkig",1048
"6/1/2016 16:00","591",691,"21","6","wolkig",1282
"6/1/2016 17:00","635",711,"20","11","Regen",1346
"6/1/2016 18:00","548",612,"19","7","Gewitter",1160
"6/1/2016 19:00","451",378,"19","6","Regen",829
"6/1/2016 20:00","293",372,"19","7","wolkig",665
"6/1/2016 21:00","218",289,"18","2","Regen",507
"6/1/2016 22:00","193",234,"18","9","Regen",427
"6/1/2016 23:00","144",170,"18","9","wolkig",314
"6/2/2016 0:00","128",127,"18","4","wolkig",255
"6/2/2016 1:00","49",132,"19","11","wolkig",181
"6/2/2016 2:00","32",61,"18","11","wolkig",93
"6/2/2016 3:00","23",107,"18","7","wolkig",130
"6/2/2016 4:00","21",65,"17","6","teilweise bewölkt",86
"6/2/2016 5:00","50",29,"16","7","teilweise bewölkt",79
"6/2/2016 6:00","134",57,"17","6","teilweise bewölkt",191
"6/2/2016 7:00","508",243,"18","7","",751
"6/2/2016 8:00","572",531,"19","6","teilweise bewölkt",1103
"6/2/2016 9:00","571",407,"19","7","teilweise bewölkt",978
"6/2/2016 10:00","646",456,"20","9","wolkig",1102
"6/2/2016 11:00","518",414,"21","11","wolkig",932
"6/2/2016 12:00","508",617,"22","7","teilweise bewölkt",1125
"6/2/2016 13:00","551",565,"22","6","teilweise bewölkt",1116
"6/2/2016 14:00","590",617,"24","7","teilweise bewölkt",1207
"6/2/2016 15:00","674",653,"18","22","Gewitter",1327
"6/2/2016 16:00","359",429,"16","7","Regen",788
"6/2/2016 17:00","530",557,"16","6","wolkig",1087
"6/2/2016 18:00","663",576,"17","7","wolkig",1239
"6/2/2016 19:00","474",516,"17","9","teilweise bewölkt",990
"6/2/2016 20:00","374",365,"18","7","Klarer Himmel",739
"6/2/2016 21:00","270",267,"16","6","Nebel",537
"6/2/2016 22:00","236",316,"16","4","Nebel",552
"6/2/2016 23:00","129",265,"16","2","Nebel",394
"6/3/2016 0:00","73",118,"15","4","Nebel",191
"6/3/2016 1:00","23",88,"16","4","Nebel",111
"6/3/2016 2:00","14",32,"17","6","Nebel",46
"6/3/2016 3:00","16",32,"16","6","Nebel",48
"6/3/2016 4:00","11",31,"16","4","wolkig",42
"6/3/2016 5:00","43",21,"16","2","Nebel",64
"6/3/2016 6:00","117",44,"16","2","Nebel",161
"6/3/2016 7:00","475",189,"15","6","wolkig",664
"6/3/2016 8:00","569",493,"15","6","Nebel",1062
"6/3/2016 9:00","488",321,"16","4","wolkig",809
"6/3/2016 10:00","417",393,"17","2","wolkig",810
"6/3/2016 11:00","412",280,"20","4","wolkig",692
"6/3/2016 12:00","493",486,"22","7","wolkig",979
"6/3/2016 13:00","515",495,"23","7","wolkig",1010
"6/3/2016 14:00","425",541,"24","13","teilweise bewölkt",966
"6/3/2016 15:00","393",431,"25","13","teilweise bewölkt",824
"6/3/2016 16:00","516",445,"25","17","Klarer Himmel",961
"6/3/2016 17:00","554",452,"25","13","Klarer Himmel",1006
"6/3/2016 18:00","590",400,"26","11","Klarer Himmel",990
"6/3/2016 19:00","619",383,"25","13","Klarer Himmel",1002
"6/3/2016 20:00","486",361,"22","6","teilweise bewölkt",847
"6/3/2016 21:00","293",311,"20","7","Klarer Himmel",604
"6/3/2016 22:00","234",398,"18","6","Klarer Himmel",632
"6/3/2016 23:00","180",327,"18","7","Klarer Himmel",507
"6/4/2016 0:00","140",364,"17","4","Klarer Himmel",504
"6/4/2016 1:00","129",272,"17","4","Klarer Himmel",401
"6/4/2016 2:00","86",134,"17","6","Klarer Himmel",220
"6/4/2016 3:00","61",106,"15","4","Nebel",167
"6/4/2016 4:00","34",67,"15","7","Nebel",101
"6/4/2016 5:00","26",45,"15","4","Nebel",71
"6/4/2016 6:00","38",27,"16","0","Nebel",65
"6/4/2016 7:00","116",32,"19","4","Klarer Himmel",148
"6/4/2016 8:00","203",96,"21","7","Klarer Himmel",299
"6/4/2016 9:00","377",124,"24","11","Klarer Himmel",501
"6/4/2016 10:00","374",191,"25","15","Klarer Himmel",565
"6/4/2016 11:00","400",251,"25","19","teilweise bewölkt",651
"6/4/2016 12:00","429",308,"25","15","wolkig",737
"6/4/2016 13:00","388",319,"26","17","wolkig",707
"6/4/2016 14:00","429",380,"27","17","wolkig",809
"6/4/2016 15:00","498",338,"26","20","teilweise bewölkt",836
"6/4/2016 16:00","509",379,"26","22","teilweise bewölkt",888
"6/4/2016 17:00","364",422,"26","13","wolkig",786
"6/4/2016 18:00","415",471,"25","17","wolkig",886
"6/4/2016 19:00","441",372,"24","9","wolkig",813
"6/4/2016 20:00","398",317,"22","6","teilweise bewölkt",715
"6/4/2016 21:00","293",284,"20","7","teilweise bewölkt",577
"6/4/2016 22:00","177",319,"19","9","Klarer Himmel",496
"6/4/2016 23:00","202",309,"18","7","Klarer Himmel",511
"6/5/2016 0:00","165",265,"18","6","Klarer Himmel",430
"6/5/2016 1:00","142",228,"18","2","Klarer Himmel",370
"6/5/2016 2:00","76",143,"16","4","Klarer Himmel",219
"6/5/2016 3:00","72",145,"15","4","Klarer Himmel",217
"6/5/2016 4:00","36",67,"15","2","Nebel",103
"6/5/2016 5:00","25",46,"15","4","Nebel",71
"6/5/2016 6:00","16",31,"17","2","Klarer Himmel",47
"6/5/2016 7:00","21",20,"19","4","Klarer Himmel",41
"6/5/2016 8:00","61",47,"21","7","Klarer Himmel",108
"6/5/2016 9:00","216",80,"23","6","Klarer Himmel",296
"6/5/2016 10:00","206",126,"24","13","Klarer Himmel",332
"6/5/2016 11:00","262",180,"25","13","Klarer Himmel",442
"6/5/2016 12:00","292",230,"26","13","teilweise bewölkt",522
"6/5/2016 13:00","310",254,"27","15","Klarer Himmel",564
"6/5/2016 14:00","395",326,"27","17","Klarer Himmel",721
"6/5/2016 15:00","378",284,"27","13","teilweise bewölkt",662
"6/5/2016 16:00","331",314,"27","15","teilweise bewölkt",645
"6/5/2016 17:00","339",318,"28","15","teilweise bewölkt",657
"6/5/2016 18:00","330",327,"27","15","teilweise bewölkt",657
"6/5/2016 19:00","299",347,"26","13","Klarer Himmel",646
"6/5/2016 20:00","223",263,"24","13","Klarer Himmel",486
"6/5/2016 21:00","111",254,"22","15","Klarer Himmel",365
"6/5/2016 22:00","113",223,"21","13","Klarer Himmel",336
"6/5/2016 23:00","71",119,"19","9","Klarer Himmel",190
"6/6/2016 0:00","25",74,"18","7","Klarer Himmel",99
"6/6/2016 1:00","12",32,"17","6","Klarer Himmel",44
"6/6/2016 2:00","5",4,"15","6","Klarer Himmel",9
"6/6/2016 3:00","4",2,"14","7","Klarer Himmel",6
"6/6/2016 4:00","7",3,"14","9","",10
"6/6/2016 5:00","44",15,"14","11","wolkig",59
"6/6/2016 6:00","138",57,"14","11","wolkig",195
"6/6/2016 7:00","541",213,"14","11","wolkig",754
"6/6/2016 8:00","676",500,"15","9","wolkig",1176
"6/6/2016 9:00","465",438,"16","11","wolkig",903
"6/6/2016 10:00","487",446,"17","7","wolkig",933
"6/6/2016 11:00","485",429,"19","9","teilweise bewölkt",914
"6/6/2016 12:00","531",480,"20","9","teilweise bewölkt",1011
"6/6/2016 13:00","575",575,"23","9","teilweise bewölkt",1150
"6/6/2016 14:00","566",574,"24","13","",1140
"6/6/2016 15:00","680",623,"25","11","",1303
"6/6/2016 16:00","723",682,"26","11","teilweise bewölkt",1405
"6/6/2016 17:00","836",813,"26","9","teilweise bewölkt",1649
"6/6/2016 18:00","788",792,"26","11","teilweise bewölkt",1580
"6/6/2016 19:00","635",635,"26","9","wolkig",1270
"6/6/2016 20:00","460",422,"24","7","wolkig",882
"6/6/2016 21:00","304",351,"22","7","wolkig",655
"6/6/2016 22:00","190",333,"20","6","Klarer Himmel",523
"6/6/2016 23:00","105",270,"19","4","Klarer Himmel",375
"6/7/2016 0:00","42",147,"18","4","",189
"6/7/2016 1:00","13",56,"17","4","",69
"6/7/2016 2:00","8",15,"16","4","",23
"6/7/2016 3:00","13",5,"16","4","Nebel",18
"6/7/2016 4:00","12",5,"16","0","Nebel",17
"6/7/2016 5:00","42",20,"15","4","Nebel",62
"6/7/2016 6:00","160",61,"16","2","",221
"6/7/2016 7:00","574",261,"18","4","",835
"6/7/2016 8:00","885",612,"21","4","Klarer Himmel",1497
"6/7/2016 9:00","607",548,"23","2","Klarer Himmel",1155
"6/7/2016 10:00","638",587,"25","4","Klarer Himmel",1225
"6/7/2016 11:00","544",445,"26","6","Klarer Himmel",989
"6/7/2016 12:00","636",694,"27","6","wolkig",1330
"6/7/2016 13:00","614",585,"27","9","wolkig",1199
"6/7/2016 14:00","624",644,"28","11","teilweise bewölkt",1268
"6/7/2016 15:00","723",740,"22","9","wolkig",1463
"6/7/2016 16:00","521",473,"18","15","Gewitter",994
"6/7/2016 17:00","575",784,"20","9","wolkig",1359
"6/7/2016 18:00","536",613,"20","15","wolkig",1149
"6/7/2016 19:00","525",452,"20","4","wolkig",977
"6/7/2016 20:00","388",329,"19","4","teilweise bewölkt",717
"6/7/2016 21:00","199",280,"18","6","Nebel",479
"6/7/2016 22:00","142",330,"16","6","Nebel",472
"6/7/2016 23:00","68",220,"16","2","Nebel",288
"6/8/2016 0:00","50",146,"15","4","Nebel",196
"6/8/2016 1:00","15",53,"15","4","Nebel",68
"6/8/2016 2:00","21",19,"14","2","Nebel",40
"6/8/2016 3:00","6",11,"13","4","Nebel",17
"6/8/2016 4:00","14",5,"13","6","Klarer Himmel",19
"6/8/2016 5:00","36",15,"13","7","Klarer Himmel",51
"6/8/2016 6:00","154",44,"13","7","Klarer Himmel",198
"6/8/2016 7:00","710",266,"14","9","Klarer Himmel",976
"6/8/2016 8:00","795",611,"15","13","wolkig",1406
"6/8/2016 9:00","583",461,"16","11","wolkig",1044
"6/8/2016 10:00","635",628,"17","9","wolkig",1263
"6/8/2016 11:00","604",503,"18","13","wolkig",1107
"6/8/2016 12:00","705",657,"18","13","wolkig",1362
"6/8/2016 13:00","597",524,"19","17","wolkig",1121
"6/8/2016 14:00","617",613,"20","13","wolkig",1230
"6/8/2016 15:00","657",654,"21","15","wolkig",1311
"6/8/2016 16:00","766",763,"21","20","wolkig",1529
"6/8/2016 17:00","861",764,"19","24","wolkig",1625
"6/8/2016 18:00","756",813,"17","20","wolkig",1569
"6/8/2016 19:00","684",708,"17","15","wolkig",1392
"6/8/2016 20:00","469",562,"17","15","Klarer Himmel",1031
"6/8/2016 21:00","314",413,"15","7","Klarer Himmel",727
"6/8/2016 22:00","303",368,"14","11","Klarer Himmel",671
"6/8/2016 23:00","180",268,"13","11","Klarer Himmel",448
"6/9/2016 0:00","154",214,"12","13","teilweise bewölkt",368
"6/9/2016 1:00","116",138,"12","11","wolkig",254
"6/9/2016 2:00","32",99,"12","11","wolkig",131
"6/9/2016 3:00","26",90,"12","11","wolkig",116
"6/9/2016 4:00","23",98,"12","9","wolkig",121
"6/9/2016 5:00","56",44,"12","7","wolkig",100
"6/9/2016 6:00","132",62,"12","13","wolkig",194
"6/9/2016 7:00","521",255,"12","9","wolkig",776
"6/9/2016 8:00","613",533,"12","13","wolkig",1146
"6/9/2016 9:00","495",393,"13","13","Regen",888
"6/9/2016 10:00","550",472,"13","13","wolkig",1022
"6/9/2016 11:00","503",406,"13","13","wolkig",909
"6/9/2016 12:00","506",507,"14","13","wolkig",1013
"6/9/2016 13:00","531",517,"15","11","wolkig",1048
"6/9/2016 14:00","580",554,"16","11","wolkig",1134
"6/9/2016 15:00","577",615,"17","13","wolkig",1192
"6/9/2016 16:00","706",653,"18","15","wolkig",1359
"6/9/2016 17:00","710",694,"19","13","wolkig",1404
"6/9/2016 18:00","714",714,"19","11","teilweise bewölkt",1428
"6/9/2016 19:00","562",587,"18","7","teilweise bewölkt",1149
"6/9/2016 20:00","370",477,"18","6","teilweise bewölkt",847
"6/9/2016 21:00","317",322,"14","0","Klarer Himmel",639
"6/9/2016 22:00","211",317,"13","6","Klarer Himmel",528
"6/9/2016 23:00","145",239,"12","11","Klarer Himmel",384
"6/10/2016 0:00","93",143,"11","11","Klarer Himmel",236
"6/10/2016 1:00","30",100,"10","6","Klarer Himmel",130
"6/10/2016 2:00","16",32,"9","6","Klarer Himmel",48
"6/10/2016 3:00","17",50,"9","4","Klarer Himmel",67
"6/10/2016 4:00","12",31,"9","6","Klarer Himmel",43
"6/10/2016 5:00","37",36,"9","4","Nebel",73
"6/10/2016 6:00","121",42,"9","6","",163
"6/10/2016 7:00","564",227,"11","7","teilweise bewölkt",791
"6/10/2016 8:00","636",434,"13","7","teilweise bewölkt",1070
"6/10/2016 9:00","511",340,"14","6","teilweise bewölkt",851
"6/10/2016 10:00","430",453,"16","7","teilweise bewölkt",883
"6/10/2016 11:00","505",287,"17","7","teilweise bewölkt",792
"6/10/2016 12:00","499",506,"18","9","Klarer Himmel",1005
"6/10/2016 13:00","526",539,"19","11","Klarer Himmel",1065
"6/10/2016 14:00","499",579,"20","11","Klarer Himmel",1078
"6/10/2016 15:00","533",443,"20","11","wolkig",976
"6/10/2016 16:00","525",436,"21","17","wolkig",961
"6/10/2016 17:00","558",449,"21","13","wolkig",1007
"6/10/2016 18:00","501",492,"21","11","wolkig",993
"6/10/2016 19:00","473",445,"20","11","wolkig",918
"6/10/2016 20:00","390",352,"18","13","wolkig",742
"6/10/2016 21:00","188",265,"17","9","Klarer Himmel",453
"6/10/2016 22:00","136",251,"16","11","Klarer Himmel",387
"6/10/2016 23:00","196",326,"15","7","Klarer Himmel",522
"6/11/2016 0:00","127",217,"14","9","Klarer Himmel",344
"6/11/2016 1:00","104",196,"12","4","Klarer Himmel",300
"6/11/2016 2:00","31",135,"12","6","Klarer Himmel",166
"6/11/2016 3:00","29",125,"12","6","Klarer Himmel",154
"6/11/2016 4:00","24",69,"12","6","Klarer Himmel",93
"6/11/2016 5:00","27",29,"12","6","Klarer Himmel",56
"6/11/2016 6:00","31",31,"12","4","Klarer Himmel",62
"6/11/2016 7:00","91",37,"13","7","Klarer Himmel",128
"6/11/2016 8:00","181",78,"14","6","Regen",259
"6/11/2016 9:00","302",139,"15","4","Regen",441
"6/11/2016 10:00","337",208,"16","6","Regen",545
"6/11/2016 11:00","319",205,"17","6","Regen",524
"6/11/2016 12:00","384",242,"18","4","wolkig",626
"6/11/2016 13:00","376",306,"20","4","wolkig",682
"6/11/2016 14:00","285",312,"20","6","wolkig",597
"6/11/2016 15:00","308",329,"21","7","wolkig",637
"6/11/2016 16:00","284",330,"21","11","wolkig",614
"6/11/2016 17:00","273",334,"21","9","wolkig",607
"6/11/2016 18:00","303",364,"21","7","Klarer Himmel",667
"6/11/2016 19:00","316",288,"20","11","Klarer Himmel",604
"6/11/2016 20:00","257",290,"19","6","Klarer Himmel",547
"6/11/2016 21:00","207",199,"18","4","Klarer Himmel",406
"6/11/2016 22:00","164",149,"17","4","Klarer Himmel",313
"6/11/2016 23:00","132",162,"14","2","Klarer Himmel",294
"6/12/2016 0:00","152",166,"14","0","Klarer Himmel",318
"6/12/2016 1:00","69",180,"13","2","Klarer Himmel",249
"6/12/2016 2:00","39",118,"12","0","Klarer Himmel",157
"6/12/2016 3:00","52",107,"12","0","Klarer Himmel",159
"6/12/2016 4:00","20",72,"12","0","Klarer Himmel",92
"6/12/2016 5:00","14",38,"12","0","Klarer Himmel",52
"6/12/2016 6:00","15",32,"13","0","Klarer Himmel",47
"6/12/2016 7:00","20",19,"16","0","Klarer Himmel",39
"6/12/2016 8:00","66",30,"17","0","wolkig",96
"6/12/2016 9:00","179",68,"18","0","wolkig",247
"6/12/2016 10:00","235",163,"20","4","wolkig",398
"6/12/2016 11:00","210",142,"19","9","wolkig",352
"6/12/2016 12:00","252",163,"19","9","wolkig",415
"6/12/2016 13:00","214",186,"20","9","wolkig",400
"6/12/2016 14:00","309",243,"22","6","wolkig",552
"6/12/2016 15:00","204",233,"20","9","Regen",437
"6/12/2016 16:00","142",138,"19","6","wolkig",280
"6/12/2016 17:00","164",219,"18","15","Regen",383
"6/12/2016 18:00","192",231,"17","13","Regen",423
"6/12/2016 19:00","309",232,"15","6","Regen",541
"6/12/2016 20:00","479",359,"15","6","wolkig",838
"6/12/2016 21:00","90",104,"15","6","wolkig",194
"6/12/2016 22:00","38",50,"15","4","wolkig",88
"6/12/2016 23:00","285",783,"14","4","wolkig",1068
"6/13/2016 0:00","54",91,"14","0","wolkig",145
"6/13/2016 1:00","11",37,"14","2","Regen",48
"6/13/2016 2:00","1",13,"14","4","wolkig",14
"6/13/2016 3:00","4",2,"15","6","Regen",6
"6/13/2016 4:00","5",4,"14","6","Regen",9
"6/13/2016 5:00","36",14,"14","4","Regen",50
"6/13/2016 6:00","71",38,"14","6","Regen",109
"6/13/2016 7:00","383",157,"15","6","Regen",540
"6/13/2016 8:00","569",401,"15","9","wolkig",970
"6/13/2016 9:00","401",392,"16","11","wolkig",793
"6/13/2016 10:00","351",388,"16","11","wolkig",739
"6/13/2016 11:00","325",302,"17","9","Regen",627
"6/13/2016 12:00","407",391,"18","11","wolkig",798
"6/13/2016 13:00","480",411,"19","7","wolkig",891
"6/13/2016 14:00","425",433,"15","11","Gewitter",858
"6/13/2016 15:00","445",449,"17","2","wolkig",894
"6/13/2016 16:00","520",474,"18","11","wolkig",994
"6/13/2016 17:00","593",649,"19","13","Regen",1242
"6/13/2016 18:00","566",613,"19","11","wolkig",1179
"6/13/2016 19:00","436",481,"19","19","teilweise bewölkt",917
"6/13/2016 20:00","288",426,"17","13","wolkig",714
"6/13/2016 21:00","156",274,"16","13","wolkig",430
"6/13/2016 22:00","107",214,"15","11","wolkig",321
"6/13/2016 23:00","75",205,"15","9","wolkig",280
"6/14/2016 0:00","28",73,"15","11","wolkig",101
"6/14/2016 1:00","16",23,"15","13","wolkig",39
"6/14/2016 2:00","12",10,"14","9","wolkig",22
"6/14/2016 3:00","6",5,"14","6","wolkig",11
"6/14/2016 4:00","10",8,"14","6","wolkig",18
"6/14/2016 5:00","34",20,"14","6","wolkig",54
"6/14/2016 6:00","66",22,"14","7","wolkig",88
"6/14/2016 7:00","356",174,"14","9","Regen",530
"6/14/2016 8:00","618",499,"14","9","wolkig",1117
"6/14/2016 9:00","455",414,"16","13","wolkig",869
"6/14/2016 10:00","507",535,"15","13","wolkig",1042
"6/14/2016 11:00","410",315,"16","15","wolkig",725
"6/14/2016 12:00","534",513,"17","15","wolkig",1047
"6/14/2016 13:00","527",452,"17","17","Regen",979
"6/14/2016 14:00","511",479,"18","17","wolkig",990
"6/14/2016 15:00","565",459,"18","17","teilweise bewölkt",1024
"6/14/2016 16:00","556",637,"19","9","teilweise bewölkt",1193
"6/14/2016 17:00","657",621,"19","11","wolkig",1278
"6/14/2016 18:00","596",675,"20","17","wolkig",1271
"6/14/2016 19:00","559",589,"19","9","wolkig",1148
"6/14/2016 20:00","378",506,"17","7","wolkig",884
"6/14/2016 21:00","227",320,"15","6","wolkig",547
"6/14/2016 22:00","197",236,"15","11","wolkig",433
"6/14/2016 23:00","112",194,"14","4","teilweise bewölkt",306
"6/15/2016 0:00","37",104,"13","6","teilweise bewölkt",141
"6/15/2016 1:00","22",69,"13","6","Nebel",91
"6/15/2016 2:00","17",14,"13","2","Nebel",31
"6/15/2016 3:00","21",8,"13","4","Nebel",29
"6/15/2016 4:00","8",7,"13","4","",15
"6/15/2016 5:00","42",15,"13","6","",57
"6/15/2016 6:00","126",40,"13","7","Klarer Himmel",166
"6/15/2016 7:00","561",224,"14","4","wolkig",785
"6/15/2016 8:00","690",536,"14","4","wolkig",1226
"6/15/2016 9:00","547",420,"15","7","wolkig",967
"6/15/2016 10:00","606",490,"16","9","wolkig",1096
"6/15/2016 11:00","431",421,"17","6","Regen",852
"6/15/2016 12:00","418",432,"13","9","Regen",850
"6/15/2016 13:00","477",442,"15","6","Regen",919
"6/15/2016 14:00","408",502,"17","4","Regen",910
"6/15/2016 15:00","504",440,"18","7","wolkig",944
"6/15/2016 16:00","552",596,"18","11","wolkig",1148
"6/15/2016 17:00","640",582,"18","11","Regen",1222
"6/15/2016 18:00","581",645,"17","13","wolkig",1226
"6/15/2016 19:00","501",537,"17","7","wolkig",1038
"6/15/2016 20:00","389",404,"16","11","wolkig",793
"6/15/2016 21:00","286",259,"15","9","wolkig",545
"6/15/2016 22:00","172",248,"14","4","wolkig",420
"6/15/2016 23:00","157",242,"14","6","Klarer Himmel",399
"6/16/2016 0:00","96",160,"13","6","Klarer Himmel",256
"6/16/2016 1:00","68",129,"13","6","Klarer Himmel",197
"6/16/2016 2:00","23",76,"13","7","Klarer Himmel",99
"6/16/2016 3:00","20",45,"12","4","Klarer Himmel",65
"6/16/2016 4:00","19",48,"10","4","Nebel",67
"6/16/2016 5:00","41",38,"10","6","Nebel",79
"6/16/2016 6:00","119",46,"12","7","Nebel",165
"6/16/2016 7:00","512",260,"12","9","wolkig",772
"6/16/2016 8:00","583",550,"15","4","wolkig",1133
"6/16/2016 9:00","519",422,"17","4","teilweise bewölkt",941
"6/16/2016 10:00","578",466,"18","4","wolkig",1044
"6/16/2016 11:00","485",412,"19","6","wolkig",897
"6/16/2016 12:00","551",536,"19","7","wolkig",1087
"6/16/2016 13:00","524",533,"20","7","wolkig",1057
"6/16/2016 14:00","597",620,"20","4","wolkig",1217
"6/16/2016 15:00","589",571,"20","4","wolkig",1160
"6/16/2016 16:00","691",623,"20","6","Regen",1314
"6/16/2016 17:00","599",646,"20","7","Gewitter",1245
"6/16/2016 18:00","604",617,"17","13","Regen",1221
"6/16/2016 19:00","639",414,"17","11","Regen",1053
"6/16/2016 20:00","678",566,"16","7","wolkig",1244
"6/16/2016 21:00","134",173,"15","6","wolkig",307
"6/16/2016 22:00","82",104,"14","4","Klarer Himmel",186
"6/16/2016 23:00","464",939,"13","2","Klarer Himmel",1403
"6/17/2016 0:00","76",207,"13","2","wolkig",283
"6/17/2016 1:00","32",99,"14","2","wolkig",131
"6/17/2016 2:00","7",53,"14","0","wolkig",60
"6/17/2016 3:00","13",25,"14","2","wolkig",38
"6/17/2016 4:00","11",27,"14","4","Regen",38
"6/17/2016 5:00","31",24,"13","4","Nebel",55
"6/17/2016 6:00","115",50,"14","4","wolkig",165
"6/17/2016 7:00","422",211,"15","7","teilweise bewölkt",633
"6/17/2016 8:00","551",373,"15","11","wolkig",924
"6/17/2016 9:00","390",313,"16","9","teilweise bewölkt",703
"6/17/2016 10:00","294",348,"15","13","Regen",642
"6/17/2016 11:00","374",274,"15","11","Regen",648
"6/17/2016 12:00","453",337,"15","13","Regen",790
"6/17/2016 13:00","439",443,"16","9","Regen",882
"6/17/2016 14:00","364",413,"16","11","wolkig",777
"6/17/2016 15:00","424",355,"16","15","wolkig",779
"6/17/2016 16:00","307",325,"17","15","wolkig",632
"6/17/2016 17:00","429",376,"18","17","teilweise bewölkt",805
"6/17/2016 18:00","378",359,"17","11","Regen",737
"6/17/2016 19:00","332",360,"17","13","Klarer Himmel",692
"6/17/2016 20:00","277",263,"17","7","Klarer Himmel",540
"6/17/2016 21:00","179",172,"16","7","wolkig",351
"6/17/2016 22:00","150",190,"15","7","Klarer Himmel",340
"6/17/2016 23:00","131",213,"14","6","Klarer Himmel",344
"6/18/2016 0:00","101",168,"15","7","Klarer Himmel",269
"6/18/2016 1:00","70",145,"13","6","wolkig",215
"6/18/2016 2:00","50",96,"14","7","teilweise bewölkt",146
"6/18/2016 3:00","27",98,"14","7","wolkig",125
"6/18/2016 4:00","35",56,"14","6","wolkig",91
"6/18/2016 5:00","29",53,"13","7","wolkig",82
"6/18/2016 6:00","53",28,"13","4","Regen",81
"6/18/2016 7:00","125",29,"14","7","Regen",154
"6/18/2016 8:00","165",63,"15","6","wolkig",228
"6/18/2016 9:00","278",93,"15","4","wolkig",371
"6/18/2016 10:00","362",165,"16","6","wolkig",527
"6/18/2016 11:00","341",164,"16","9","Regen",505
"6/18/2016 12:00","295",240,"15","9","wolkig",535
"6/18/2016 13:00","287",234,"16","15","Regen",521
"6/18/2016 14:00","270",271,"16","13","Regen",541
"6/18/2016 15:00","274",266,"18","9","wolkig",540
"6/18/2016 16:00","280",287,"18","9","Regen",567
"6/18/2016 17:00","146",242,"15","9","wolkig",388
"6/18/2016 18:00","168",272,"15","9","wolkig",440
"6/18/2016 19:00","210",236,"16","11","wolkig",446
"6/18/2016 20:00","139",146,"15","13","Regen",285
"6/18/2016 21:00","157",136,"14","9","wolkig",293
"6/18/2016 22:00","116",143,"14","15","wolkig",259
"6/18/2016 23:00","111",125,"14","11","wolkig",236
"6/19/2016 0:00","84",105,"14","11","Regen",189
"6/19/2016 1:00","68",161,"13","7","Regen",229
"6/19/2016 2:00","29",109,"13","11","wolkig",138
"6/19/2016 3:00","27",77,"12","15","Regen",104
"6/19/2016 4:00","29",61,"12","9","wolkig",90
"6/19/2016 5:00","15",36,"12","11","wolkig",51
"6/19/2016 6:00","19",21,"12","9","wolkig",40
"6/19/2016 7:00","25",22,"12","13","wolkig",47
"6/19/2016 8:00","59",40,"13","11","wolkig",99
"6/19/2016 9:00","151",67,"14","9","teilweise bewölkt",218
"6/19/2016 10:00","187",112,"14","13","wolkig",299
"6/19/2016 11:00","177",163,"14","13","wolkig",340
"6/19/2016 12:00","176",170,"14","13","Regen",346
"6/19/2016 13:00","236",182,"17","7","teilweise bewölkt",418
"6/19/2016 14:00","306",240,"16","15","wolkig",546
"6/19/2016 15:00","274",257,"18","9","teilweise bewölkt",531
"6/19/2016 16:00","284",236,"18","13","teilweise bewölkt",520
"6/19/2016 17:00","351",285,"18","7","teilweise bewölkt",636
"6/19/2016 18:00","257",280,"18","7","teilweise bewölkt",537
"6/19/2016 19:00","197",261,"17","6","teilweise bewölkt",458
"6/19/2016 20:00","167",264,"16","6","teilweise bewölkt",431
"6/19/2016 21:00","104",165,"14","9","teilweise bewölkt",269
"6/19/2016 22:00","65",145,"11","4","Klarer Himmel",210
"6/19/2016 23:00","48",121,"11","4","Klarer Himmel",169
"6/20/2016 0:00","40",46,"10","4","Klarer Himmel",86
"6/20/2016 1:00","21",27,"9","2","Nebel",48
"6/20/2016 2:00","5",8,"9","4","Nebel",13
"6/20/2016 3:00","3",7,"9","4","Nebel",10
"6/20/2016 4:00","5",3,"9","7","teilweise bewölkt",8
"6/20/2016 5:00","37",21,"9","6","teilweise bewölkt",58
"6/20/2016 6:00","130",38,"10","11","Klarer Himmel",168
"6/20/2016 7:00","514",204,"13","11","Klarer Himmel",718
"6/20/2016 8:00","636",458,"16","19","wolkig",1094
"6/20/2016 9:00","459",398,"18","22","wolkig",857
"6/20/2016 10:00","500",488,"19","22","wolkig",988
"6/20/2016 11:00","423",403,"19","26","wolkig",826
"6/20/2016 12:00","516",562,"20","26","wolkig",1078
"6/20/2016 13:00","471",486,"19","22","Regen",957
"6/20/2016 14:00","531",546,"20","15","Regen",1077
"6/20/2016 15:00","575",533,"20","19","Regen",1108
"6/20/2016 16:00","540",576,"19","13","Regen",1116
"6/20/2016 17:00","687",676,"18","11","Regen",1363
"6/20/2016 18:00","407",608,"17","15","Regen",1015
"6/20/2016 19:00","327",380,"16","13","Regen",707
"6/20/2016 20:00","212",290,"16","20","Regen",502
"6/20/2016 21:00","140",215,"15","17","Regen",355
"6/20/2016 22:00","105",186,"15","17","Regen",291
"6/20/2016 23:00","59",121,"15","15","Regen",180
"6/21/2016 0:00","39",43,"16","17","wolkig",82
"6/21/2016 1:00","20",25,"16","19","wolkig",45
"6/21/2016 2:00","12",5,"15","11","wolkig",17
"6/21/2016 3:00","4",5,"15","13","wolkig",9
"6/21/2016 4:00","8",5,"15","9","wolkig",13
"6/21/2016 5:00","34",12,"15","9","wolkig",46
"6/21/2016 6:00","101",33,"16","9","Regen",134
"6/21/2016 7:00","425",220,"16","13","wolkig",645
"6/21/2016 8:00","643",455,"17","17","wolkig",1098
"6/21/2016 9:00","468",427,"17","13","wolkig",895
"6/21/2016 10:00","539",466,"17","15","wolkig",1005
"6/21/2016 11:00","454",399,"18","13","wolkig",853
"6/21/2016 12:00","525",535,"19","15","wolkig",1060
"6/21/2016 13:00","492",481,"19","13","wolkig",973
"6/21/2016 14:00","568",542,"19","13","wolkig",1110
"6/21/2016 15:00","544",570,"20","9","wolkig",1114
"6/21/2016 16:00","784",689,"21","7","wolkig",1473
"6/21/2016 17:00","1283",965,"21","11","Regen",2248
"6/21/2016 18:00","322",409,"20","11","Regen",731
"6/21/2016 19:00","222",244,"20","7","wolkig",466
"6/21/2016 20:00","544",897,"19","4","wolkig",1441
"6/21/2016 21:00","289",358,"19","2","wolkig",647
"6/21/2016 22:00","192",366,"18","7","wolkig",558
"6/21/2016 23:00","134",279,"18","9","wolkig",413
"6/22/2016 0:00","49",107,"18","7","wolkig",156
"6/22/2016 1:00","36",72,"18","9","wolkig",108
"6/22/2016 2:00","9",20,"18","9","Regen",29
"6/22/2016 3:00","14",13,"18","7","wolkig",27
"6/22/2016 4:00","10",13,"17","9","wolkig",23
"6/22/2016 5:00","40",18,"17","7","teilweise bewölkt",58
"6/22/2016 6:00","146",44,"17","6","wolkig",190
"6/22/2016 7:00","651",232,"18","7","wolkig",883
"6/22/2016 8:00","754",577,"18","11","wolkig",1331
"6/22/2016 9:00","583",424,"19","13","teilweise bewölkt",1007
"6/22/2016 10:00","606",554,"21","17","teilweise bewölkt",1160
"6/22/2016 11:00","551",438,"21","13","teilweise bewölkt",989
"6/22/2016 12:00","558",574,"22","17","wolkig",1132
"6/22/2016 13:00","639",543,"24","17","wolkig",1182
"6/22/2016 14:00","685",709,"24","17","teilweise bewölkt",1394
"6/22/2016 15:00","625",651,"24","13","wolkig",1276
"6/22/2016 16:00","757",885,"24","15","wolkig",1642
"6/22/2016 17:00","801",811,"24","7","wolkig",1612
"6/22/2016 18:00","803",878,"24","7","teilweise bewölkt",1681
"6/22/2016 19:00","668",610,"24","6","teilweise bewölkt",1278
"6/22/2016 20:00","551",465,"23","4","Klarer Himmel",1016
"6/22/2016 21:00","416",341,"21","4","Klarer Himmel",757
"6/22/2016 22:00","244",369,"19","2","Klarer Himmel",613
"6/22/2016 23:00","174",301,"19","6","teilweise bewölkt",475
"6/23/2016 0:00","193",167,"19","4","teilweise bewölkt",360
"6/23/2016 1:00","75",124,"17","4","Klarer Himmel",199
"6/23/2016 2:00","18",95,"16","4","Klarer Himmel",113
"6/23/2016 3:00","31",84,"18","4","wolkig",115
"6/23/2016 4:00","22",85,"18","6","wolkig",107
"6/23/2016 5:00","54",86,"18","6","Klarer Himmel",140
"6/23/2016 6:00","141",51,"19","4","teilweise bewölkt",192
"6/23/2016 7:00","511",262,"21","9","Klarer Himmel",773
"6/23/2016 8:00","603",514,"23","9","Klarer Himmel",1117
"6/23/2016 9:00","594",407,"25","13","Klarer Himmel",1001
"6/23/2016 10:00","546",447,"27","13","Klarer Himmel",993
"6/23/2016 11:00","510",435,"28","15","Klarer Himmel",945
"6/23/2016 12:00","583",587,"29","19","teilweise bewölkt",1170
"6/23/2016 13:00","614",590,"31","19","teilweise bewölkt",1204
"6/23/2016 14:00","640",602,"31","15","Klarer Himmel",1242
"6/23/2016 15:00","733",636,"32","17","Klarer Himmel",1369
"6/23/2016 16:00","809",669,"32","15","Klarer Himmel",1478
"6/23/2016 17:00","927",655,"33","7","Klarer Himmel",1582
"6/23/2016 18:00","579",621,"28","4","Gewitter",1200
"6/23/2016 19:00","630",439,"20","15","Gewitter",1069
"6/23/2016 20:00","506",319,"21","15","Gewitter",825
"6/23/2016 21:00","250",225,"21","11","wolkig",475
"6/23/2016 22:00","143",327,"21","6","wolkig",470
"6/23/2016 23:00","110",650,"21","28","Regen",760
"6/24/2016 0:00","36",205,"20","13","Gewitter",241
"6/24/2016 1:00","30",158,"20","11","teilweise bewölkt",188
"6/24/2016 2:00","13",58,"19","9","teilweise bewölkt",71
"6/24/2016 3:00","10",20,"19","6","Gewitter",30
"6/24/2016 4:00","9",21,"19","4","Gewitter",30
"6/24/2016 5:00","15",16,"19","15","Gewitter",31
"6/24/2016 6:00","97",41,"19","6","Gewitter",138
"6/24/2016 7:00","351",139,"20","6","Regen",490
"6/24/2016 8:00","299",282,"19","9","Regen",581
"6/24/2016 9:00","362",280,"22","4","teilweise bewölkt",642
"6/24/2016 10:00","376",325,"22","6","Klarer Himmel",701
"6/24/2016 11:00","435",279,"25","6","Klarer Himmel",714
"6/24/2016 12:00","443",367,"27","4","teilweise bewölkt",810
"6/24/2016 13:00","421",436,"27","6","wolkig",857
"6/24/2016 14:00","399",407,"25","11","wolkig",806
"6/24/2016 15:00","428",339,"25","20","wolkig",767
"6/24/2016 16:00","389",351,"24","19","wolkig",740
"6/24/2016 17:00","483",367,"23","15","wolkig",850
"6/24/2016 18:00","391",435,"23","13","wolkig",826
"6/24/2016 19:00","411",334,"22","9","wolkig",745
"6/24/2016 20:00","354",270,"22","6","wolkig",624
"6/24/2016 21:00","273",197,"21","6","wolkig",470
"6/24/2016 22:00","224",268,"20","7","wolkig",492
"6/24/2016 23:00","184",384,"19","2","teilweise bewölkt",568
"6/25/2016 0:00","101",238,"18","4","wolkig",339
"6/25/2016 1:00","92",115,"18","0","teilweise bewölkt",207
"6/25/2016 2:00","50",119,"18","7","teilweise bewölkt",169
"6/25/2016 3:00","39",100,"18","7","wolkig",139
"6/25/2016 4:00","32",63,"18","7","wolkig",95
"6/25/2016 5:00","27",36,"18","6","wolkig",63
"6/25/2016 6:00","40",22,"18","4","wolkig",62
"6/25/2016 7:00","80",26,"18","9","wolkig",106
"6/25/2016 8:00","125",48,"18","6","Regen",173
"6/25/2016 9:00","132",59,"17","28","Regen",191
"6/25/2016 10:00","100",48,"17","4","Regen",148
"6/25/2016 11:00","110",105,"17","9","Regen",215
"6/25/2016 12:00","116",94,"17","15","Regen",210
"6/25/2016 13:00","98",117,"16","11","Regen",215
"6/25/2016 14:00","125",140,"16","11","Regen",265
"6/25/2016 15:00","106",111,"16","15","Regen",217
"6/25/2016 16:00","127",146,"15","15","Regen",273
"6/25/2016 17:00","157",126,"15","17","Regen",283
"6/25/2016 18:00","173",162,"15","9","Regen",335
"6/25/2016 19:00","205",162,"15","6","Regen",367
"6/25/2016 20:00","199",150,"15","4","Regen",349
"6/25/2016 21:00","156",110,"15","13","wolkig",266
"6/25/2016 22:00","133",112,"14","11","wolkig",245
"6/25/2016 23:00","103",156,"15","9","wolkig",259
"6/26/2016 0:00","93",158,"14","7","teilweise bewölkt",251
"6/26/2016 1:00","76",98,"14","13","wolkig",174
"6/26/2016 2:00","28",103,"14","7","teilweise bewölkt",131
"6/26/2016 3:00","40",75,"13","9","teilweise bewölkt",115
"6/26/2016 4:00","16",52,"12","7","Nebel",68
"6/26/2016 5:00","15",36,"12","7","teilweise bewölkt",51
"6/26/2016 6:00","16",15,"12","11","teilweise bewölkt",31
"6/26/2016 7:00","32",17,"13","9","teilweise bewölkt",49
"6/26/2016 8:00","67",37,"15","17","wolkig",104
"6/26/2016 9:00","177",58,"15","17","wolkig",235
"6/26/2016 10:00","199",109,"16","22","wolkig",308
"6/26/2016 11:00","240",119,"17","24","teilweise bewölkt",359
"6/26/2016 12:00","246",221,"17","20","wolkig",467
"6/26/2016 13:00","249",180,"18","19","teilweise bewölkt",429
"6/26/2016 14:00","300",265,"18","15","wolkig",565
"6/26/2016 15:00","343",292,"20","17","wolkig",635
"6/26/2016 16:00","358",343,"13","7","Regen",701
"6/26/2016 17:00","645",483,"17","9","teilweise bewölkt",1128
"6/26/2016 18:00","170",150,"17","9","teilweise bewölkt",320
"6/26/2016 19:00","117",142,"18","13","teilweise bewölkt",259
"6/26/2016 20:00","360",537,"17","13","teilweise bewölkt",897
"6/26/2016 21:00","171",322,"16","9","teilweise bewölkt",493
"6/26/2016 22:00","75",185,"15","9","teilweise bewölkt",260
"6/26/2016 23:00","82",172,"15","7","Klarer Himmel",254
"6/27/2016 0:00","33",73,"14","9","Klarer Himmel",106
"6/27/2016 1:00","9",25,"13","9","teilweise bewölkt",34
"6/27/2016 2:00","8",17,"13","7","teilweise bewölkt",25
"6/27/2016 3:00","7",4,"13","9","teilweise bewölkt",11
"6/27/2016 4:00","10",10,"12","9","Klarer Himmel",20
"6/27/2016 5:00","40",21,"12","9","",61
"6/27/2016 6:00","116",35,"13","13","",151
"6/27/2016 7:00","451",206,"14","20","teilweise bewölkt",657
"6/27/2016 8:00","593",420,"15","22","teilweise bewölkt",1013
"6/27/2016 9:00","459",342,"16","22","teilweise bewölkt",801
"6/27/2016 10:00","423",426,"17","20","wolkig",849
"6/27/2016 11:00","410",376,"19","19","wolkig",786
"6/27/2016 12:00","488",476,"18","26","wolkig",964
"6/27/2016 13:00","537",510,"19","24","wolkig",1047
"6/27/2016 14:00","470",513,"18","22","wolkig",983
"6/27/2016 15:00","623",547,"18","20","wolkig",1170
"6/27/2016 16:00","568",615,"16","15","Regen",1183
"6/27/2016 17:00","718",704,"17","15","wolkig",1422
"6/27/2016 18:00","508",627,"17","9","Regen",1135
"6/27/2016 19:00","360",413,"17","9","Regen",773
"6/27/2016 20:00","266",304,"15","6","wolkig",570
"6/27/2016 21:00","175",222,"15","9","teilweise bewölkt",397
"6/27/2016 22:00","129",236,"14","11","teilweise bewölkt",365
"6/27/2016 23:00","73",136,"13","7","Klarer Himmel",209
"6/28/2016 0:00","41",89,"12","7","Nebel",130
"6/28/2016 1:00","9",43,"11","4","Nebel",52
"6/28/2016 2:00","6",11,"11","0","Nebel",17
"6/28/2016 3:00","13",8,"10","2","Nebel",21
"6/28/2016 4:00","12",3,"10","2","Nebel",15
"6/28/2016 5:00","35",22,"10","2","Nebel",57
"6/28/2016 6:00","131",40,"11","4","Nebel",171
"6/28/2016 7:00","470",220,"13","4","teilweise bewölkt",690
"6/28/2016 8:00","742",499,"15","6","teilweise bewölkt",1241
"6/28/2016 9:00","568",494,"16","7","teilweise bewölkt",1062
"6/28/2016 10:00","588",520,"17","6","teilweise bewölkt",1108
"6/28/2016 11:00","451",414,"19","4","teilweise bewölkt",865
"6/28/2016 12:00","569",632,"20","9","teilweise bewölkt",1201
"6/28/2016 13:00","595",554,"20","9","teilweise bewölkt",1149
"6/28/2016 14:00","588",567,"21","7","wolkig",1155
"6/28/2016 15:00","617",516,"21","11","wolkig",1133
"6/28/2016 16:00","701",676,"21","7","wolkig",1377
"6/28/2016 17:00","742",738,"21","7","wolkig",1480
"6/28/2016 18:00","704",750,"21","7","wolkig",1454
"6/28/2016 19:00","612",635,"21","7","teilweise bewölkt",1247
"6/28/2016 20:00","376",420,"20","6","Klarer Himmel",796
"6/28/2016 21:00","253",366,"19","4","Klarer Himmel",619
"6/28/2016 22:00","176",358,"18","6","Klarer Himmel",534
"6/28/2016 23:00","121",248,"18","7","Klarer Himmel",369
"6/29/2016 0:00","60",160,"17","7","Klarer Himmel",220
"6/29/2016 1:00","30",73,"17","7","wolkig",103
"6/29/2016 2:00","15",22,"15","9","Regen",37
"6/29/2016 3:00","8",10,"15","9","Regen",18
"6/29/2016 4:00","7",5,"15","13","Regen",12
"6/29/2016 5:00","45",22,"14","9","",67
"6/29/2016 6:00","140",46,"15","13","teilweise bewölkt",186
"6/29/2016 7:00","623",242,"15","19","teilweise bewölkt",865
"6/29/2016 8:00","721",552,"16","24","wolkig",1273
"6/29/2016 9:00","584",381,"16","24","wolkig",965
"6/29/2016 10:00","585",520,"16","26","wolkig",1105
"6/29/2016 11:00","476",389,"17","24","teilweise bewölkt",865
"6/29/2016 12:00","514",496,"17","20","wolkig",1010
"6/29/2016 13:00","577",470,"18","19","wolkig",1047
"6/29/2016 14:00","510",525,"19","26","teilweise bewölkt",1035
"6/29/2016 15:00","524",523,"20","26","teilweise bewölkt",1047
"6/29/2016 16:00","637",636,"21","22","wolkig",1273
"6/29/2016 17:00","684",646,"20","20","wolkig",1330
"6/29/2016 18:00","595",691,"20","19","wolkig",1286
"6/29/2016 19:00","567",531,"20","11","Klarer Himmel",1098
"6/29/2016 20:00","388",474,"19","9","Klarer Himmel",862
"6/29/2016 21:00","259",292,"18","6","Klarer Himmel",551
"6/29/2016 22:00","230",281,"17","7","Klarer Himmel",511
"6/29/2016 23:00","143",257,"16","6","Klarer Himmel",400
"6/30/2016 0:00","105",212,"15","6","Klarer Himmel",317
"6/30/2016 1:00","55",147,"16","9","Klarer Himmel",202
"6/30/2016 2:00","42",85,"16","7","Klarer Himmel",127
"6/30/2016 3:00","22",32,"16","9","Klarer Himmel",54
"6/30/2016 4:00","15",26,"17","13","Klarer Himmel",41
"6/30/2016 5:00","49",35,"17","11","Klarer Himmel",84
"6/30/2016 6:00","118",35,"16","9","wolkig",153
"6/30/2016 7:00","403",208,"16","11","wolkig",611
"6/30/2016 8:00","600",452,"16","15","wolkig",1052
"6/30/2016 9:00","492",362,"17","19","wolkig",854
"6/30/2016 10:00","580",431,"17","19","wolkig",1011
"6/30/2016 11:00","457",369,"17","17","wolkig",826
"6/30/2016 12:00","495",495,"18","20","Regen",990
"6/30/2016 13:00","513",487,"19","20","wolkig",1000
"6/30/2016 14:00","528",514,"19","20","wolkig",1042
"6/30/2016 15:00","622",545,"19","15","Regen",1167
"6/30/2016 16:00","556",577,"19","20","Regen",1133
"6/30/2016 17:00","576",545,"19","13","wolkig",1121
"6/30/2016 18:00","598",614,"20","17","wolkig",1212
"6/30/2016 19:00","478",468,"20","13","wolkig",946
"6/30/2016 20:00","311",453,"20","15","wolkig",764
"6/30/2016 21:00","204",236,"19","15","wolkig",440
"6/30/2016 22:00","162",224,"18","15","wolkig",386
"6/30/2016 23:00","134",159,"17","13","Klarer Himmel",293
"7/1/2016 0:00","73",204,"17","9","wolkig",277
"7/1/2016 1:00","23",58,"17","13","wolkig",81
"7/1/2016 2:00","17",35,"16","9","wolkig",52
"7/1/2016 3:00","21",23,"16","11","wolkig",44
"7/1/2016 4:00","13",9,"16","11","Klarer Himmel",22
"7/1/2016 5:00","31",26,"16","11","wolkig",57
"7/1/2016 6:00","110",39,"17","13","wolkig",149
"7/1/2016 7:00","440",202,"18","15","wolkig",642
"7/1/2016 8:00","582",389,"19","19","wolkig",971
"7/1/2016 9:00","454",332,"20","17","wolkig",786
"7/1/2016 10:00","373",341,"17","20","Regen",714
"7/1/2016 11:00","443",294,"17","17","wolkig",737
"7/1/2016 12:00","480",384,"20","22","wolkig",864
"7/1/2016 13:00","449",467,"20","19","wolkig",916
"7/1/2016 14:00","446",494,"20","17","wolkig",940
"7/1/2016 15:00","398",415,"20","20","Regen",813
"7/1/2016 16:00","408",394,"21","19","wolkig",802
"7/1/2016 17:00","448",403,"21","19","wolkig",851
"7/1/2016 18:00","448",382,"22","22","wolkig",830
"7/1/2016 19:00","472",328,"21","17","wolkig",800
"7/1/2016 20:00","336",303,"20","13","Klarer Himmel",639
"7/1/2016 21:00","211",222,"19","15","wolkig",433
"7/1/2016 22:00","137",254,"19","13","Klarer Himmel",391
"7/1/2016 23:00","158",268,"19","15","wolkig",426
"7/2/2016 0:00","106",190,"17","20","Regen",296
"7/2/2016 1:00","56",146,"16","11","Regen",202
"7/2/2016 2:00","35",115,"16","11","Regen",150
"7/2/2016 3:00","19",59,"15","11","Regen",78
"7/2/2016 4:00","13",42,"14","32","Regen",55
"7/2/2016 5:00","27",24,"14","15","Regen",51
"7/2/2016 6:00","30",19,"14","17","wolkig",49
"7/2/2016 7:00","79",27,"14","20","wolkig",106
"7/2/2016 8:00","132",79,"14","19","wolkig",211
"7/2/2016 9:00","294",136,"15","22","wolkig",430
"7/2/2016 10:00","360",135,"15","19","wolkig",495
"7/2/2016 11:00","375",191,"14","20","Regen",566
"7/2/2016 12:00","391",225,"17","22","teilweise bewölkt",616
"7/2/2016 13:00","369",267,"15","22","Regen",636
"7/2/2016 14:00","270",305,"19","22","teilweise bewölkt",575
"7/2/2016 15:00","306",326,"14","6","Regen",632
"7/2/2016 16:00","286",318,"16","15","teilweise bewölkt",604
"7/2/2016 17:00","216",279,"15","26","Regen",495
"7/2/2016 18:00","305",389,"16","17","teilweise bewölkt",694
"7/2/2016 19:00","487",288,"16","19","teilweise bewölkt",775
"7/2/2016 20:00","613",326,"15","13","teilweise bewölkt",939
"7/2/2016 21:00","81",104,"14","11","teilweise bewölkt",185
"7/2/2016 22:00","39",91,"13","11","teilweise bewölkt",130
"7/2/2016 23:00","36",119,"13","9","Klarer Himmel",155
"7/3/2016 0:00","297",618,"12","9","Klarer Himmel",915
"7/3/2016 1:00","83",273,"12","9","teilweise bewölkt",356
"7/3/2016 2:00","52",144,"11","9","teilweise bewölkt",196
"7/3/2016 3:00","28",130,"11","11","Klarer Himmel",158
"7/3/2016 4:00","28",59,"11","11","teilweise bewölkt",87
"7/3/2016 5:00","25",37,"11","9","teilweise bewölkt",62
"7/3/2016 6:00","19",24,"11","11","teilweise bewölkt",43
"7/3/2016 7:00","24",27,"13","17","wolkig",51
"7/3/2016 8:00","37",27,"13","19","Regen",64
"7/3/2016 9:00","127",58,"13","15","wolkig",185
"7/3/2016 10:00","218",91,"15","13","wolkig",309
"7/3/2016 11:00","183",114,"17","15","teilweise bewölkt",297
"7/3/2016 12:00","254",148,"15","7","Gewitter",402
"7/3/2016 13:00","297",171,"19","19","teilweise bewölkt",468
"7/3/2016 14:00","256",219,"17","28","teilweise bewölkt",475
"7/3/2016 15:00","243",240,"18","19","wolkig",483
"7/3/2016 16:00","299",297,"19","19","teilweise bewölkt",596
"7/3/2016 17:00","363",318,"19","17","teilweise bewölkt",681
"7/3/2016 18:00","277",321,"19","15","teilweise bewölkt",598
"7/3/2016 19:00","206",267,"16","11","teilweise bewölkt",473
"7/3/2016 20:00","156",264,"16","9","wolkig",420
"7/3/2016 21:00","90",178,"14","6","teilweise bewölkt",268
"7/3/2016 22:00","76",133,"13","6","teilweise bewölkt",209
"7/3/2016 23:00","69",158,"12","2","Klarer Himmel",227
"7/4/2016 0:00","28",42,"11","2","Nebel",70
"7/4/2016 1:00","17",23,"10","2","Nebel",40
"7/4/2016 2:00","9",11,"11","2","Nebel",20
"7/4/2016 3:00","6",5,"11","2","Nebel",11
"7/4/2016 4:00","9",1,"10","2","Nebel",10
"7/4/2016 5:00","32",17,"11","2","Klarer Himmel",49
"7/4/2016 6:00","116",34,"12","2","Klarer Himmel",150
"7/4/2016 7:00","478",197,"13","4","Klarer Himmel",675
"7/4/2016 8:00","586",444,"15","6","Klarer Himmel",1030
"7/4/2016 9:00","466",338,"18","6","wolkig",804
"7/4/2016 10:00","507",417,"19","7","teilweise bewölkt",924
"7/4/2016 11:00","483",331,"20","9","teilweise bewölkt",814
"7/4/2016 12:00","493",544,"20","11","teilweise bewölkt",1037
"7/4/2016 13:00","505",488,"21","9","teilweise bewölkt",993
"7/4/2016 14:00","568",473,"22","9","teilweise bewölkt",1041
"7/4/2016 15:00","574",493,"22","9","teilweise bewölkt",1067
"7/4/2016 16:00","615",708,"22","11","teilweise bewölkt",1323
"7/4/2016 17:00","720",783,"22","11","teilweise bewölkt",1503
"7/4/2016 18:00","632",721,"22","11","teilweise bewölkt",1353
"7/4/2016 19:00","481",557,"21","6","wolkig",1038
"7/4/2016 20:00","341",472,"20","9","teilweise bewölkt",813
"7/4/2016 21:00","216",252,"18","6","Klarer Himmel",468
"7/4/2016 22:00","161",301,"17","2","Klarer Himmel",462
"7/4/2016 23:00","112",198,"15","2","Klarer Himmel",310
"7/5/2016 0:00","48",91,"15","4","wolkig",139
"7/5/2016 1:00","29",62,"14","2","Klarer Himmel",91
"7/5/2016 2:00","19",23,"13","2","Nebel",42
"7/5/2016 3:00","9",8,"13","6","Nebel",17
"7/5/2016 4:00","11",1,"13","2","Nebel",12
"7/5/2016 5:00","30",21,"14","6","wolkig",51
"7/5/2016 6:00","119",39,"15","6","Klarer Himmel",158
"7/5/2016 7:00","464",243,"17","15","Klarer Himmel",707
"7/5/2016 8:00","757",454,"18","20","",1211
"7/5/2016 9:00","595",623,"19","26","teilweise bewölkt",1218
"7/5/2016 10:00","576",483,"19","20","wolkig",1059
"7/5/2016 11:00","428",405,"19","26","wolkig",833
"7/5/2016 12:00","515",511,"18","28","wolkig",1026
"7/5/2016 13:00","477",484,"17","26","Regen",961
"7/5/2016 14:00","490",496,"19","22","wolkig",986
"7/5/2016 15:00","491",502,"19","26","wolkig",993
"7/5/2016 16:00","617",671,"19","28","wolkig",1288
"7/5/2016 17:00","699",678,"19","35","teilweise bewölkt",1377
"7/5/2016 18:00","595",658,"18","41","teilweise bewölkt",1253
"7/5/2016 19:00","610",518,"16","35","wolkig",1128
"7/5/2016 20:00","303",461,"15","26","wolkig",764
"7/5/2016 21:00","266",370,"14","24","wolkig",636
"7/5/2016 22:00","141",328,"14","19","wolkig",469
"7/5/2016 23:00","93",170,"14","20","wolkig",263
"7/6/2016 0:00","37",144,"13","17","wolkig",181
"7/6/2016 1:00","24",80,"13","17","wolkig",104
"7/6/2016 2:00","26",7,"13","17","wolkig",33
"7/6/2016 3:00","19",9,"12","15","wolkig",28
"7/6/2016 4:00","11",6,"12","15","wolkig",17
"7/6/2016 5:00","27",25,"12","13","teilweise bewölkt",52
"7/6/2016 6:00","144",48,"12","17","teilweise bewölkt",192
"7/6/2016 7:00","511",238,"13","19","teilweise bewölkt",749
"7/6/2016 8:00","806",460,"15","20","teilweise bewölkt",1266
"7/6/2016 9:00","606",390,"15","22","teilweise bewölkt",996
"7/6/2016 10:00","551",501,"16","20","teilweise bewölkt",1052
"7/6/2016 11:00","559",424,"16","17","wolkig",983
"7/6/2016 12:00","559",594,"17","17","wolkig",1153
"7/6/2016 13:00","491",581,"19","22","teilweise bewölkt",1072
"7/6/2016 14:00","502",590,"19","19","teilweise bewölkt",1092
"7/6/2016 15:00","576",555,"20","22","teilweise bewölkt",1131
"7/6/2016 16:00","651",742,"19","22","teilweise bewölkt",1393
"7/6/2016 17:00","711",709,"19","20","teilweise bewölkt",1420
"7/6/2016 18:00","645",650,"19","19","teilweise bewölkt",1295
"7/6/2016 19:00","551",558,"19","17","teilweise bewölkt",1109
"7/6/2016 20:00","443",459,"17","13","teilweise bewölkt",902
"7/6/2016 21:00","248",314,"15","9","wolkig",562
"7/6/2016 22:00","166",257,"14","9","Klarer Himmel",423
"7/6/2016 23:00","122",327,"13","9","Klarer Himmel",449
"7/7/2016 0:00","76",139,"13","6","Klarer Himmel",215
"7/7/2016 1:00","34",97,"11","6","Klarer Himmel",131
"7/7/2016 2:00","14",56,"10","2","Klarer Himmel",70
"7/7/2016 3:00","4",48,"9","2","Klarer Himmel",52
"7/7/2016 4:00","11",21,"9","4","Nebel",32
"7/7/2016 5:00","38",35,"8","0","Nebel",73
"7/7/2016 6:00","124",41,"10","6","Klarer Himmel",165
"7/7/2016 7:00","428",230,"13","6","Klarer Himmel",658
"7/7/2016 8:00","698",490,"15","7","Klarer Himmel",1188
"7/7/2016 9:00","565",419,"16","7","teilweise bewölkt",984
"7/7/2016 10:00","560",398,"17","9","teilweise bewölkt",958
"7/7/2016 11:00","493",363,"18","11","teilweise bewölkt",856
"7/7/2016 12:00","556",593,"19","11","wolkig",1149
"7/7/2016 13:00","597",594,"20","13","Klarer Himmel",1191
"7/7/2016 14:00","611",615,"21","9","Klarer Himmel",1226
"7/7/2016 15:00","642",628,"22","15","Klarer Himmel",1270
"7/7/2016 16:00","660",631,"22","15","Klarer Himmel",1291
"7/7/2016 17:00","685",709,"22","17","Klarer Himmel",1394
"7/7/2016 18:00","720",738,"22","15","Klarer Himmel",1458
"7/7/2016 19:00","1116",586,"22","11","Klarer Himmel",1702
"7/7/2016 20:00","997",644,"20","6","Klarer Himmel",1641
"7/7/2016 21:00","145",175,"17","2","Klarer Himmel",320
"7/7/2016 22:00","92",158,"16","4","Klarer Himmel",250
"7/7/2016 23:00","500",1642,"15","4","Klarer Himmel",2142
"7/8/2016 0:00","122",270,"15","4","Klarer Himmel",392
"7/8/2016 1:00","42",128,"15","7","Klarer Himmel",170
"7/8/2016 2:00","23",76,"15","4","Klarer Himmel",99
"7/8/2016 3:00","17",39,"15","6","Klarer Himmel",56
"7/8/2016 4:00","16",31,"15","2","Klarer Himmel",47
"7/8/2016 5:00","26",29,"15","2","Klarer Himmel",55
"7/8/2016 6:00","108",37,"16","6","Klarer Himmel",145
"7/8/2016 7:00","441",206,"17","4","Klarer Himmel",647
"7/8/2016 8:00","645",382,"18","6","Klarer Himmel",1027
"7/8/2016 9:00","473",346,"19","7","Klarer Himmel",819
"7/8/2016 10:00","492",408,"21","11","Klarer Himmel",900
"7/8/2016 11:00","481",345,"22","17","Klarer Himmel",826
"7/8/2016 12:00","474",453,"22","24","wolkig",927
"7/8/2016 13:00","498",440,"20","20","wolkig",938
"7/8/2016 14:00","456",506,"21","33","wolkig",962
"7/8/2016 15:00","459",437,"20","26","Regen",896
"7/8/2016 16:00","416",484,"20","22","wolkig",900
"7/8/2016 17:00","472",521,"21","30","wolkig",993
"7/8/2016 18:00","492",504,"20","24","wolkig",996
"7/8/2016 19:00","447",374,"19","24","teilweise bewölkt",821
"7/8/2016 20:00","373",336,"19","17","teilweise bewölkt",709
"7/8/2016 21:00","246",297,"18","15","teilweise bewölkt",543
"7/8/2016 22:00","144",244,"16","20","Regen",388
"7/8/2016 23:00","112",316,"16","9","teilweise bewölkt",428
"7/9/2016 0:00","103",259,"15","7","wolkig",362
"7/9/2016 1:00","86",157,"15","9","Klarer Himmel",243
"7/9/2016 2:00","53",117,"15","7","wolkig",170
"7/9/2016 3:00","18",72,"14","6","teilweise bewölkt",90
"7/9/2016 4:00","11",50,"15","7","wolkig",61
"7/9/2016 5:00","32",45,"14","6","Nebel",77
"7/9/2016 6:00","37",31,"15","9","",68
"7/9/2016 7:00","86",22,"17","13","teilweise bewölkt",108
"7/9/2016 8:00","122",77,"17","13","teilweise bewölkt",199
"7/9/2016 9:00","361",123,"19","15","wolkig",484
"7/9/2016 10:00","440",186,"20","20","wolkig",626
"7/9/2016 11:00","426",202,"20","17","wolkig",628
"7/9/2016 12:00","421",274,"21","15","wolkig",695
"7/9/2016 13:00","381",362,"21","17","teilweise bewölkt",743
"7/9/2016 14:00","347",413,"23","19","teilweise bewölkt",760
"7/9/2016 15:00","308",390,"23","17","teilweise bewölkt",698
"7/9/2016 16:00","396",369,"23","20","wolkig",765
"7/9/2016 17:00","433",443,"22","20","Regen",876
"7/9/2016 18:00","411",456,"22","11","wolkig",867
"7/9/2016 19:00","436",306,"22","9","Klarer Himmel",742
"7/9/2016 20:00","376",341,"22","7","wolkig",717
"7/9/2016 21:00","267",204,"20","7","Klarer Himmel",471
"7/9/2016 22:00","153",278,"20","9","Klarer Himmel",431
"7/9/2016 23:00","148",274,"20","11","wolkig",422
"7/10/2016 0:00","112",423,"20","7","wolkig",535
"7/10/2016 1:00","100",240,"18","6","Klarer Himmel",340
"7/10/2016 2:00","51",160,"18","9","Klarer Himmel",211
"7/10/2016 3:00","62",117,"19","11","Klarer Himmel",179
"7/10/2016 4:00","24",76,"17","9","Klarer Himmel",100
"7/10/2016 5:00","24",28,"17","4","Klarer Himmel",52
"7/10/2016 6:00","27",31,"18","7","Klarer Himmel",58
"7/10/2016 7:00","35",21,"19","9","Klarer Himmel",56
"7/10/2016 8:00","33",33,"22","11","Klarer Himmel",66
"7/10/2016 9:00","229",90,"24","15","Klarer Himmel",319
"7/10/2016 10:00","334",145,"25","17","Klarer Himmel",479
"7/10/2016 11:00","323",187,"26","19","teilweise bewölkt",510
"7/10/2016 12:00","317",213,"27","20","wolkig",530
"7/10/2016 13:00","268",280,"28","22","teilweise bewölkt",548
"7/10/2016 14:00","343",292,"28","24","Klarer Himmel",635
"7/10/2016 15:00","354",283,"29","20","Klarer Himmel",637
"7/10/2016 16:00","345",337,"29","17","Klarer Himmel",682
"7/10/2016 17:00","333",310,"29","20","Klarer Himmel",643
"7/10/2016 18:00","333",311,"29","13","Klarer Himmel",644
"7/10/2016 19:00","268",337,"28","7","Klarer Himmel",605
"7/10/2016 20:00","326",399,"26","7","Klarer Himmel",725
"7/10/2016 21:00","136",236,"25","6","Klarer Himmel",372
"7/10/2016 22:00","80",161,"24","15","Klarer Himmel",241
"7/10/2016 23:00","116",203,"21","15","Klarer Himmel",319
"7/11/2016 0:00","78",194,"20","7","Klarer Himmel",272
"7/11/2016 1:00","19",36,"20","6","Klarer Himmel",55
"7/11/2016 2:00","6",14,"20","15","Klarer Himmel",20
"7/11/2016 3:00","6",5,"19","15","Klarer Himmel",11
"7/11/2016 4:00","10",8,"19","13","Klarer Himmel",18
"7/11/2016 5:00","40",16,"19","13","",56
"7/11/2016 6:00","118",44,"19","15","wolkig",162
"7/11/2016 7:00","322",167,"19","19","wolkig",489
"7/11/2016 8:00","600",376,"19","26","wolkig",976
"7/11/2016 9:00","472",331,"19","22","wolkig",803
"7/11/2016 10:00","461",426,"20","24","wolkig",887
"7/11/2016 11:00","436",318,"21","28","wolkig",754
"7/11/2016 12:00","460",433,"22","28","teilweise bewölkt",893
"7/11/2016 13:00","492",405,"22","30","wolkig",897
"7/11/2016 14:00","491",491,"22","28","wolkig",982
"7/11/2016 15:00","527",488,"23","32","wolkig",1015
"7/11/2016 16:00","580",598,"23","28","teilweise bewölkt",1178
"7/11/2016 17:00","657",671,"23","26","teilweise bewölkt",1328
"7/11/2016 18:00","569",638,"23","28","Klarer Himmel",1207
"7/11/2016 19:00","439",544,"22","24","Klarer Himmel",983
"7/11/2016 20:00","290",415,"22","20","Klarer Himmel",705
"7/11/2016 21:00","234",285,"21","17","wolkig",519
"7/11/2016 22:00","152",258,"19","11","teilweise bewölkt",410
"7/11/2016 23:00","80",201,"19","13","teilweise bewölkt",281
"7/12/2016 0:00","45",94,"18","11","Klarer Himmel",139
"7/12/2016 1:00","29",39,"17","11","Klarer Himmel",68
"7/12/2016 2:00","14",18,"16","11","Klarer Himmel",32
"7/12/2016 3:00","3",13,"16","11","Klarer Himmel",16
"7/12/2016 4:00","8",6,"16","9","Klarer Himmel",14
"7/12/2016 5:00","42",17,"15","11","Klarer Himmel",59
"7/12/2016 6:00","136",52,"15","15","teilweise bewölkt",188
"7/12/2016 7:00","371",205,"16","19","teilweise bewölkt",576
"7/12/2016 8:00","689",435,"17","19","teilweise bewölkt",1124
"7/12/2016 9:00","580",399,"19","19","teilweise bewölkt",979
"7/12/2016 10:00","575",502,"19","20","wolkig",1077
"7/12/2016 11:00","514",420,"19","22","wolkig",934
"7/12/2016 12:00","532",531,"21","17","wolkig",1063
"7/12/2016 13:00","573",489,"22","19","wolkig",1062
"7/12/2016 14:00","551",540,"21","15","teilweise bewölkt",1091
"7/12/2016 15:00","564",511,"23","22","teilweise bewölkt",1075
"7/12/2016 16:00","647",690,"21","19","teilweise bewölkt",1337
"7/12/2016 17:00","684",669,"20","7","wolkig",1353
"7/12/2016 18:00","648",750,"20","6","wolkig",1398
"7/12/2016 19:00","461",535,"17","4","wolkig",996
"7/12/2016 20:00","349",420,"16","0","teilweise bewölkt",769
"7/12/2016 21:00","178",274,"17","7","Regen",452
"7/12/2016 22:00","157",335,"16","4","wolkig",492
"7/12/2016 23:00","63",188,"16","6","wolkig",251
"7/13/2016 0:00","25",113,"15","4","Klarer Himmel",138
"7/13/2016 1:00","25",64,"14","0","Nebel",89
"7/13/2016 2:00","10",24,"13","0","Nebel",34
"7/13/2016 3:00","8",19,"13","6","",27
"7/13/2016 4:00","8",6,"12","2","Nebel",14
"7/13/2016 5:00","51",13,"12","2","Nebel",64
"7/13/2016 6:00","133",39,"13","0","wolkig",172
"7/13/2016 7:00","353",219,"14","4","teilweise bewölkt",572
"7/13/2016 8:00","793",368,"15","2","wolkig",1161
"7/13/2016 9:00","584",395,"17","6","teilweise bewölkt",979
"7/13/2016 10:00","586",492,"18","9","wolkig",1078
"7/13/2016 11:00","518",355,"19","15","wolkig",873
"7/13/2016 12:00","522",524,"19","9","wolkig",1046
"7/13/2016 13:00","521",467,"20","15","teilweise bewölkt",988
"7/13/2016 14:00","454",550,"21","13","",1004
"7/13/2016 15:00","532",491,"21","19","wolkig",1023
"7/13/2016 16:00","576",620,"17","19","wolkig",1196
"7/13/2016 17:00","680",716,"15","11","Regen",1396
"7/13/2016 18:00","500",581,"15","6","wolkig",1081
"7/13/2016 19:00","482",528,"15","7","wolkig",1010
"7/13/2016 20:00","335",368,"15","9","wolkig",703
"7/13/2016 21:00","196",251,"15","9","wolkig",447
"7/13/2016 22:00","165",270,"14","11","wolkig",435
"7/13/2016 23:00","122",177,"13","6","wolkig",299
"7/14/2016 0:00","68",133,"13","6","Klarer Himmel",201
"7/14/2016 1:00","31",96,"12","9","wolkig",127
"7/14/2016 2:00","18",105,"11","7","Klarer Himmel",123
"7/14/2016 3:00","17",52,"10","7","Klarer Himmel",69
"7/14/2016 4:00","29",30,"10","4","Nebel",59
"7/14/2016 5:00","42",35,"10","6","Nebel",77
"7/14/2016 6:00","109",57,"11","4","teilweise bewölkt",166
"7/14/2016 7:00","319",195,"12","7","teilweise bewölkt",514
"7/14/2016 8:00","657",399,"14","13","teilweise bewölkt",1056
"7/14/2016 9:00","527",352,"16","13","",879
"7/14/2016 10:00","555",339,"16","11","teilweise bewölkt",894
"7/14/2016 11:00","409",379,"16","13","teilweise bewölkt",788
"7/14/2016 12:00","478",475,"18","19","teilweise bewölkt",953
"7/14/2016 13:00","494",436,"17","15","teilweise bewölkt",930
"7/14/2016 14:00","523",526,"16","2","wolkig",1049
"7/14/2016 15:00","497",533,"16","15","teilweise bewölkt",1030
"7/14/2016 16:00","612",614,"15","15","teilweise bewölkt",1226
"7/14/2016 17:00","582",600,"17","19","wolkig",1182
"7/14/2016 18:00","523",656,"16","19","wolkig",1179
"7/14/2016 19:00","444",497,"14","20","wolkig",941
"7/14/2016 20:00","257",348,"13","19","wolkig",605
"7/14/2016 21:00","183",234,"14","15","wolkig",417
"7/14/2016 22:00","149",261,"13","11","teilweise bewölkt",410
"7/14/2016 23:00","73",212,"12","11","Klarer Himmel",285
"7/15/2016 0:00","57",138,"11","9","Klarer Himmel",195
"7/15/2016 1:00","28",67,"12","11","Klarer Himmel",95
"7/15/2016 2:00","14",34,"12","13","wolkig",48
"7/15/2016 3:00","7",25,"12","11","Klarer Himmel",32
"7/15/2016 4:00","10",9,"12","13","wolkig",19
"7/15/2016 5:00","26",10,"12","9","wolkig",36
"7/15/2016 6:00","102",35,"13","13","wolkig",137
"7/15/2016 7:00","310",159,"13","17","wolkig",469
"7/15/2016 8:00","559",330,"15","17","wolkig",889
"7/15/2016 9:00","433",277,"15","17","teilweise bewölkt",710
"7/15/2016 10:00","414",358,"15","19","teilweise bewölkt",772
"7/15/2016 11:00","450",313,"16","19","",763
"7/15/2016 12:00","447",412,"18","19","wolkig",859
"7/15/2016 13:00","485",461,"19","19","wolkig",946
"7/15/2016 14:00","445",438,"19","17","teilweise bewölkt",883
"7/15/2016 15:00","463",440,"19","15","wolkig",903
"7/15/2016 16:00","398",419,"19","6","wolkig",817
"7/15/2016 17:00","644",423,"20","20","wolkig",1067
"7/15/2016 18:00","823",479,"19","11","wolkig",1302
"7/15/2016 19:00","817",397,"19","7","wolkig",1214
"7/15/2016 20:00","823",382,"18","7","teilweise bewölkt",1205
"7/15/2016 21:00","503",373,"16","6","teilweise bewölkt",876
"7/15/2016 22:00","543",390,"13","0","Nebel",933
"7/15/2016 23:00","357",310,"12","2","Nebel",667
"7/16/2016 0:00","338",316,"11","4","Nebel",654
"7/16/2016 1:00","231",192,"11","0","Nebel",423
"7/16/2016 2:00","70",137,"12","6","Nebel",207
"7/16/2016 3:00","54",97,"13","7","Klarer Himmel",151
"7/16/2016 4:00","25",95,"14","7","Klarer Himmel",120
"7/16/2016 5:00","35",56,"15","6","Regen",91
"7/16/2016 6:00","40",31,"15","9","wolkig",71
"7/16/2016 7:00","94",27,"16","9","wolkig",121
"7/16/2016 8:00","158",60,"16","11","wolkig",218
"7/16/2016 9:00","334",90,"17","11","wolkig",424
"7/16/2016 10:00","486",142,"18","17","wolkig",628
"7/16/2016 11:00","440",225,"18","15","wolkig",665
"7/16/2016 12:00","468",267,"19","15","wolkig",735
"7/16/2016 13:00","502",317,"20","13","wolkig",819
"7/16/2016 14:00","608",415,"21","15","wolkig",1023
"7/16/2016 15:00","482",325,"21","17","wolkig",807
"7/16/2016 16:00","250",347,"21","20","wolkig",597
"7/16/2016 17:00","295",333,"21","15","wolkig",628
"7/16/2016 18:00","218",370,"21","13","wolkig",588
"7/16/2016 19:00","346",320,"22","15","wolkig",666
"7/16/2016 20:00","270",300,"21","13","wolkig",570
"7/16/2016 21:00","190",160,"20","6","wolkig",350
"7/16/2016 22:00","167",196,"19","4","teilweise bewölkt",363
"7/16/2016 23:00","99",220,"19","4","wolkig",319
"7/17/2016 0:00","101",174,"19","7","Klarer Himmel",275
"7/17/2016 1:00","98",105,"19","7","wolkig",203
"7/17/2016 2:00","48",111,"19","7","wolkig",159
"7/17/2016 3:00","29",77,"19","9","wolkig",106
"7/17/2016 4:00","13",59,"19","9","wolkig",72
"7/17/2016 5:00","11",24,"19","9","wolkig",35
"7/17/2016 6:00","22",17,"19","11","teilweise bewölkt",39
"7/17/2016 7:00","26",20,"19","15","wolkig",46
"7/17/2016 8:00","39",37,"19","13","wolkig",76
"7/17/2016 9:00","268",55,"20","17","wolkig",323
"7/17/2016 10:00","251",135,"21","19","wolkig",386
"7/17/2016 11:00","180",151,"22","19","wolkig",331
"7/17/2016 12:00","211",165,"22","24","wolkig",376
"7/17/2016 13:00","238",266,"24","24","wolkig",504
"7/17/2016 14:00","286",238,"24","20","teilweise bewölkt",524
"7/17/2016 15:00","304",248,"25","28","wolkig",552
"7/17/2016 16:00","256",288,"24","20","wolkig",544
"7/17/2016 17:00","304",310,"24","22","Klarer Himmel",614
"7/17/2016 18:00","287",313,"23","20","wolkig",600
"7/17/2016 19:00","269",297,"22","15","Klarer Himmel",566
"7/17/2016 20:00","215",275,"21","9","Klarer Himmel",490
"7/17/2016 21:00","134",212,"19","7","Klarer Himmel",346
"7/17/2016 22:00","91",184,"17","6","Klarer Himmel",275
"7/17/2016 23:00","72",120,"16","6","Klarer Himmel",192
"7/18/2016 0:00","30",53,"15","6","Klarer Himmel",83
"7/18/2016 1:00","11",37,"14","7","Klarer Himmel",48
"7/18/2016 2:00","9",17,"16","6","Klarer Himmel",26
"7/18/2016 3:00","7",4,"13","2","wolkig",11
"7/18/2016 4:00","5",7,"12","0","Nebel",12
"7/18/2016 5:00","41",15,"13","4","Nebel",56
"7/18/2016 6:00","115",52,"15","4","wolkig",167
"7/18/2016 7:00","332",173,"16","6","Regen",505
"7/18/2016 8:00","516",296,"18","7","teilweise bewölkt",812
"7/18/2016 9:00","436",292,"20","7","teilweise bewölkt",728
"7/18/2016 10:00","386",324,"22","17","teilweise bewölkt",710
"7/18/2016 11:00","386",305,"23","15","teilweise bewölkt",691
"7/18/2016 12:00","448",383,"25","22","teilweise bewölkt",831
"7/18/2016 13:00","479",394,"25","17","teilweise bewölkt",873
"7/18/2016 14:00","421",425,"26","17","teilweise bewölkt",846
"7/18/2016 15:00","534",511,"27","19","Klarer Himmel",1045
"7/18/2016 16:00","550",508,"27","15","Klarer Himmel",1058
"7/18/2016 17:00","635",573,"26","15","Klarer Himmel",1208
"7/18/2016 18:00","563",559,"26","17","Klarer Himmel",1122
"7/18/2016 19:00","390",461,"25","9","Klarer Himmel",851
"7/18/2016 20:00","288",322,"24","7","Klarer Himmel",610
"7/18/2016 21:00","202",414,"20","2","Klarer Himmel",616
"7/18/2016 22:00","127",270,"17","0","Klarer Himmel",397
"7/18/2016 23:00","79",174,"16","0","Klarer Himmel",253
"7/19/2016 0:00","45",95,"15","0","Klarer Himmel",140
"7/19/2016 1:00","19",52,"14","0","Klarer Himmel",71
"7/19/2016 2:00","13",11,"13","2","Klarer Himmel",24
"7/19/2016 3:00","8",8,"13","2","Klarer Himmel",16
"7/19/2016 4:00","14",5,"12","0","Nebel",19
"7/19/2016 5:00","43",18,"12","4","Nebel",61
"7/19/2016 6:00","133",43,"13","0","Klarer Himmel",176
"7/19/2016 7:00","488",187,"18","2","Klarer Himmel",675
"7/19/2016 8:00","608",369,"20","6","Klarer Himmel",977
"7/19/2016 9:00","562",471,"23","4","Klarer Himmel",1033
"7/19/2016 10:00","413",360,"24","6","Klarer Himmel",773
"7/19/2016 11:00","445",349,"25","6","Klarer Himmel",794
"7/19/2016 12:00","475",404,"27","4","Klarer Himmel",879
"7/19/2016 13:00","464",435,"28","4","Klarer Himmel",899
"7/19/2016 14:00","468",504,"28","6","Klarer Himmel",972
"7/19/2016 15:00","547",445,"29","6","Klarer Himmel",992
"7/19/2016 16:00","630",537,"30","6","Klarer Himmel",1167
"7/19/2016 17:00","697",638,"29","4","Klarer Himmel",1335
"7/19/2016 18:00","638",589,"30","2","Klarer Himmel",1227
"7/19/2016 19:00","527",455,"29","7","Klarer Himmel",982
"7/19/2016 20:00","390",390,"26","7","Klarer Himmel",780
"7/19/2016 21:00","267",339,"24","6","Klarer Himmel",606
"7/19/2016 22:00","196",340,"23","6","Klarer Himmel",536
"7/19/2016 23:00","97",324,"21","6","Klarer Himmel",421
"7/20/2016 0:00","61",207,"20","6","Klarer Himmel",268
"7/20/2016 1:00","35",119,"21","7","Klarer Himmel",154
"7/20/2016 2:00","17",38,"20","6","Klarer Himmel",55
"7/20/2016 3:00","8",19,"20","7","Klarer Himmel",27
"7/20/2016 4:00","11",11,"20","7","Klarer Himmel",22
"7/20/2016 5:00","40",30,"20","9","Klarer Himmel",70
"7/20/2016 6:00","121",54,"21","9","Klarer Himmel",175
"7/20/2016 7:00","379",180,"22","9","Klarer Himmel",559
"7/20/2016 8:00","646",367,"24","7","Klarer Himmel",1013
"7/20/2016 9:00","559",357,"25","11","Klarer Himmel",916
"7/20/2016 10:00","502",380,"28","13","Klarer Himmel",882
"7/20/2016 11:00","439",442,"29","13","Klarer Himmel",881
"7/20/2016 12:00","467",435,"31","13","Klarer Himmel",902
"7/20/2016 13:00","498",450,"32","19","Klarer Himmel",948
"7/20/2016 14:00","428",446,"33","17","Klarer Himmel",874
"7/20/2016 15:00","525",464,"34","15","Klarer Himmel",989
"7/20/2016 16:00","652",460,"34","17","Klarer Himmel",1112
"7/20/2016 17:00","625",460,"33","11","Klarer Himmel",1085
"7/20/2016 18:00","613",513,"31","6","Klarer Himmel",1126
"7/20/2016 19:00","519",507,"30","4","wolkig",1026
"7/20/2016 20:00","205",401,"23","22","Gewitter",606
"7/20/2016 21:00","243",321,"21","7","wolkig",564
"7/20/2016 22:00","138",257,"21","6","Klarer Himmel",395
"7/20/2016 23:00","122",169,"20","4","Klarer Himmel",291
"7/21/2016 0:00","124",189,"20","4","wolkig",313
"7/21/2016 1:00","39",131,"20","2","Klarer Himmel",170
"7/21/2016 2:00","30",119,"19","0","Nebel",149
"7/21/2016 3:00","26",104,"18","0","Nebel",130
"7/21/2016 4:00","29",51,"18","0","Nebel",80
"7/21/2016 5:00","45",46,"17","4","Nebel",91
"7/21/2016 6:00","113",53,"18","4","Nebel",166
"7/21/2016 7:00","340",173,"20","6","",513
"7/21/2016 8:00","520",323,"22","9","",843
"7/21/2016 9:00","536",300,"23","7","Klarer Himmel",836
"7/21/2016 10:00","420",290,"25","7","Klarer Himmel",710
"7/21/2016 11:00","409",352,"25","11","teilweise bewölkt",761
"7/21/2016 12:00","439",416,"26","9","teilweise bewölkt",855
"7/21/2016 13:00","415",485,"27","7","teilweise bewölkt",900
"7/21/2016 14:00","467",485,"29","7","teilweise bewölkt",952
"7/21/2016 15:00","506",412,"29","6","teilweise bewölkt",918
"7/21/2016 16:00","427",547,"30","4","teilweise bewölkt",974
"7/21/2016 17:00","497",536,"28","2","wolkig",1033
"7/21/2016 18:00","485",604,"18","24","Gewitter",1089
"7/21/2016 19:00","309",350,"21","4","Regen",659
"7/21/2016 20:00","346",314,"21","4","Nebel",660
"7/21/2016 21:00","201",211,"20","0","Nebel",412
"7/21/2016 22:00","134",214,"19","2","Nebel",348
"7/21/2016 23:00","100",190,"19","6","teilweise bewölkt",290
"7/22/2016 0:00","57",176,"18","2","Klarer Himmel",233
"7/22/2016 1:00","38",78,"18","2","",116
"7/22/2016 2:00","13",42,"18","2","",55
"7/22/2016 3:00","3",19,"19","2","",22
"7/22/2016 4:00","17",24,"18","0","Nebel",41
"7/22/2016 5:00","33",28,"18","0","Nebel",61
"7/22/2016 6:00","113",42,"19","0","Nebel",155
"7/22/2016 7:00","306",168,"20","6","Nebel",474
"7/22/2016 8:00","441",258,"20","7","wolkig",699
"7/22/2016 9:00","440",255,"21","13","Regen",695
"7/22/2016 10:00","332",241,"21","19","Regen",573
"7/22/2016 11:00","373",290,"22","13","wolkig",663
"7/22/2016 12:00","314",326,"18","15","Gewitter",640
"7/22/2016 13:00","347",356,"21","19","wolkig",703
"7/22/2016 14:00","374",337,"23","13","Klarer Himmel",711
"7/22/2016 15:00","427",323,"24","7","wolkig",750
"7/22/2016 16:00","360",417,"24","6","wolkig",777
"7/22/2016 17:00","362",345,"25","7","Klarer Himmel",707
"7/22/2016 18:00","378",401,"25","7","Klarer Himmel",779
"7/22/2016 19:00","402",353,"25","7","Klarer Himmel",755
"7/22/2016 20:00","340",307,"23","9","Klarer Himmel",647
"7/22/2016 21:00","227",216,"21","11","Klarer Himmel",443
"7/22/2016 22:00","164",223,"20","4","Klarer Himmel",387
"7/22/2016 23:00","126",226,"20","13","Klarer Himmel",352
"7/23/2016 0:00","134",240,"19","7","Klarer Himmel",374
"7/23/2016 1:00","86",134,"19","7","Klarer Himmel",220
"7/23/2016 2:00","24",114,"19","6","Klarer Himmel",138
"7/23/2016 3:00","27",116,"18","4","",143
"7/23/2016 4:00","18",65,"18","6","",83
"7/23/2016 5:00","28",43,"18","7","Nebel",71
"7/23/2016 6:00","29",37,"18","2","Nebel",66
"7/23/2016 7:00","78",25,"19","7","Nebel",103
"7/23/2016 8:00","208",65,"19","11","wolkig",273
"7/23/2016 9:00","317",123,"20","15","wolkig",440
"7/23/2016 10:00","388",182,"21","11","wolkig",570
"7/23/2016 11:00","379",215,"21","13","wolkig",594
"7/23/2016 12:00","384",220,"22","9","wolkig",604
"7/23/2016 13:00","302",321,"22","9","wolkig",623
"7/23/2016 14:00","292",295,"24","6","wolkig",587
"7/23/2016 15:00","256",295,"24","7","wolkig",551
"7/23/2016 16:00","258",299,"24","4","wolkig",557
"7/23/2016 17:00","251",252,"25","4","teilweise bewölkt",503
"7/23/2016 18:00","250",348,"25","4","wolkig",598
"7/23/2016 19:00","318",323,"24","6","wolkig",641
"7/23/2016 20:00","269",278,"22","4","Klarer Himmel",547
"7/23/2016 21:00","188",182,"20","0","Klarer Himmel",370
"7/23/2016 22:00","180",189,"19","2","Klarer Himmel",369
"7/23/2016 23:00","123",194,"18","0","Klarer Himmel",317
"7/24/2016 0:00","92",221,"17","0","Klarer Himmel",313
"7/24/2016 1:00","63",143,"16","0","Nebel",206
"7/24/2016 2:00","30",93,"16","0","Nebel",123
"7/24/2016 3:00","32",72,"15","0","Nebel",104
"7/24/2016 4:00","16",66,"15","0","Nebel",82
"7/24/2016 5:00","8",48,"15","0","Nebel",56
"7/24/2016 6:00","14",38,"16","0","Nebel",52
"7/24/2016 7:00","30",18,"18","0","",48
"7/24/2016 8:00","65",32,"19","6","Klarer Himmel",97
"7/24/2016 9:00","217",55,"22","4","Klarer Himmel",272
"7/24/2016 10:00","250",103,"23","7","teilweise bewölkt",353
"7/24/2016 11:00","214",184,"25","7","teilweise bewölkt",398
"7/24/2016 12:00","234",194,"26","7","teilweise bewölkt",428
"7/24/2016 13:00","276",209,"26","7","teilweise bewölkt",485
"7/24/2016 14:00","311",220,"27","6","teilweise bewölkt",531
"7/24/2016 15:00","285",228,"27","7","teilweise bewölkt",513
"7/24/2016 16:00","289",275,"27","11","teilweise bewölkt",564
"7/24/2016 17:00","272",248,"26","7","wolkig",520
"7/24/2016 18:00","267",276,"27","7","wolkig",543
"7/24/2016 19:00","231",281,"26","6","Klarer Himmel",512
"7/24/2016 20:00","176",297,"25","4","Klarer Himmel",473
"7/24/2016 21:00","137",250,"22","0","Klarer Himmel",387
"7/24/2016 22:00","90",185,"21","0","Klarer Himmel",275
"7/24/2016 23:00","73",145,"22","4","Klarer Himmel",218
"7/25/2016 0:00","38",112,"22","6","Klarer Himmel",150
"7/25/2016 1:00","17",29,"21","2","Klarer Himmel",46
"7/25/2016 2:00","8",8,"20","0","Klarer Himmel",16
"7/25/2016 3:00","8",11,"20","4","Klarer Himmel",19
"7/25/2016 4:00","11",6,"20","0","wolkig",17
"7/25/2016 5:00","46",23,"19","4","wolkig",69
"7/25/2016 6:00","106",40,"20","9","wolkig",146
"7/25/2016 7:00","363",152,"20","6","wolkig",515
"7/25/2016 8:00","456",273,"21","4","wolkig",729
"7/25/2016 9:00","352",280,"23","11","wolkig",632
"7/25/2016 10:00","340",279,"24","15","wolkig",619
"7/25/2016 11:00","378",269,"25","19","wolkig",647
"7/25/2016 12:00","400",302,"25","17","wolkig",702
"7/25/2016 13:00","392",311,"26","19","teilweise bewölkt",703
"7/25/2016 14:00","411",313,"25","13","wolkig",724
"7/25/2016 15:00","364",353,"24","17","wolkig",717
"7/25/2016 16:00","408",520,"24","17","wolkig",928
"7/25/2016 17:00","472",541,"25","17","wolkig",1013
"7/25/2016 18:00","420",504,"25","17","teilweise bewölkt",924
"7/25/2016 19:00","405",402,"23","13","teilweise bewölkt",807
"7/25/2016 20:00","333",331,"22","7","teilweise bewölkt",664
"7/25/2016 21:00","209",232,"21","13","teilweise bewölkt",441
"7/25/2016 22:00","119",217,"19","13","wolkig",336
"7/25/2016 23:00","67",181,"18","6","Klarer Himmel",248
"7/26/2016 0:00","79",228,"17","0","Klarer Himmel",307
"7/26/2016 1:00","25",70,"18","4","wolkig",95
"7/26/2016 2:00","10",16,"18","7","wolkig",26
"7/26/2016 3:00","15",21,"16","4","teilweise bewölkt",36
"7/26/2016 4:00","6",6,"16","4","teilweise bewölkt",12
"7/26/2016 5:00","42",23,"15","0","Nebel",65
"7/26/2016 6:00","132",47,"15","2","Nebel",179
"7/26/2016 7:00","410",189,"16","0","Klarer Himmel",599
"7/26/2016 8:00","464",301,"18","4","wolkig",765
"7/26/2016 9:00","438",260,"19","4","wolkig",698
"7/26/2016 10:00","385",222,"20","6","wolkig",607
"7/26/2016 11:00","376",291,"22","6","wolkig",667
"7/26/2016 12:00","391",378,"23","7","wolkig",769
"7/26/2016 13:00","390",368,"23","9","wolkig",758
"7/26/2016 14:00","496",399,"24","9","wolkig",895
"7/26/2016 15:00","432",372,"24","7","Klarer Himmel",804
"7/26/2016 16:00","511",485,"24","4","Klarer Himmel",996
"7/26/2016 17:00","491",683,"24","6","Klarer Himmel",1174
"7/26/2016 18:00","419",600,"24","4","Klarer Himmel",1019
"7/26/2016 19:00","399",472,"23","7","Klarer Himmel",871
"7/26/2016 20:00","273",347,"22","4","Klarer Himmel",620
"7/26/2016 21:00","198",231,"20","2","Klarer Himmel",429
"7/26/2016 22:00","139",262,"20","4","Klarer Himmel",401
"7/26/2016 23:00","73",173,"19","9","Klarer Himmel",246
"7/27/2016 0:00","108",195,"18","4","Klarer Himmel",303
"7/27/2016 1:00","39",88,"18","4","Klarer Himmel",127
"7/27/2016 2:00","11",38,"18","6","Klarer Himmel",49
"7/27/2016 3:00","15",38,"17","0","Klarer Himmel",53
"7/27/2016 4:00","15",25,"17","6","Klarer Himmel",40
"7/27/2016 5:00","46",32,"17","6","Klarer Himmel",78
"7/27/2016 6:00","126",28,"17","7","Klarer Himmel",154
"7/27/2016 7:00","353",169,"17","6","Klarer Himmel",522
"7/27/2016 8:00","509",261,"19","7","Klarer Himmel",770
"7/27/2016 9:00","422",281,"20","11","wolkig",703
"7/27/2016 10:00","422",271,"22","13","wolkig",693
"7/27/2016 11:00","435",321,"22","19","wolkig",756
"7/27/2016 12:00","441",374,"22","22","teilweise bewölkt",815
"7/27/2016 13:00","387",387,"22","22","wolkig",774
"7/27/2016 14:00","394",374,"23","24","wolkig",768
"7/27/2016 15:00","349",425,"23","24","wolkig",774
"7/27/2016 16:00","422",463,"23","24","wolkig",885
"7/27/2016 17:00","467",471,"23","26","wolkig",938
"7/27/2016 18:00","486",527,"22","22","wolkig",1013
"7/27/2016 19:00","399",415,"21","13","Klarer Himmel",814
"7/27/2016 20:00","284",347,"21","11","wolkig",631
"7/27/2016 21:00","216",254,"20","17","Regen",470
"7/27/2016 22:00","161",212,"18","15","Regen",373
"7/27/2016 23:00","114",180,"17","9","wolkig",294
"7/28/2016 0:00","84",216,"18","11","wolkig",300
"7/28/2016 1:00","39",78,"18","11","wolkig",117
"7/28/2016 2:00","13",70,"18","15","wolkig",83
"7/28/2016 3:00","11",69,"16","7","Klarer Himmel",80
"7/28/2016 4:00","16",39,"17","4","Klarer Himmel",55
"7/28/2016 5:00","43",43,"15","0","Nebel",86
"7/28/2016 6:00","116",29,"16","2","wolkig",145
"7/28/2016 7:00","274",152,"17","4","wolkig",426
"7/28/2016 8:00","284",196,"18","4","wolkig",480
"7/28/2016 9:00","299",199,"17","7","Regen",498
"7/28/2016 10:00","286",178,"17","6","wolkig",464
"7/28/2016 11:00","269",172,"18","4","Regen",441
"7/28/2016 12:00","316",247,"19","6","Regen",563
"7/28/2016 13:00","269",287,"20","11","Regen",556
"7/28/2016 14:00","260",260,"19","17","Regen",520
"7/28/2016 15:00","323",316,"20","17","wolkig",639
"7/28/2016 16:00","384",384,"21","13","teilweise bewölkt",768
"7/28/2016 17:00","354",423,"22","11","wolkig",777
"7/28/2016 18:00","338",441,"22","6","wolkig",779
"7/28/2016 19:00","311",324,"22","6","wolkig",635
"7/28/2016 20:00","251",277,"20","11","wolkig",528
"7/28/2016 21:00","152",204,"19","0","wolkig",356
"7/28/2016 22:00","95",197,"19","11","wolkig",292
"7/28/2016 23:00","105",205,"18","0","wolkig",310
"7/29/2016 0:00","76",154,"19","4","wolkig",230
"7/29/2016 1:00","34",63,"18","4","wolkig",97
"7/29/2016 2:00","18",44,"18","7","Klarer Himmel",62
"7/29/2016 3:00","3",31,"17","13","wolkig",34
"7/29/2016 4:00","15",15,"17","6","wolkig",30
"7/29/2016 5:00","35",29,"17","7","wolkig",64
"7/29/2016 6:00","108",40,"17","7","Regen",148
"7/29/2016 7:00","203",137,"17","13","wolkig",340
"7/29/2016 8:00","352",209,"17","13","wolkig",561
"7/29/2016 9:00","314",202,"17","9","wolkig",516
"7/29/2016 10:00","286",175,"19","15","wolkig",461
"7/29/2016 11:00","333",221,"20","17","wolkig",554
"7/29/2016 12:00","346",271,"21","17","wolkig",617
"7/29/2016 13:00","239",307,"17","11","Regen",546
"7/29/2016 14:00","353",258,"21","9","wolkig",611
"7/29/2016 15:00","369",298,"22","13","teilweise bewölkt",667
"7/29/2016 16:00","358",306,"23","26","wolkig",664
"7/29/2016 17:00","328",372,"23","24","teilweise bewölkt",700
"7/29/2016 18:00","255",347,"23","22","teilweise bewölkt",602
"7/29/2016 19:00","352",317,"22","24","teilweise bewölkt",669
"7/29/2016 20:00","276",241,"21","13","wolkig",517
"7/29/2016 21:00","192",182,"19","17","wolkig",374
"7/29/2016 22:00","114",186,"19","13","Klarer Himmel",300
"7/29/2016 23:00","94",171,"18","9","Klarer Himmel",265
"7/30/2016 0:00","121",191,"18","9","Klarer Himmel",312
"7/30/2016 1:00","69",154,"17","9","wolkig",223
"7/30/2016 2:00","54",104,"17","7","Klarer Himmel",158
"7/30/2016 3:00","18",89,"16","9","Klarer Himmel",107
"7/30/2016 4:00","16",52,"16","11","wolkig",68
"7/30/2016 5:00","31",41,"15","7","teilweise bewölkt",72
"7/30/2016 6:00","31",25,"16","11","Klarer Himmel",56
"7/30/2016 7:00","57",28,"16","13","Klarer Himmel",85
"7/30/2016 8:00","169",56,"17","17","teilweise bewölkt",225
"7/30/2016 9:00","282",101,"18","22","teilweise bewölkt",383
"7/30/2016 10:00","333",133,"19","19","teilweise bewölkt",466
"7/30/2016 11:00","329",242,"18","24","wolkig",571
"7/30/2016 12:00","296",165,"18","19","wolkig",461
"7/30/2016 13:00","313",239,"21","20","wolkig",552
"7/30/2016 14:00","290",276,"20","17","wolkig",566
"7/30/2016 15:00","266",246,"21","15","wolkig",512
"7/30/2016 16:00","212",289,"20","9","Regen",501
"7/30/2016 17:00","200",247,"18","11","Regen",447
"7/30/2016 18:00","197",277,"18","9","Regen",474
"7/30/2016 19:00","205",240,"17","4","wolkig",445
"7/30/2016 20:00","178",189,"17","0","wolkig",367
"7/30/2016 21:00","146",109,"17","4","wolkig",255
"7/30/2016 22:00","125",139,"17","6","wolkig",264
"7/30/2016 23:00","102",121,"17","7","wolkig",223
"7/31/2016 0:00","81",158,"16","0","wolkig",239
"7/31/2016 1:00","99",115,"16","4","Nebel",214
"7/31/2016 2:00","37",77,"15","2","Nebel",114
"7/31/2016 3:00","20",101,"15","0","Nebel",121
"7/31/2016 4:00","11",70,"15","2","wolkig",81
"7/31/2016 5:00","19",33,"15","6","Nebel",52
"7/31/2016 6:00","17",30,"16","4","Nebel",47
"7/31/2016 7:00","23",15,"16","9","Nebel",38
"7/31/2016 8:00","37",26,"17","11","wolkig",63
"7/31/2016 9:00","126",50,"17","11","wolkig",176
"7/31/2016 10:00","179",76,"18","17","wolkig",255
"7/31/2016 11:00","169",116,"19","15","wolkig",285
"7/31/2016 12:00","253",119,"19","11","Regen",372
"7/31/2016 13:00","183",173,"19","17","wolkig",356
"7/31/2016 14:00","179",163,"20","11","wolkig",342
"7/31/2016 15:00","186",153,"20","9","Regen",339
"7/31/2016 16:00","206",252,"20","13","wolkig",458
"7/31/2016 17:00","186",195,"18","19","wolkig",381
"7/31/2016 18:00","166",222,"19","15","wolkig",388
"7/31/2016 19:00","164",216,"19","19","teilweise bewölkt",380
"7/31/2016 20:00","145",211,"17","7","teilweise bewölkt",356
"7/31/2016 21:00","94",163,"16","13","teilweise bewölkt",257
"7/31/2016 22:00","68",112,"15","9","Klarer Himmel",180
"7/31/2016 23:00","45",84,"14","7","Klarer Himmel",129
"8/1/2016 0:00","29",44,"13","7","Klarer Himmel",73
"8/1/2016 1:00","15",22,"12","7","Klarer Himmel",37
"8/1/2016 2:00","12",15,"12","6","Klarer Himmel",27
"8/1/2016 3:00","8",6,"13","9","Klarer Himmel",14
"8/1/2016 4:00","9",7,"11","7","Klarer Himmel",16
"8/1/2016 5:00","36",15,"12","6","Nebel",51
"8/1/2016 6:00","107",42,"12","6","Klarer Himmel",149
"8/1/2016 7:00","264",143,"13","7","Klarer Himmel",407
"8/1/2016 8:00","458",241,"14","7","Klarer Himmel",699
"8/1/2016 9:00","312",176,"17","9","Regen",488
"8/1/2016 10:00","245",182,"14","9","Regen",427
"8/1/2016 11:00","269",193,"15","4","Regen",462
"8/1/2016 12:00","276",214,"17","9","wolkig",490
"8/1/2016 13:00","300",237,"19","15","teilweise bewölkt",537
"8/1/2016 14:00","296",304,"19","11","teilweise bewölkt",600
"8/1/2016 15:00","229",315,"15","17","Regen",544
"8/1/2016 16:00","249",276,"17","9","teilweise bewölkt",525
"8/1/2016 17:00","382",490,"19","11","teilweise bewölkt",872
"8/1/2016 18:00","344",451,"19","9","teilweise bewölkt",795
"8/1/2016 19:00","296",295,"19","9","teilweise bewölkt",591
"8/1/2016 20:00","251",252,"17","4","Nebel",503
"8/1/2016 21:00","127",229,"15","2","Nebel",356
"8/1/2016 22:00","66",168,"13","2","Nebel",234
"8/1/2016 23:00","60",107,"14","4","Nebel",167
"8/2/2016 0:00","49",123,"14","2","Nebel",172
"8/2/2016 1:00","14",48,"14","0","Regen",62
"8/2/2016 2:00","5",23,"14","7","Regen",28
"8/2/2016 3:00","1",19,"15","7","Regen",20
"8/2/2016 4:00","8",3,"15","9","Regen",11
"8/2/2016 5:00","28",13,"14","6","Regen",41
"8/2/2016 6:00","74",25,"14","7","Regen",99
"8/2/2016 7:00","166",88,"14","4","Regen",254
"8/2/2016 8:00","332",168,"14","6","Regen",500
"8/2/2016 9:00","295",189,"15","7","wolkig",484
"8/2/2016 10:00","277",165,"15","6","Regen",442
"8/2/2016 11:00","256",168,"16","9","wolkig",424
"8/2/2016 12:00","270",206,"17","11","wolkig",476
"8/2/2016 13:00","245",225,"18","9","wolkig",470
"8/2/2016 14:00","280",249,"17","9","wolkig",529
"8/2/2016 15:00","265",287,"18","11","Regen",552
"8/2/2016 16:00","270",361,"17","15","wolkig",631
"8/2/2016 17:00","307",379,"18","9","wolkig",686
"8/2/2016 18:00","298",376,"18","13","wolkig",674
"8/2/2016 19:00","225",287,"17","9","Regen",512
"8/2/2016 20:00","150",219,"17","7","Regen",369
"8/2/2016 21:00","90",163,"17","9","Regen",253
"8/2/2016 22:00","59",145,"17","11","Regen",204
"8/2/2016 23:00","71",124,"18","11","wolkig",195
"8/3/2016 0:00","25",68,"18","13","Regen",93
"8/3/2016 1:00","25",39,"18","13","wolkig",64
"8/3/2016 2:00","9",13,"18","11","Regen",22
"8/3/2016 3:00","10",7,"18","13","Regen",17
"8/3/2016 4:00","8",2,"18","13","wolkig",10
"8/3/2016 5:00","28",21,"18","15","wolkig",49
"8/3/2016 6:00","68",22,"18","15","Regen",90
"8/3/2016 7:00","172",86,"18","15","Regen",258
"8/3/2016 8:00","361",192,"18","19","Regen",553
"8/3/2016 9:00","271",148,"19","19","Regen",419
"8/3/2016 10:00","254",140,"19","19","Regen",394
"8/3/2016 11:00","222",157,"19","17","Regen",379
"8/3/2016 12:00","257",220,"19","22","Regen",477
"8/3/2016 13:00","218",230,"19","20","Regen",448
"8/3/2016 14:00","202",226,"19","22","Regen",428
"8/3/2016 15:00","179",238,"19","19","Regen",417
"8/3/2016 16:00","231",264,"19","20","wolkig",495
"8/3/2016 17:00","259",303,"19","19","wolkig",562
"8/3/2016 18:00","227",320,"19","13","Regen",547
"8/3/2016 19:00","244",247,"19","15","Regen",491
"8/3/2016 20:00","209",206,"19","15","Regen",415
"8/3/2016 21:00","129",134,"19","15","Regen",263
"8/3/2016 22:00","108",140,"19","17","Regen",248
"8/3/2016 23:00","96",80,"15","19","Regen",176
"8/4/2016 0:00","89",111,"16","6","Klarer Himmel",200
"8/4/2016 1:00","42",79,"17","15","teilweise bewölkt",121
"8/4/2016 2:00","12",55,"17","17","teilweise bewölkt",67
"8/4/2016 3:00","7",50,"17","19","teilweise bewölkt",57
"8/4/2016 4:00","14",42,"16","11","teilweise bewölkt",56
"8/4/2016 5:00","33",30,"16","17","wolkig",63
"8/4/2016 6:00","101",42,"16","19","wolkig",143
"8/4/2016 7:00","247",130,"16","19","wolkig",377
"8/4/2016 8:00","349",260,"16","20","wolkig",609
"8/4/2016 9:00","334",157,"17","19","wolkig",491
"8/4/2016 10:00","285",157,"18","20","wolkig",442
"8/4/2016 11:00","281",170,"19","24","wolkig",451
"8/4/2016 12:00","293",239,"19","22","wolkig",532
"8/4/2016 13:00","288",265,"20","19","wolkig",553
"8/4/2016 14:00","300",337,"19","19","wolkig",637
"8/4/2016 15:00","331",308,"19","22","wolkig",639
"8/4/2016 16:00","370",406,"19","19","wolkig",776
"8/4/2016 17:00","377",446,"20","19","wolkig",823
"8/4/2016 18:00","323",427,"20","17","wolkig",750
"8/4/2016 19:00","319",334,"19","13","wolkig",653
"8/4/2016 20:00","255",266,"18","7","wolkig",521
"8/4/2016 21:00","117",205,"18","15","Regen",322
"8/4/2016 22:00","82",207,"17","11","wolkig",289
"8/4/2016 23:00","79",157,"16","7","Klarer Himmel",236
"8/5/2016 0:00","45",128,"15","6","Klarer Himmel",173
"8/5/2016 1:00","26",71,"14","4","Klarer Himmel",97
"8/5/2016 2:00","3",31,"14","6","Klarer Himmel",34
"8/5/2016 3:00","10",23,"14","6","Klarer Himmel",33
"8/5/2016 4:00","9",17,"14","7","Klarer Himmel",26
"8/5/2016 5:00","27",22,"13","7","Nebel",49
"8/5/2016 6:00","101",36,"14","9","wolkig",137
"8/5/2016 7:00","202",125,"15","11","wolkig",327
"8/5/2016 8:00","357",210,"15","13","wolkig",567
"8/5/2016 9:00","322",187,"16","11","wolkig",509
"8/5/2016 10:00","268",166,"17","13","wolkig",434
"8/5/2016 11:00","242",187,"19","15","wolkig",429
"8/5/2016 12:00","300",242,"20","22","teilweise bewölkt",542
"8/5/2016 13:00","288",297,"22","20","teilweise bewölkt",585
"8/5/2016 14:00","324",307,"20","32","Regen",631
"8/5/2016 15:00","283",279,"19","13","Regen",562
"8/5/2016 16:00","325",314,"21","13","teilweise bewölkt",639
"8/5/2016 17:00","297",311,"22","22","teilweise bewölkt",608
"8/5/2016 18:00","289",341,"21","13","teilweise bewölkt",630
"8/5/2016 19:00","307",283,"20","15","wolkig",590
"8/5/2016 20:00","249",251,"19","11","wolkig",500
"8/5/2016 21:00","164",160,"17","11","Klarer Himmel",324
"8/5/2016 22:00","124",162,"16","11","Klarer Himmel",286
"8/5/2016 23:00","104",148,"15","7","Klarer Himmel",252
"8/6/2016 0:00","85",163,"15","6","Klarer Himmel",248
"8/6/2016 1:00","55",113,"14","4","Klarer Himmel",168
"8/6/2016 2:00","44",106,"13","7","teilweise bewölkt",150
"8/6/2016 3:00","33",91,"14","6","teilweise bewölkt",124
"8/6/2016 4:00","7",56,"13","7","teilweise bewölkt",63
"8/6/2016 5:00","26",41,"14","7","Klarer Himmel",67
"8/6/2016 6:00","35",30,"14","6","Klarer Himmel",65
"8/6/2016 7:00","51",29,"15","7","wolkig",80
"8/6/2016 8:00","133",54,"16","9","Klarer Himmel",187
"8/6/2016 9:00","226",68,"18","15","wolkig",294
"8/6/2016 10:00","341",121,"18","19","wolkig",462
"8/6/2016 11:00","334",163,"18","17","Regen",497
"8/6/2016 12:00","318",216,"18","13","wolkig",534
"8/6/2016 13:00","269",239,"18","15","Regen",508
"8/6/2016 14:00","141",244,"19","11","teilweise bewölkt",385
"8/6/2016 15:00","230",253,"20","20","teilweise bewölkt",483
"8/6/2016 16:00","200",199,"20","20","teilweise bewölkt",399
"8/6/2016 17:00","224",219,"20","15","wolkig",443
"8/6/2016 18:00","236",262,"21","15","teilweise bewölkt",498
"8/6/2016 19:00","249",225,"21","11","teilweise bewölkt",474
"8/6/2016 20:00","280",208,"19","11","teilweise bewölkt",488
"8/6/2016 21:00","160",164,"17","11","teilweise bewölkt",324
"8/6/2016 22:00","125",132,"14","6","Klarer Himmel",257
"8/6/2016 23:00","92",190,"14","4","Klarer Himmel",282
"8/7/2016 0:00","96",164,"12","2","Klarer Himmel",260
"8/7/2016 1:00","58",119,"12","4","Nebel",177
"8/7/2016 2:00","22",90,"11","4","Nebel",112
"8/7/2016 3:00","14",83,"11","2","Nebel",97
"8/7/2016 4:00","8",40,"11","4","Nebel",48
"8/7/2016 5:00","10",43,"10","2","Nebel",53
"8/7/2016 6:00","17",26,"11","7","Klarer Himmel",43
"8/7/2016 7:00","26",20,"13","7","Klarer Himmel",46
"8/7/2016 8:00","35",34,"16","13","Klarer Himmel",69
"8/7/2016 9:00","136",62,"17","13","Klarer Himmel",198
"8/7/2016 10:00","215",138,"19","15","Klarer Himmel",353
"8/7/2016 11:00","221",141,"22","20","Klarer Himmel",362
"8/7/2016 12:00","239",146,"23","20","Klarer Himmel",385
"8/7/2016 13:00","315",195,"24","22","Klarer Himmel",510
"8/7/2016 14:00","331",211,"25","24","wolkig",542
"8/7/2016 15:00","318",246,"24","22","wolkig",564
"8/7/2016 16:00","251",326,"23","20","wolkig",577
"8/7/2016 17:00","219",342,"23","22","",561
"8/7/2016 18:00","228",325,"23","20","wolkig",553
"8/7/2016 19:00","144",226,"22","13","wolkig",370
"8/7/2016 20:00","136",209,"22","11","wolkig",345
"8/7/2016 21:00","99",165,"21","7","wolkig",264
"8/7/2016 22:00","70",112,"21","13","wolkig",182
"8/7/2016 23:00","34",71,"22","17","wolkig",105
"8/8/2016 0:00","24",40,"22","19","wolkig",64
"8/8/2016 1:00","7",28,"21","19","wolkig",35
"8/8/2016 2:00","6",12,"20","13","wolkig",18
"8/8/2016 3:00","6",7,"20","26","wolkig",13
"8/8/2016 4:00","7",5,"19","24","wolkig",12
"8/8/2016 5:00","40",15,"18","17","teilweise bewölkt",55
"8/8/2016 6:00","111",47,"18","19","teilweise bewölkt",158
"8/8/2016 7:00","283",147,"18","24","teilweise bewölkt",430
"8/8/2016 8:00","442",186,"18","22","wolkig",628
"8/8/2016 9:00","288",180,"18","19","wolkig",468
"8/8/2016 10:00","218",168,"17","24","wolkig",386
"8/8/2016 11:00","270",210,"18","19","wolkig",480
"8/8/2016 12:00","254",211,"18","24","wolkig",465
"8/8/2016 13:00","172",260,"17","20","wolkig",432
"8/8/2016 14:00","221",243,"20","20","teilweise bewölkt",464
"8/8/2016 15:00","313",243,"21","24","teilweise bewölkt",556
"8/8/2016 16:00","342",351,"21","28","teilweise bewölkt",693
"8/8/2016 17:00","358",489,"21","28","teilweise bewölkt",847
"8/8/2016 18:00","365",390,"19","26","Klarer Himmel",755
"8/8/2016 19:00","272",334,"18","15","Klarer Himmel",606
"8/8/2016 20:00","202",234,"16","9","Klarer Himmel",436
"8/8/2016 21:00","134",207,"14","6","Klarer Himmel",341
"8/8/2016 22:00","75",158,"15","11","Klarer Himmel",233
"8/8/2016 23:00","67",123,"14","7","Klarer Himmel",190
"8/9/2016 0:00","12",75,"14","7","Klarer Himmel",87
"8/9/2016 1:00","10",40,"14","6","Klarer Himmel",50
"8/9/2016 2:00","14",14,"13","6","Klarer Himmel",28
"8/9/2016 3:00","4",20,"13","6","Klarer Himmel",24
"8/9/2016 4:00","9",6,"13","6","Klarer Himmel",15
"8/9/2016 5:00","27",18,"13","6","Klarer Himmel",45
"8/9/2016 6:00","107",43,"12","6","Klarer Himmel",150
"8/9/2016 7:00","261",125,"13","6","Klarer Himmel",386
"8/9/2016 8:00","388",204,"15","11","Klarer Himmel",592
"8/9/2016 9:00","331",225,"15","17","wolkig",556
"8/9/2016 10:00","305",198,"15","15","wolkig",503
"8/9/2016 11:00","347",201,"16","13","wolkig",548
"8/9/2016 12:00","264",250,"17","15","teilweise bewölkt",514
"8/9/2016 13:00","270",241,"18","19","teilweise bewölkt",511
"8/9/2016 14:00","336",260,"16","24","wolkig",596
"8/9/2016 15:00","256",353,"18","17","wolkig",609
"8/9/2016 16:00","320",422,"17","17","wolkig",742
"8/9/2016 17:00","343",440,"16","17","wolkig",783
"8/9/2016 18:00","339",442,"16","11","wolkig",781
"8/9/2016 19:00","267",307,"16","15","teilweise bewölkt",574
"8/9/2016 20:00","172",244,"13","4","wolkig",416
"8/9/2016 21:00","125",166,"14","7","Klarer Himmel",291
"8/9/2016 22:00","106",174,"13","7","Klarer Himmel",280
"8/9/2016 23:00","64",121,"13","9","Regen",185
"8/10/2016 0:00","33",92,"13","6","wolkig",125
"8/10/2016 1:00","22",52,"12","9","wolkig",74
"8/10/2016 2:00","7",32,"12","7","Regen",39
"8/10/2016 3:00","6",13,"11","7","Regen",19
"8/10/2016 4:00","6",2,"11","6","Regen",8
"8/10/2016 5:00","27",15,"10","7","Regen",42
"8/10/2016 6:00","96",25,"10","7","Klarer Himmel",121
"8/10/2016 7:00","263",95,"11","7","wolkig",358
"8/10/2016 8:00","399",196,"12","15","teilweise bewölkt",595
"8/10/2016 9:00","347",174,"13","13","teilweise bewölkt",521
"8/10/2016 10:00","323",218,"14","17","teilweise bewölkt",541
"8/10/2016 11:00","366",177,"16","15","teilweise bewölkt",543
"8/10/2016 12:00","326",268,"17","22","Regen",594
"8/10/2016 13:00","250",268,"14","13","Regen",518
"8/10/2016 14:00","247",319,"15","20","Regen",566
"8/10/2016 15:00","221",284,"13","19","Regen",505
"8/10/2016 16:00","273",282,"13","7","Regen",555
"8/10/2016 17:00","415",450,"14","9","Regen",865
"8/10/2016 18:00","306",349,"15","9","teilweise bewölkt",655
"8/10/2016 19:00","252",309,"14","4","teilweise bewölkt",561
"8/10/2016 20:00","199",253,"12","2","Klarer Himmel",452
"8/10/2016 21:00","139",238,"10","2","Nebel",377
"8/10/2016 22:00","108",188,"9","4","Nebel",296
"8/10/2016 23:00","93",146,"8","2","Klarer Himmel",239
"8/11/2016 0:00","72",92,"8","2","Klarer Himmel",164
"8/11/2016 1:00","54",80,"7","0","Nebel",134
"8/11/2016 2:00","38",42,"7","2","Nebel",80
"8/11/2016 3:00","10",42,"6","0","Nebel",52
"8/11/2016 4:00","21",35,"6","4","Nebel",56
"8/11/2016 5:00","40",26,"6","4","Nebel",66
"8/11/2016 6:00","94",54,"7","4","Nebel",148
"8/11/2016 7:00","230",121,"9","6","Klarer Himmel",351
"8/11/2016 8:00","427",186,"10","11","Klarer Himmel",613
"8/11/2016 9:00","287",172,"11","13","Klarer Himmel",459
"8/11/2016 10:00","237",194,"13","15","Regen",431
"8/11/2016 11:00","240",188,"14","20","Regen",428
"8/11/2016 12:00","231",208,"14","19","wolkig",439
"8/11/2016 13:00","266",231,"15","19","Regen",497
"8/11/2016 14:00","249",288,"14","19","Regen",537
"8/11/2016 15:00","219",243,"13","28","Regen",462
"8/11/2016 16:00","247",324,"13","22","Regen",571
"8/11/2016 17:00","259",338,"13","20","Regen",597
"8/11/2016 18:00","254",305,"13","19","Regen",559
"8/11/2016 19:00","153",205,"13","17","Regen",358
"8/11/2016 20:00","144",180,"13","15","Regen",324
"8/11/2016 21:00","59",122,"13","17","Regen",181
"8/11/2016 22:00","48",88,"13","15","Regen",136
"8/11/2016 23:00","59",88,"14","15","Regen",147
"8/12/2016 0:00","40",56,"14","15","Regen",96
"8/12/2016 1:00","39",35,"14","15","Regen",74
"8/12/2016 2:00","3",21,"14","11","Regen",24
"8/12/2016 3:00","10",29,"15","15","Regen",39
"8/12/2016 4:00","11",27,"15","13","Regen",38
"8/12/2016 5:00","26",30,"16","13","Regen",56
"8/12/2016 6:00","67",36,"16","13","Regen",103
"8/12/2016 7:00","229",107,"17","13","Regen",336
"8/12/2016 8:00","300",149,"17","15","Regen",449
"8/12/2016 9:00","209",130,"17","15","Regen",339
"8/12/2016 10:00","179",131,"17","15","Regen",310
"8/12/2016 11:00","235",165,"18","19","Regen",400
"8/12/2016 12:00","215",213,"19","24","wolkig",428
"8/12/2016 13:00","221",202,"20","24","wolkig",423
"8/12/2016 14:00","219",261,"21","28","wolkig",480
"8/12/2016 15:00","265",249,"21","26","wolkig",514
"8/12/2016 16:00","238",274,"20","26","wolkig",512
"8/12/2016 17:00","243",278,"21","13","wolkig",521
"8/12/2016 18:00","269",276,"21","13","wolkig",545
"8/12/2016 19:00","265",187,"21","15","wolkig",452
"8/12/2016 20:00","236",195,"20","7","wolkig",431
"8/12/2016 21:00","159",148,"19","6","teilweise bewölkt",307
"8/12/2016 22:00","139",134,"17","7","teilweise bewölkt",273
"8/12/2016 23:00","94",106,"17","7","teilweise bewölkt",200
"8/13/2016 0:00","93",126,"17","9","teilweise bewölkt",219
"8/13/2016 1:00","63",143,"17","11","wolkig",206
"8/13/2016 2:00","33",93,"16","11","teilweise bewölkt",126
"8/13/2016 3:00","23",74,"16","11","teilweise bewölkt",97
"8/13/2016 4:00","17",47,"16","11","teilweise bewölkt",64
"8/13/2016 5:00","31",31,"16","11","Klarer Himmel",62
"8/13/2016 6:00","41",35,"16","11","Klarer Himmel",76
"8/13/2016 7:00","62",15,"16","15","wolkig",77
"8/13/2016 8:00","94",42,"17","17","wolkig",136
"8/13/2016 9:00","212",77,"17","15","wolkig",289
"8/13/2016 10:00","289",116,"18","20","wolkig",405
"8/13/2016 11:00","293",146,"18","26","wolkig",439
"8/13/2016 12:00","283",200,"19","22","wolkig",483
"8/13/2016 13:00","286",214,"20","24","wolkig",500
"8/13/2016 14:00","261",253,"21","24","wolkig",514
"8/13/2016 15:00","234",232,"20","24","wolkig",466
"8/13/2016 16:00","275",273,"22","20","wolkig",548
"8/13/2016 17:00","205",290,"21","13","wolkig",495
"8/13/2016 18:00","213",309,"21","19","wolkig",522
"8/13/2016 19:00","218",208,"20","13","wolkig",426
"8/13/2016 20:00","180",191,"20","17","wolkig",371
"8/13/2016 21:00","146",136,"19","11","Regen",282
"8/13/2016 22:00","128",119,"17","6","wolkig",247
"8/13/2016 23:00","136",129,"16","0","wolkig",265
"8/14/2016 0:00","91",101,"16","2","teilweise bewölkt",192
"8/14/2016 1:00","83",150,"15","0","wolkig",233
"8/14/2016 2:00","41",81,"15","0","Nebel",122
"8/14/2016 3:00","19",50,"15","2","Nebel",69
"8/14/2016 4:00","12",46,"15","4","Nebel",58
"8/14/2016 5:00","10",30,"15","2","Nebel",40
"8/14/2016 6:00","21",20,"15","4","Nebel",41
"8/14/2016 7:00","25",16,"15","0","Nebel",41
"8/14/2016 8:00","35",23,"17","4","wolkig",58
"8/14/2016 9:00","89",68,"18","4","wolkig",157
"8/14/2016 10:00","131",109,"19","7","wolkig",240
"8/14/2016 11:00","138",121,"19","9","teilweise bewölkt",259
"8/14/2016 12:00","206",168,"20","11","teilweise bewölkt",374
"8/14/2016 13:00","231",161,"21","15","wolkig",392
"8/14/2016 14:00","245",154,"22","6","teilweise bewölkt",399
"8/14/2016 15:00","238",175,"22","11","teilweise bewölkt",413
"8/14/2016 16:00","277",198,"22","7","teilweise bewölkt",475
"8/14/2016 17:00","234",283,"21","11","wolkig",517
"8/14/2016 18:00","206",270,"21","17","teilweise bewölkt",476
"8/14/2016 19:00","167",228,"19","11","teilweise bewölkt",395
"8/14/2016 20:00","129",191,"17","9","Klarer Himmel",320
"8/14/2016 21:00","91",120,"16","7","Klarer Himmel",211
"8/14/2016 22:00","57",96,"14","6","Klarer Himmel",153
"8/14/2016 23:00","36",69,"13","4","Klarer Himmel",105
"8/15/2016 0:00","24",33,"13","0","Nebel",57
"8/15/2016 1:00","22",16,"11","2","teilweise bewölkt",38
"8/15/2016 2:00","6",10,"12","2","wolkig",16
"8/15/2016 3:00","4",3,"13","2","Klarer Himmel",7
"8/15/2016 4:00","11",4,"13","4","Klarer Himmel",15
"8/15/2016 5:00","36",17,"13","4","Klarer Himmel",53
"8/15/2016 6:00","109",57,"13","0","Klarer Himmel",166
"8/15/2016 7:00","274",144,"14","2","Klarer Himmel",418
"8/15/2016 8:00","412",215,"16","7","teilweise bewölkt",627
"8/15/2016 9:00","300",199,"18","9","teilweise bewölkt",499
"8/15/2016 10:00","306",179,"18","9","wolkig",485
"8/15/2016 11:00","277",220,"19","7","wolkig",497
"8/15/2016 12:00","296",243,"20","15","wolkig",539
"8/15/2016 13:00","303",276,"19","13","wolkig",579
"8/15/2016 14:00","340",321,"20","17","wolkig",661
"8/15/2016 15:00","344",296,"20","13","teilweise bewölkt",640
"8/15/2016 16:00","402",418,"20","13","wolkig",820
"8/15/2016 17:00","424",565,"19","13","wolkig",989
"8/15/2016 18:00","396",495,"20","15","teilweise bewölkt",891
"8/15/2016 19:00","305",305,"19","13","Klarer Himmel",610
"8/15/2016 20:00","256",244,"16","4","Klarer Himmel",500
"8/15/2016 21:00","87",178,"14","2","Klarer Himmel",265
"8/15/2016 22:00","73",152,"13","4","Klarer Himmel",225
"8/15/2016 23:00","34",114,"12","4","Klarer Himmel",148
"8/16/2016 0:00","36",74,"13","4","Klarer Himmel",110
"8/16/2016 1:00","12",43,"12","4","Klarer Himmel",55
"8/16/2016 2:00","8",25,"11","2","Klarer Himmel",33
"8/16/2016 3:00","4",11,"10","2","Nebel",15
"8/16/2016 4:00","7",10,"10","0","Nebel",17
"8/16/2016 5:00","33",13,"9","0","Nebel",46
"8/16/2016 6:00","117",45,"9","4","Nebel",162
"8/16/2016 7:00","305",164,"13","6","Klarer Himmel",469
"8/16/2016 8:00","435",229,"15","9","wolkig",664
"8/16/2016 9:00","343",205,"17","13","wolkig",548
"8/16/2016 10:00","294",210,"18","13","wolkig",504
"8/16/2016 11:00","289",236,"19","13","wolkig",525
"8/16/2016 12:00","327",262,"19","11","teilweise bewölkt",589
"8/16/2016 13:00","370",284,"19","11","teilweise bewölkt",654
"8/16/2016 14:00","345",330,"21","13","teilweise bewölkt",675
"8/16/2016 15:00","296",356,"20","19","teilweise bewölkt",652
"8/16/2016 16:00","408",430,"21","15","teilweise bewölkt",838
"8/16/2016 17:00","451",550,"21","13","teilweise bewölkt",1001
"8/16/2016 18:00","468",490,"20","15","teilweise bewölkt",958
"8/16/2016 19:00","318",416,"19","11","Klarer Himmel",734
"8/16/2016 20:00","216",336,"16","6","Klarer Himmel",552
"8/16/2016 21:00","147",257,"15","6","Klarer Himmel",404
"8/16/2016 22:00","99",195,"13","4","Klarer Himmel",294
"8/16/2016 23:00","50",163,"13","6","Klarer Himmel",213
"8/17/2016 0:00","40",92,"13","2","Klarer Himmel",132
"8/17/2016 1:00","21",48,"13","4","Klarer Himmel",69
"8/17/2016 2:00","9",30,"14","6","Klarer Himmel",39
"8/17/2016 3:00","9",14,"13","4","Klarer Himmel",23
"8/17/2016 4:00","7",8,"11","4","Klarer Himmel",15
"8/17/2016 5:00","32",17,"9","2","Nebel",49
"8/17/2016 6:00","125",54,"8","6","Nebel",179
"8/17/2016 7:00","318",157,"12","2","Nebel",475
"8/17/2016 8:00","436",254,"15","7","Klarer Himmel",690
"8/17/2016 9:00","371",213,"17","7","Klarer Himmel",584
"8/17/2016 10:00","321",197,"19","9","Klarer Himmel",518
"8/17/2016 11:00","362",225,"20","9","Klarer Himmel",587
"8/17/2016 12:00","418",272,"21","11","Klarer Himmel",690
"8/17/2016 13:00","320",347,"21","9","Klarer Himmel",667
"8/17/2016 14:00","305",325,"22","11","Klarer Himmel",630
"8/17/2016 15:00","368",448,"22","9","Klarer Himmel",816
"8/17/2016 16:00","429",458,"22","11","Klarer Himmel",887
"8/17/2016 17:00","489",480,"22","11","Klarer Himmel",969
"8/17/2016 18:00","468",532,"21","7","Klarer Himmel",1000
"8/17/2016 19:00","409",368,"20","6","Klarer Himmel",777
"8/17/2016 20:00","287",317,"17","6","Klarer Himmel",604
"8/17/2016 21:00","196",228,"16","6","Klarer Himmel",424
"8/17/2016 22:00","97",273,"14","4","Klarer Himmel",370
"8/17/2016 23:00","96",169,"13","6","Klarer Himmel",265
"8/18/2016 0:00","74",114,"12","4","Klarer Himmel",188
"8/18/2016 1:00","31",62,"10","4","Nebel",93
"8/18/2016 2:00","11",61,"10","6","Nebel",72
"8/18/2016 3:00","5",35,"10","7","Nebel",40
"8/18/2016 4:00","16",66,"9","4","Klarer Himmel",82
"8/18/2016 5:00","31",27,"8","2","Nebel",58
"8/18/2016 6:00","126",52,"8","2","Nebel",178
"8/18/2016 7:00","303",164,"11","6","Klarer Himmel",467
"8/18/2016 8:00","439",228,"16","6","Klarer Himmel",667
"8/18/2016 9:00","311",205,"19","7","Klarer Himmel",516
"8/18/2016 10:00","296",204,"20","11","Klarer Himmel",500
"8/18/2016 11:00","263",218,"22","13","Klarer Himmel",481
"8/18/2016 12:00","351",261,"22","13","Klarer Himmel",612
"8/18/2016 13:00","324",294,"23","9","Klarer Himmel",618
"8/18/2016 14:00","402",326,"23","7","Klarer Himmel",728
"8/18/2016 15:00","369",370,"24","6","Klarer Himmel",739
"8/18/2016 16:00","461",436,"24","7","Klarer Himmel",897
"8/18/2016 17:00","450",456,"24","13","Klarer Himmel",906
"8/18/2016 18:00","414",433,"23","11","Klarer Himmel",847
"8/18/2016 19:00","377",423,"22","6","Klarer Himmel",800
"8/18/2016 20:00","223",267,"18","6","Klarer Himmel",490
"8/18/2016 21:00","137",249,"15","2","Klarer Himmel",386
"8/18/2016 22:00","121",243,"15","7","Klarer Himmel",364
"8/18/2016 23:00","66",183,"15","4","Klarer Himmel",249
"8/19/2016 0:00","34",104,"14","4","Klarer Himmel",138
"8/19/2016 1:00","16",45,"14","4","Klarer Himmel",61
"8/19/2016 2:00","20",23,"12","4","Klarer Himmel",43
"8/19/2016 3:00","10",16,"11","2","Nebel",26
"8/19/2016 4:00","8",7,"10","0","Nebel",15
"8/19/2016 5:00","27",12,"9","0","Nebel",39
"8/19/2016 6:00","121",47,"9","0","Nebel",168
"8/19/2016 7:00","269",139,"11","2","Klarer Himmel",408
"8/19/2016 8:00","404",227,"16","4","Klarer Himmel",631
"8/19/2016 9:00","329",183,"19","6","Klarer Himmel",512
"8/19/2016 10:00","261",178,"21","4","Klarer Himmel",439
"8/19/2016 11:00","301",210,"22","6","teilweise bewölkt",511
"8/19/2016 12:00","345",240,"23","6","teilweise bewölkt",585
"8/19/2016 13:00","322",326,"25","7","Klarer Himmel",648
"8/19/2016 14:00","361",329,"26","6","Klarer Himmel",690
"8/19/2016 15:00","375",379,"25","7","Klarer Himmel",754
"8/19/2016 16:00","341",342,"26","7","Klarer Himmel",683
"8/19/2016 17:00","404",366,"25","6","Klarer Himmel",770
"8/19/2016 18:00","396",387,"23","4","Klarer Himmel",783
"8/19/2016 19:00","299",319,"22","4","Klarer Himmel",618
"8/19/2016 20:00","172",225,"19","2","Regen",397
"8/19/2016 21:00","144",168,"18","4","",312
"8/19/2016 22:00","107",138,"18","4","Klarer Himmel",245
"8/19/2016 23:00","96",187,"19","6","Regen",283
"8/20/2016 0:00","68",113,"19","20","Regen",181
"8/20/2016 1:00","50",95,"18","9","wolkig",145
"8/20/2016 2:00","27",61,"17","7","Klarer Himmel",88
"8/20/2016 3:00","17",63,"17","9","wolkig",80
"8/20/2016 4:00","15",39,"17","11","wolkig",54
"8/20/2016 5:00","22",33,"17","13","wolkig",55
"8/20/2016 6:00","47",38,"17","11","wolkig",85
"8/20/2016 7:00","142",28,"17","9","wolkig",170
"8/20/2016 8:00","163",48,"18","15","wolkig",211
"8/20/2016 9:00","219",81,"18","15","wolkig",300
"8/20/2016 10:00","346",153,"20","13","wolkig",499
"8/20/2016 11:00","388",183,"20","11","wolkig",571
"8/20/2016 12:00","411",278,"20","13","wolkig",689
"8/20/2016 13:00","335",309,"22","17","wolkig",644
"8/20/2016 14:00","297",320,"21","13","wolkig",617
"8/20/2016 15:00","239",352,"22","17","Regen",591
"8/20/2016 16:00","247",297,"20","9","teilweise bewölkt",544
"8/20/2016 17:00","211",264,"22","11","teilweise bewölkt",475
"8/20/2016 18:00","230",238,"22","11","teilweise bewölkt",468
"8/20/2016 19:00","232",235,"21","7","Klarer Himmel",467
"8/20/2016 20:00","209",184,"18","7","Klarer Himmel",393
"8/20/2016 21:00","143",166,"15","4","Nebel",309
"8/20/2016 22:00","129",164,"15","7","Klarer Himmel",293
"8/20/2016 23:00","68",144,"18","19","Klarer Himmel",212
"8/21/2016 0:00","62",112,"17","13","Klarer Himmel",174
"8/21/2016 1:00","58",129,"17","9","Klarer Himmel",187
"8/21/2016 2:00","40",75,"15","9","Klarer Himmel",115
"8/21/2016 3:00","22",93,"15","11","Klarer Himmel",115
"8/21/2016 4:00","18",42,"15","13","Klarer Himmel",60
"8/21/2016 5:00","20",50,"14","11","Klarer Himmel",70
"8/21/2016 6:00","20",36,"15","11","Klarer Himmel",56
"8/21/2016 7:00","34",25,"16","17","wolkig",59
"8/21/2016 8:00","38",28,"17","19","wolkig",66
"8/21/2016 9:00","107",51,"18","22","wolkig",158
"8/21/2016 10:00","146",113,"17","20","wolkig",259
"8/21/2016 11:00","102",89,"15","28","Regen",191
"8/21/2016 12:00","113",121,"17","22","wolkig",234
"8/21/2016 13:00","118",133,"17","20","wolkig",251
"8/21/2016 14:00","150",133,"19","20","wolkig",283
"8/21/2016 15:00","159",129,"18","20","Regen",288
"8/21/2016 16:00","120",118,"18","17","wolkig",238
"8/21/2016 17:00","141",127,"18","19","wolkig",268
"8/21/2016 18:00","157",151,"18","24","wolkig",308
"8/21/2016 19:00","134",136,"18","22","wolkig",270
"8/21/2016 20:00","90",109,"17","13","wolkig",199
"8/21/2016 21:00","49",106,"17","17","wolkig",155
"8/21/2016 22:00","49",71,"16","9","teilweise bewölkt",120
"8/21/2016 23:00","27",55,"16","11","teilweise bewölkt",82
"8/22/2016 0:00","17",28,"16","11","Klarer Himmel",45
"8/22/2016 1:00","9",16,"16","11","Klarer Himmel",25
"8/22/2016 2:00","4",13,"15","9","wolkig",17
"8/22/2016 3:00","3",5,"16","11","wolkig",8
"8/22/2016 4:00","7",4,"15","13","teilweise bewölkt",11
"8/22/2016 5:00","39",19,"14","11","wolkig",58
"8/22/2016 6:00","121",54,"14","9","Regen",175
"8/22/2016 7:00","256",142,"15","11","Regen",398
"8/22/2016 8:00","332",181,"15","13","Regen",513
"8/22/2016 9:00","294",185,"15","13","wolkig",479
"8/22/2016 10:00","190",188,"16","15","Regen",378
"8/22/2016 11:00","146",184,"16","17","Regen",330
"8/22/2016 12:00","158",168,"16","15","Regen",326
"8/22/2016 13:00","178",181,"16","13","Regen",359
"8/22/2016 14:00","235",224,"17","13","Regen",459
"8/22/2016 15:00","192",234,"17","13","Regen",426
"8/22/2016 16:00","304",283,"18","15","Regen",587
"8/22/2016 17:00","313",378,"18","11","Regen",691
"8/22/2016 18:00","304",391,"19","11","wolkig",695
"8/22/2016 19:00","232",298,"19","9","teilweise bewölkt",530
"8/22/2016 20:00","172",214,"18","9","Klarer Himmel",386
"8/22/2016 21:00","129",133,"17","7","Klarer Himmel",262
"8/22/2016 22:00","94",136,"17","7","teilweise bewölkt",230
"8/22/2016 23:00","55",112,"15","2","Nebel",167
"8/23/2016 0:00","13",65,"14","0","Nebel",78
"8/23/2016 1:00","14",41,"15","0","wolkig",55
"8/23/2016 2:00","5",19,"15","2","wolkig",24
"8/23/2016 3:00","6",8,"16","4","wolkig",14
"8/23/2016 4:00","10",5,"16","2","Klarer Himmel",15
"8/23/2016 5:00","44",22,"15","6","wolkig",66
"8/23/2016 6:00","155",46,"15","0","Nebel",201
"8/23/2016 7:00","335",190,"16","0","Nebel",525
"8/23/2016 8:00","462",284,"18","6","wolkig",746
"8/23/2016 9:00","408",249,"19","7","wolkig",657
"8/23/2016 10:00","311",205,"21","7","Klarer Himmel",516
"8/23/2016 11:00","308",250,"23","7","Klarer Himmel",558
"8/23/2016 12:00","367",285,"24","7","Klarer Himmel",652
"8/23/2016 13:00","369",366,"25","7","Klarer Himmel",735
"8/23/2016 14:00","393",369,"26","7","wolkig",762
"8/23/2016 15:00","380",404,"26","2","teilweise bewölkt",784
"8/23/2016 16:00","529",486,"26","6","teilweise bewölkt",1015
"8/23/2016 17:00","537",526,"27","4","teilweise bewölkt",1063
"8/23/2016 18:00","502",542,"26","6","Klarer Himmel",1044
"8/23/2016 19:00","454",489,"25","4","Klarer Himmel",943
"8/23/2016 20:00","257",351,"22","6","Klarer Himmel",608
"8/23/2016 21:00","162",285,"21","6","Klarer Himmel",447
"8/23/2016 22:00","117",264,"20","6","Klarer Himmel",381
"8/23/2016 23:00","80",173,"20","4","Klarer Himmel",253
"8/24/2016 0:00","35",106,"19","4","Klarer Himmel",141
"8/24/2016 1:00","16",56,"19","6","Klarer Himmel",72
"8/24/2016 2:00","11",24,"18","4","Klarer Himmel",35
"8/24/2016 3:00","6",8,"19","6","Klarer Himmel",14
"8/24/2016 4:00","11",5,"18","6","Klarer Himmel",16
"8/24/2016 5:00","28",23,"17","4","Klarer Himmel",51
"8/24/2016 6:00","151",53,"17","4","Klarer Himmel",204
"8/24/2016 7:00","482",206,"19","7","Klarer Himmel",688
"8/24/2016 8:00","581",317,"21","7","Klarer Himmel",898
"8/24/2016 9:00","467",248,"23","6","Klarer Himmel",715
"8/24/2016 10:00","359",264,"25","7","Klarer Himmel",623
"8/24/2016 11:00","377",311,"27","7","Klarer Himmel",688
"8/24/2016 12:00","379",346,"28","9","Klarer Himmel",725
"8/24/2016 13:00","410",473,"29","11","Klarer Himmel",883
"8/24/2016 14:00","391",412,"30","13","Klarer Himmel",803
"8/24/2016 15:00","402",395,"30","11","Klarer Himmel",797
"8/24/2016 16:00","533",452,"31","6","Klarer Himmel",985
"8/24/2016 17:00","580",525,"31","6","Klarer Himmel",1105
"8/24/2016 18:00","506",544,"30","4","Klarer Himmel",1050
"8/24/2016 19:00","452",430,"28","6","Klarer Himmel",882
"8/24/2016 20:00","326",377,"25","6","Klarer Himmel",703
"8/24/2016 21:00","202",276,"24","6","Klarer Himmel",478
"8/24/2016 22:00","149",280,"25","7","Klarer Himmel",429
"8/24/2016 23:00","125",194,"23","6","Klarer Himmel",319
"8/25/2016 0:00","55",102,"21","4","Klarer Himmel",157
"8/25/2016 1:00","50",97,"21","6","Klarer Himmel",147
"8/25/2016 2:00","14",60,"21","9","Klarer Himmel",74
"8/25/2016 3:00","10",53,"21","7","Klarer Himmel",63
"8/25/2016 4:00","15",35,"19","4","Klarer Himmel",50
"8/25/2016 5:00","36",31,"20","9","Klarer Himmel",67
"8/25/2016 6:00","147",50,"19","9","Klarer Himmel",197
"8/25/2016 7:00","555",236,"20","9","Klarer Himmel",791
"8/25/2016 8:00","484",304,"22","6","Klarer Himmel",788
"8/25/2016 9:00","405",290,"24","7","Klarer Himmel",695
"8/25/2016 10:00","321",230,"27","11","Klarer Himmel",551
"8/25/2016 11:00","333",265,"28","15","Klarer Himmel",598
"8/25/2016 12:00","315",355,"29","15","Klarer Himmel",670
"8/25/2016 13:00","389",417,"30","9","Klarer Himmel",806
"8/25/2016 14:00","353",373,"31","11","Klarer Himmel",726
"8/25/2016 15:00","409",372,"31","15","Klarer Himmel",781
"8/25/2016 16:00","519",435,"32","11","Klarer Himmel",954
"8/25/2016 17:00","511",487,"32","6","Klarer Himmel",998
"8/25/2016 18:00","536",492,"32","4","Klarer Himmel",1028
"8/25/2016 19:00","448",376,"29","4","Klarer Himmel",824
"8/25/2016 20:00","279",316,"24","0","Klarer Himmel",595
"8/25/2016 21:00","229",342,"21","4","Klarer Himmel",571
"8/25/2016 22:00","148",286,"20","2","Klarer Himmel",434
"8/25/2016 23:00","94",186,"21","6","Klarer Himmel",280
"8/26/2016 0:00","40",108,"19","2","Klarer Himmel",148
"8/26/2016 1:00","33",66,"18","2","Klarer Himmel",99
"8/26/2016 2:00","10",17,"20","6","Klarer Himmel",27
"8/26/2016 3:00","7",16,"20","6","Klarer Himmel",23
"8/26/2016 4:00","10",15,"19","6","Klarer Himmel",25
"8/26/2016 5:00","33",21,"18","4","Klarer Himmel",54
"8/26/2016 6:00","130",54,"18","2","Klarer Himmel",184
"8/26/2016 7:00","530",197,"20","6","Klarer Himmel",727
"8/26/2016 8:00","460",293,"22","9","Klarer Himmel",753
"8/26/2016 9:00","371",211,"25","7","Klarer Himmel",582
"8/26/2016 10:00","274",264,"26","7","Klarer Himmel",538
"8/26/2016 11:00","273",284,"28","7","Klarer Himmel",557
"8/26/2016 12:00","354",393,"30","11","Klarer Himmel",747
"8/26/2016 13:00","336",424,"30","7","Klarer Himmel",760
"8/26/2016 14:00","385",368,"30","15","Klarer Himmel",753
"8/26/2016 15:00","417",330,"31","9","Klarer Himmel",747
"8/26/2016 16:00","392",383,"31","9","Klarer Himmel",775
"8/26/2016 17:00","422",399,"30","15","Klarer Himmel",821
"8/26/2016 18:00","364",381,"29","11","Klarer Himmel",745
"8/26/2016 19:00","350",329,"27","13","Klarer Himmel",679
"8/26/2016 20:00","316",256,"25","15","Klarer Himmel",572
"8/26/2016 21:00","243",208,"24","17","Klarer Himmel",451
"8/26/2016 22:00","137",231,"22","13","Klarer Himmel",368
"8/26/2016 23:00","111",220,"21","13","Klarer Himmel",331
"8/27/2016 0:00","117",146,"20","9","wolkig",263
"8/27/2016 1:00","56",122,"20","9","Klarer Himmel",178
"8/27/2016 2:00","70",95,"19","9","wolkig",165
"8/27/2016 3:00","15",75,"19","9","wolkig",90
"8/27/2016 4:00","19",50,"18","11","teilweise bewölkt",69
"8/27/2016 5:00","19",47,"17","7","wolkig",66
"8/27/2016 6:00","34",34,"17","9","teilweise bewölkt",68
"8/27/2016 7:00","101",27,"18","6","Klarer Himmel",128
"8/27/2016 8:00","154",82,"19","15","Klarer Himmel",236
"8/27/2016 9:00","292",121,"21","11","Klarer Himmel",413
"8/27/2016 10:00","322",165,"22","13","Klarer Himmel",487
"8/27/2016 11:00","337",185,"24","13","Klarer Himmel",522
"8/27/2016 12:00","406",262,"25","15","Klarer Himmel",668
"8/27/2016 13:00","354",275,"26","11","Klarer Himmel",629
"8/27/2016 14:00","343",271,"27","11","Klarer Himmel",614
"8/27/2016 15:00","261",285,"28","11","Klarer Himmel",546
"8/27/2016 16:00","255",309,"28","19","teilweise bewölkt",564
"8/27/2016 17:00","327",349,"29","9","teilweise bewölkt",676
"8/27/2016 18:00","307",332,"28","7","wolkig",639
"8/27/2016 19:00","280",250,"27","6","wolkig",530
"8/27/2016 20:00","205",190,"25","7","Klarer Himmel",395
"8/27/2016 21:00","161",176,"25","6","wolkig",337
"8/27/2016 22:00","139",219,"23","7","wolkig",358
"8/27/2016 23:00","85",171,"23","13","teilweise bewölkt",256
"8/28/2016 0:00","90",135,"24","7","teilweise bewölkt",225
"8/28/2016 1:00","68",108,"24","13","wolkig",176
"8/28/2016 2:00","39",95,"21","4","teilweise bewölkt",134
"8/28/2016 3:00","33",60,"21","6","wolkig",93
"8/28/2016 4:00","16",41,"21","6","Klarer Himmel",57
"8/28/2016 5:00","7",39,"20","7","Klarer Himmel",46
"8/28/2016 6:00","24",17,"20","4","Klarer Himmel",41
"8/28/2016 7:00","40",11,"21","9","Klarer Himmel",51
"8/28/2016 8:00","70",23,"23","9","Klarer Himmel",93
"8/28/2016 9:00","156",76,"25","11","teilweise bewölkt",232
"8/28/2016 10:00","184",139,"27","13","wolkig",323
"8/28/2016 11:00","212",198,"29","13","wolkig",410
"8/28/2016 12:00","265",219,"31","20","teilweise bewölkt",484
"8/28/2016 13:00","252",230,"32","22","teilweise bewölkt",482
"8/28/2016 14:00","307",197,"30","30","teilweise bewölkt",504
"8/28/2016 15:00","239",179,"27","32","Regen",418
"8/28/2016 16:00","209",213,"26","32","teilweise bewölkt",422
"8/28/2016 17:00","277",232,"25","33","teilweise bewölkt",509
"8/28/2016 18:00","244",307,"23","30","teilweise bewölkt",551
"8/28/2016 19:00","173",205,"22","26","teilweise bewölkt",378
"8/28/2016 20:00","195",180,"21","9","Klarer Himmel",375
"8/28/2016 21:00","75",171,"19","11","Klarer Himmel",246
"8/28/2016 22:00","53",132,"19","13","teilweise bewölkt",185
"8/28/2016 23:00","32",93,"18","6","Klarer Himmel",125
"8/29/2016 0:00","16",38,"17","9","teilweise bewölkt",54
"8/29/2016 1:00","10",26,"18","7","Klarer Himmel",36
"8/29/2016 2:00","5",13,"17","13","Klarer Himmel",18
"8/29/2016 3:00","4",2,"17","17","teilweise bewölkt",6
"8/29/2016 4:00","10",13,"17","15","wolkig",23
"8/29/2016 5:00","34",14,"17","13","wolkig",48
"8/29/2016 6:00","114",60,"17","19","Regen",174
"8/29/2016 7:00","444",157,"17","17","wolkig",601
"8/29/2016 8:00","386",257,"17","17","wolkig",643
"8/29/2016 9:00","326",211,"19","17","wolkig",537
"8/29/2016 10:00","267",192,"18","13","wolkig",459
"8/29/2016 11:00","272",225,"20","13","wolkig",497
"8/29/2016 12:00","277",240,"20","13","wolkig",517
"8/29/2016 13:00","276",268,"21","17","wolkig",544
"8/29/2016 14:00","301",363,"21","22","wolkig",664
"8/29/2016 15:00","312",345,"21","15","wolkig",657
"8/29/2016 16:00","405",453,"20","15","wolkig",858
"8/29/2016 17:00","445",491,"21","15","teilweise bewölkt",936
"8/29/2016 18:00","408",518,"20","11","teilweise bewölkt",926
"8/29/2016 19:00","282",364,"19","15","wolkig",646
"8/29/2016 20:00","200",297,"17","9","teilweise bewölkt",497
"8/29/2016 21:00","126",200,"16","11","Klarer Himmel",326
"8/29/2016 22:00","110",175,"14","4","Klarer Himmel",285
"8/29/2016 23:00","40",121,"12","0","Klarer Himmel",161
"8/30/2016 0:00","23",79,"11","2","Klarer Himmel",102
"8/30/2016 1:00","12",28,"11","0","Nebel",40
"8/30/2016 2:00","4",11,"10","0","Nebel",15
"8/30/2016 3:00","3",7,"9","0","Nebel",10
"8/30/2016 4:00","12",8,"9","0","Nebel",20
"8/30/2016 5:00","39",18,"8","2","Nebel",57
"8/30/2016 6:00","130",52,"9","0","Nebel",182
"8/30/2016 7:00","540",208,"10","2","Nebel",748
"8/30/2016 8:00","483",321,"14","0","Klarer Himmel",804
"8/30/2016 9:00","376",302,"17","0","Klarer Himmel",678
"8/30/2016 10:00","334",221,"18","2","teilweise bewölkt",555
"8/30/2016 11:00","296",244,"19","4","teilweise bewölkt",540
"8/30/2016 12:00","364",364,"20","6","teilweise bewölkt",728
"8/30/2016 13:00","337",366,"21","9","teilweise bewölkt",703
"8/30/2016 14:00","353",330,"22","7","Klarer Himmel",683
"8/30/2016 15:00","384",444,"22","7","Klarer Himmel",828
"8/30/2016 16:00","501",487,"23","4","Klarer Himmel",988
"8/30/2016 17:00","520",536,"22","6","Klarer Himmel",1056
"8/30/2016 18:00","459",575,"22","4","Klarer Himmel",1034
"8/30/2016 19:00","379",415,"20","4","Klarer Himmel",794
"8/30/2016 20:00","255",338,"17","2","Klarer Himmel",593
"8/30/2016 21:00","143",238,"14","4","Klarer Himmel",381
"8/30/2016 22:00","130",241,"13","2","Klarer Himmel",371
"8/30/2016 23:00","78",167,"12","0","Klarer Himmel",245
"8/31/2016 0:00","28",113,"12","0","Klarer Himmel",141
"8/31/2016 1:00","16",47,"11","0","Klarer Himmel",63
"8/31/2016 2:00","6",25,"11","2","Klarer Himmel",31
"8/31/2016 3:00","6",14,"10","2","Klarer Himmel",20
"8/31/2016 4:00","15",10,"12","6","Klarer Himmel",25
"8/31/2016 5:00","42",27,"11","2","Klarer Himmel",69
"8/31/2016 6:00","128",46,"11","2","Klarer Himmel",174
"8/31/2016 7:00","560",201,"13","4","Klarer Himmel",761
"8/31/2016 8:00","508",341,"16","4","Klarer Himmel",849
"8/31/2016 9:00","418",241,"18","7","Klarer Himmel",659
"8/31/2016 10:00","381",239,"20","9","Klarer Himmel",620
"8/31/2016 11:00","380",258,"22","4","Klarer Himmel",638
"8/31/2016 12:00","409",363,"24","4","Klarer Himmel",772
"8/31/2016 13:00","383",374,"25","9","Klarer Himmel",757
"8/31/2016 14:00","416",488,"26","11","Klarer Himmel",904
"8/31/2016 15:00","414",511,"26","13","Klarer Himmel",925
"8/31/2016 16:00","438",457,"26","13","Klarer Himmel",895
"8/31/2016 17:00","513",574,"26","19","Klarer Himmel",1087
"8/31/2016 18:00","478",540,"25","13","Klarer Himmel",1018
"8/31/2016 19:00","430",423,"23","6","Klarer Himmel",853
"8/31/2016 20:00","271",347,"18","0","Klarer Himmel",618
"8/31/2016 21:00","219",283,"18","7","Klarer Himmel",502
"8/31/2016 22:00","140",261,"16","2","Klarer Himmel",401
"8/31/2016 23:00","93",167,"15","0","Klarer Himmel",260
"9/1/2016 0:00","56",104,"14","2","Klarer Himmel",160
"9/1/2016 1:00","39",69,"13","0","Klarer Himmel",108
"9/1/2016 2:00","12",85,"13","2","",97
"9/1/2016 3:00","12",29,"12","2","Nebel",41
"9/1/2016 4:00","13",35,"12","2","Nebel",48
"9/1/2016 5:00","33",33,"12","0","Nebel",66
"9/1/2016 6:00","128",33,"12","2","Nebel",161
"9/1/2016 7:00","557",238,"13","0","Nebel",795
"9/1/2016 8:00","481",312,"16","0","",793
"9/1/2016 9:00","391",248,"18","6","",639
"9/1/2016 10:00","301",224,"20","6","Klarer Himmel",525
"9/1/2016 11:00","286",212,"23","13","teilweise bewölkt",498
"9/1/2016 12:00","310",308,"23","15","teilweise bewölkt",618
"9/1/2016 13:00","360",345,"24","17","teilweise bewölkt",705
"9/1/2016 14:00","390",356,"24","19","wolkig",746
"9/1/2016 15:00","391",462,"19","26","Regen",853
"9/1/2016 16:00","458",523,"19","6","wolkig",981
"9/1/2016 17:00","461",510,"20","7","wolkig",971
"9/1/2016 18:00","457",560,"21","9","wolkig",1017
"9/1/2016 19:00","333",417,"19","2","wolkig",750
"9/1/2016 20:00","243",289,"16","0","Nebel",532
"9/1/2016 21:00","183",207,"16","0","wolkig",390
"9/1/2016 22:00","127",180,"15","0","Nebel",307
"9/1/2016 23:00","56",142,"13","4","Nebel",198
"9/2/2016 0:00","30",83,"13","0","Nebel",113
"9/2/2016 1:00","16",61,"12","0","Nebel",77
"9/2/2016 2:00","6",29,"11","0","Nebel",35
"9/2/2016 3:00","6",8,"11","0","Nebel",14
"9/2/2016 4:00","14",7,"11","0","Nebel",21
"9/2/2016 5:00","29",28,"10","0","Nebel",57
"9/2/2016 6:00","106",53,"11","0","Nebel",159
"9/2/2016 7:00","486",192,"11","2","Nebel",678
"9/2/2016 8:00","444",282,"13","6","Nebel",726
"9/2/2016 9:00","355",176,"15","4","wolkig",531
"9/2/2016 10:00","303",194,"18","7","wolkig",497
"9/2/2016 11:00","314",220,"21","17","wolkig",534
"9/2/2016 12:00","363",268,"23","17","wolkig",631
"9/2/2016 13:00","341",390,"24","15","wolkig",731
"9/2/2016 14:00","350",385,"24","17","Klarer Himmel",735
"9/2/2016 15:00","390",496,"25","19","Klarer Himmel",886
"9/2/2016 16:00","359",360,"25","19","Klarer Himmel",719
"9/2/2016 17:00","423",378,"24","19","wolkig",801
"9/2/2016 18:00","379",431,"22","17","Klarer Himmel",810
"9/2/2016 19:00","393",371,"21","11","Klarer Himmel",764
"9/2/2016 20:00","235",269,"18","6","Klarer Himmel",504
"9/2/2016 21:00","175",206,"18","6","Klarer Himmel",381
"9/2/2016 22:00","143",188,"18","6","Klarer Himmel",331
"9/2/2016 23:00","99",197,"18","6","Klarer Himmel",296
"9/3/2016 0:00","106",169,"18","4","Klarer Himmel",275
"9/3/2016 1:00","51",131,"17","11","wolkig",182
"9/3/2016 2:00","40",98,"17","7","wolkig",138
"9/3/2016 3:00","26",82,"16","7","wolkig",108
"9/3/2016 4:00","24",57,"16","11","wolkig",81
"9/3/2016 5:00","18",26,"16","7","Klarer Himmel",44
"9/3/2016 6:00","37",23,"15","9","teilweise bewölkt",60
"9/3/2016 7:00","76",36,"16","7","wolkig",112
"9/3/2016 8:00","118",67,"17","11","wolkig",185
"9/3/2016 9:00","246",73,"18","11","wolkig",319
"9/3/2016 10:00","361",125,"18","19","wolkig",486
"9/3/2016 11:00","293",171,"18","13","wolkig",464
"9/3/2016 12:00","321",222,"20","17","wolkig",543
"9/3/2016 13:00","366",267,"20","11","wolkig",633
"9/3/2016 14:00","292",249,"21","20","wolkig",541
"9/3/2016 15:00","282",300,"22","17","wolkig",582
"9/3/2016 16:00","290",322,"22","15","wolkig",612
"9/3/2016 17:00","300",321,"22","13","wolkig",621
"9/3/2016 18:00","307",271,"22","6","wolkig",578
"9/3/2016 19:00","306",263,"19","0","wolkig",569
"9/3/2016 20:00","267",219,"17","0","wolkig",486
"9/3/2016 21:00","180",174,"16","6","Klarer Himmel",354
"9/3/2016 22:00","161",196,"17","7","Klarer Himmel",357
"9/3/2016 23:00","108",211,"18","9","Klarer Himmel",319
"9/4/2016 0:00","105",245,"18","9","Klarer Himmel",350
"9/4/2016 1:00","69",167,"18","13","Klarer Himmel",236
"9/4/2016 2:00","19",111,"19","11","wolkig",130
"9/4/2016 3:00","23",107,"19","11","wolkig",130
"9/4/2016 4:00","9",64,"18","7","Regen",73
"9/4/2016 5:00","7",60,"17","15","Regen",67
"9/4/2016 6:00","24",21,"17","15","Klarer Himmel",45
"9/4/2016 7:00","19",14,"17","13","wolkig",33
"9/4/2016 8:00","45",16,"18","19","wolkig",61
"9/4/2016 9:00","101",35,"18","15","wolkig",136
"9/4/2016 10:00","137",85,"19","15","wolkig",222
"9/4/2016 11:00","151",84,"19","20","Regen",235
"9/4/2016 12:00","106",83,"19","20","wolkig",189
"9/4/2016 13:00","150",117,"21","26","teilweise bewölkt",267
"9/4/2016 14:00","209",123,"22","26","teilweise bewölkt",332
"9/4/2016 15:00","212",141,"22","33","teilweise bewölkt",353
"9/4/2016 16:00","202",187,"20","24","wolkig",389
"9/4/2016 17:00","207",258,"19","32","wolkig",465
"9/4/2016 18:00","142",205,"19","32","wolkig",347
"9/4/2016 19:00","160",204,"18","22","wolkig",364
"9/4/2016 20:00","99",166,"17","20","wolkig",265
"9/4/2016 21:00","54",102,"16","20","Regen",156
"9/4/2016 22:00","43",121,"16","20","teilweise bewölkt",164
"9/4/2016 23:00","43",65,"17","17","wolkig",108
"9/5/2016 0:00","19",31,"16","15","wolkig",50
"9/5/2016 1:00","7",23,"16","22","wolkig",30
"9/5/2016 2:00","7",11,"16","24","wolkig",18
"9/5/2016 3:00","3",6,"16","24","Regen",9
"9/5/2016 4:00","7",1,"15","20","wolkig",8
"9/5/2016 5:00","22",26,"15","20","Regen",48
"9/5/2016 6:00","109",57,"15","19","Regen",166
"9/5/2016 7:00","484",193,"15","13","wolkig",677
"9/5/2016 8:00","480",264,"16","17","teilweise bewölkt",744
"9/5/2016 9:00","379",305,"17","13","wolkig",684
"9/5/2016 10:00","265",232,"18","19","wolkig",497
"9/5/2016 11:00","245",212,"19","15","wolkig",457
"9/5/2016 12:00","327",267,"20","11","wolkig",594
"9/5/2016 13:00","374",315,"22","9","wolkig",689
"9/5/2016 14:00","316",377,"22","13","wolkig",693
"9/5/2016 15:00","337",409,"22","11","wolkig",746
"9/5/2016 16:00","411",460,"22","11","teilweise bewölkt",871
"9/5/2016 17:00","489",528,"22","11","teilweise bewölkt",1017
"9/5/2016 18:00","415",568,"21","9","teilweise bewölkt",983
"9/5/2016 19:00","344",387,"19","6","teilweise bewölkt",731
"9/5/2016 20:00","209",280,"17","0","wolkig",489
"9/5/2016 21:00","171",217,"15","0","teilweise bewölkt",388
"9/5/2016 22:00","82",170,"15","0","Klarer Himmel",252
"9/5/2016 23:00","56",142,"13","2","Nebel",198
"9/6/2016 0:00","17",65,"13","0","Nebel",82
"9/6/2016 1:00","18",43,"12","0","Nebel",61
"9/6/2016 2:00","8",10,"12","0","Nebel",18
"9/6/2016 3:00","4",8,"11","0","Nebel",12
"9/6/2016 4:00","12",4,"12","2","Nebel",16
"9/6/2016 5:00","32",23,"11","0","Nebel",55
"9/6/2016 6:00","128",55,"11","0","Nebel",183
"9/6/2016 7:00","560",232,"13","2","Nebel",792
"9/6/2016 8:00","539",361,"15","2","teilweise bewölkt",900
"9/6/2016 9:00","396",314,"17","7","teilweise bewölkt",710
"9/6/2016 10:00","296",264,"20","6","Klarer Himmel",560
"9/6/2016 11:00","316",249,"22","9","teilweise bewölkt",565
"9/6/2016 12:00","390",321,"23","11","teilweise bewölkt",711
"9/6/2016 13:00","401",424,"23","7","teilweise bewölkt",825
"9/6/2016 14:00","422",355,"24","9","teilweise bewölkt",777
"9/6/2016 15:00","417",476,"24","7","teilweise bewölkt",893
"9/6/2016 16:00","543",493,"25","6","teilweise bewölkt",1036
"9/6/2016 17:00","558",560,"25","7","Klarer Himmel",1118
"9/6/2016 18:00","514",579,"24","2","Klarer Himmel",1093
"9/6/2016 19:00","460",407,"19","4","Klarer Himmel",867
"9/6/2016 20:00","274",438,"18","0","Klarer Himmel",712
"9/6/2016 21:00","161",311,"16","2","Klarer Himmel",472
"9/6/2016 22:00","128",279,"15","2","Klarer Himmel",407
"9/6/2016 23:00","72",153,"14","0","Klarer Himmel",225
"9/7/2016 0:00","40",91,"13","0","Klarer Himmel",131
"9/7/2016 1:00","26",60,"13","4","Klarer Himmel",86
"9/7/2016 2:00","8",14,"15","4","Klarer Himmel",22
"9/7/2016 3:00","5",9,"15","6","Klarer Himmel",14
"9/7/2016 4:00","10",11,"14","4","Klarer Himmel",21
"9/7/2016 5:00","41",31,"13","6","Klarer Himmel",72
"9/7/2016 6:00","144",56,"13","2","Klarer Himmel",200
"9/7/2016 7:00","574",220,"14","4","Klarer Himmel",794
"9/7/2016 8:00","535",402,"16","6","Klarer Himmel",937
"9/7/2016 9:00","451",341,"18","7","Klarer Himmel",792
"9/7/2016 10:00","350",296,"20","7","Klarer Himmel",646
"9/7/2016 11:00","375",271,"23","4","Klarer Himmel",646
"9/7/2016 12:00","450",369,"25","4","Klarer Himmel",819
"9/7/2016 13:00","390",379,"25","7","Klarer Himmel",769
"9/7/2016 14:00","364",444,"26","7","Klarer Himmel",808
"9/7/2016 15:00","382",497,"26","9","Klarer Himmel",879
"9/7/2016 16:00","557",466,"27","6","Klarer Himmel",1023
"9/7/2016 17:00","603",587,"26","7","Klarer Himmel",1190
"9/7/2016 18:00","517",537,"25","7","Klarer Himmel",1054
"9/7/2016 19:00","457",455,"23","4","Klarer Himmel",912
"9/7/2016 20:00","281",371,"19","6","Klarer Himmel",652
"9/7/2016 21:00","220",259,"18","6","Klarer Himmel",479
"9/7/2016 22:00","137",269,"16","6","Klarer Himmel",406
"9/7/2016 23:00","77",189,"18","4","Klarer Himmel",266
"9/8/2016 0:00","85",133,"16","4","Klarer Himmel",218
"9/8/2016 1:00","41",89,"14","0","Klarer Himmel",130
"9/8/2016 2:00","8",55,"14","4","Klarer Himmel",63
"9/8/2016 3:00","12",48,"16","6","Klarer Himmel",60
"9/8/2016 4:00","15",44,"16","4","Klarer Himmel",59
"9/8/2016 5:00","39",48,"14","2","Klarer Himmel",87
"9/8/2016 6:00","130",66,"13","2","Nebel",196
"9/8/2016 7:00","565",216,"16","6","Klarer Himmel",781
"9/8/2016 8:00","492",356,"18","6","Klarer Himmel",848
"9/8/2016 9:00","449",297,"21","9","Klarer Himmel",746
"9/8/2016 10:00","301",242,"23","11","Klarer Himmel",543
"9/8/2016 11:00","340",250,"25","15","Klarer Himmel",590
"9/8/2016 12:00","391",346,"27","13","Klarer Himmel",737
"9/8/2016 13:00","348",412,"27","13","Klarer Himmel",760
"9/8/2016 14:00","453",444,"28","20","Klarer Himmel",897
"9/8/2016 15:00","467",446,"28","22","Klarer Himmel",913
"9/8/2016 16:00","497",508,"28","17","Klarer Himmel",1005
"9/8/2016 17:00","562",517,"27","22","Klarer Himmel",1079
"9/8/2016 18:00","511",504,"26","11","Klarer Himmel",1015
"9/8/2016 19:00","406",490,"22","4","Klarer Himmel",896
"9/8/2016 20:00","260",378,"20","0","Klarer Himmel",638
"9/8/2016 21:00","177",283,"19","0","Klarer Himmel",460
"9/8/2016 22:00","130",246,"17","0","Klarer Himmel",376
"9/8/2016 23:00","104",183,"19","9","Klarer Himmel",287
"9/9/2016 0:00","33",116,"19","9","Klarer Himmel",149
"9/9/2016 1:00","25",41,"18","9","teilweise bewölkt",66
"9/9/2016 2:00","10",19,"18","11","wolkig",29
"9/9/2016 3:00","9",17,"18","11","wolkig",26
"9/9/2016 4:00","18",8,"16","7","wolkig",26
"9/9/2016 5:00","35",17,"17","7","teilweise bewölkt",52
"9/9/2016 6:00","120",51,"15","6","Nebel",171
"9/9/2016 7:00","532",205,"16","9","wolkig",737
"9/9/2016 8:00","416",311,"16","9","wolkig",727
"9/9/2016 9:00","350",209,"16","7","wolkig",559
"9/9/2016 10:00","289",206,"18","7","wolkig",495
"9/9/2016 11:00","284",261,"18","7","wolkig",545
"9/9/2016 12:00","377",290,"20","9","teilweise bewölkt",667
"9/9/2016 13:00","398",447,"21","7","teilweise bewölkt",845
"9/9/2016 14:00","414",442,"23","9","teilweise bewölkt",856
"9/9/2016 15:00","412",449,"23","7","teilweise bewölkt",861
"9/9/2016 16:00","405",367,"24","6","teilweise bewölkt",772
"9/9/2016 17:00","429",381,"23","4","teilweise bewölkt",810
"9/9/2016 18:00","412",451,"23","6","Klarer Himmel",863
"9/9/2016 19:00","340",377,"19","4","Klarer Himmel",717
"9/9/2016 20:00","296",302,"16","0","Nebel",598
"9/9/2016 21:00","170",216,"15","0","Nebel",386
"9/9/2016 22:00","130",181,"14","0","Nebel",311
"9/9/2016 23:00","137",200,"13","0","Nebel",337
"9/10/2016 0:00","79",151,"12","0","Nebel",230
"9/10/2016 1:00","62",114,"12","0","Nebel",176
"9/10/2016 2:00","37",107,"11","0","Nebel",144
"9/10/2016 3:00","14",71,"10","0","Nebel",85
"9/10/2016 4:00","17",65,"10","0","Nebel",82
"9/10/2016 5:00","22",48,"10","0","Nebel",70
"9/10/2016 6:00","32",28,"10","0","Nebel",60
"9/10/2016 7:00","92",28,"11","0","Nebel",120
"9/10/2016 8:00","140",67,"15","0","Klarer Himmel",207
"9/10/2016 9:00","299",96,"18","4","Klarer Himmel",395
"9/10/2016 10:00","364",165,"21","2","Klarer Himmel",529
"9/10/2016 11:00","409",214,"23","4","Klarer Himmel",623
"9/10/2016 12:00","386",303,"24","6","Klarer Himmel",689
"9/10/2016 13:00","356",376,"26","7","Klarer Himmel",732
"9/10/2016 14:00","340",360,"26","9","Klarer Himmel",700
"9/10/2016 15:00","287",355,"27","11","Klarer Himmel",642
"9/10/2016 16:00","301",282,"26","11","Klarer Himmel",583
"9/10/2016 17:00","307",343,"27","11","Klarer Himmel",650
"9/10/2016 18:00","371",364,"26","7","Klarer Himmel",735
"9/10/2016 19:00","326",268,"23","6","Klarer Himmel",594
"9/10/2016 20:00","267",279,"20","4","Klarer Himmel",546
"9/10/2016 21:00","160",197,"18","4","Klarer Himmel",357
"9/10/2016 22:00","158",301,"17","0","Klarer Himmel",459
"9/10/2016 23:00","127",198,"16","0","Klarer Himmel",325
"9/11/2016 0:00","107",173,"15","0","Klarer Himmel",280
"9/11/2016 1:00","79",142,"15","0","Klarer Himmel",221
"9/11/2016 2:00","42",133,"14","0","Klarer Himmel",175
"9/11/2016 3:00","33",77,"13","0","Nebel",110
"9/11/2016 4:00","28",46,"13","0","Nebel",74
"9/11/2016 5:00","25",47,"12","0","Nebel",72
"9/11/2016 6:00","26",37,"13","2","Nebel",63
"9/11/2016 7:00","57",17,"13","0","Nebel",74
"9/11/2016 8:00","387",53,"15","0","Klarer Himmel",440
"9/11/2016 9:00","305",233,"18","4","Klarer Himmel",538
"9/11/2016 10:00","328",268,"21","0","Klarer Himmel",596
"9/11/2016 11:00","393",193,"22","6","Klarer Himmel",586
"9/11/2016 12:00","635",208,"23","6","Klarer Himmel",843
"9/11/2016 13:00","432",346,"24","6","wolkig",778
"9/11/2016 14:00","371",495,"24","6","wolkig",866
"9/11/2016 15:00","338",399,"24","6","wolkig",737
"9/11/2016 16:00","275",323,"25","6","wolkig",598
"9/11/2016 17:00","236",295,"25","6","wolkig",531
"9/11/2016 18:00","287",292,"24","4","wolkig",579
"9/11/2016 19:00","258",241,"21","0","Klarer Himmel",499
"9/11/2016 20:00","147",191,"18","4","Klarer Himmel",338
"9/11/2016 21:00","79",158,"17","4","Klarer Himmel",237
"9/11/2016 22:00","86",258,"17","4","Klarer Himmel",344
"9/11/2016 23:00","35",83,"16","2","Klarer Himmel",118
"9/12/2016 0:00","16",52,"16","0","Klarer Himmel",68
"9/12/2016 1:00","8",9,"15","0","Nebel",17
"9/12/2016 2:00","7",15,"14","0","Nebel",22
"9/12/2016 3:00","1",5,"14","4","Nebel",6
"9/12/2016 4:00","13",5,"14","2","Klarer Himmel",18
"9/12/2016 5:00","43",15,"13","0","Klarer Himmel",58
"9/12/2016 6:00","121",50,"13","2","Nebel",171
"9/12/2016 7:00","539",204,"13","2","Klarer Himmel",743
"9/12/2016 8:00","469",350,"18","0","Klarer Himmel",819
"9/12/2016 9:00","364",311,"21","7","Klarer Himmel",675
"9/12/2016 10:00","335",243,"23","6","teilweise bewölkt",578
"9/12/2016 11:00","277",233,"25","4","Klarer Himmel",510
"9/12/2016 12:00","368",359,"28","4","Klarer Himmel",727
"9/12/2016 13:00","333",334,"29","4","Klarer Himmel",667
"9/12/2016 14:00","403",390,"30","7","Klarer Himmel",793
"9/12/2016 15:00","403",444,"30","6","Klarer Himmel",847
"9/12/2016 16:00","498",440,"30","4","Klarer Himmel",938
"9/12/2016 17:00","546",527,"31","2","Klarer Himmel",1073
"9/12/2016 18:00","498",515,"28","6","Klarer Himmel",1013
"9/12/2016 19:00","393",412,"25","0","Klarer Himmel",805
"9/12/2016 20:00","280",332,"22","0","Klarer Himmel",612
"9/12/2016 21:00","173",253,"20","0","Klarer Himmel",426
"9/12/2016 22:00","97",251,"19","0","Klarer Himmel",348
"9/12/2016 23:00","49",133,"18","0","Klarer Himmel",182
"9/13/2016 0:00","28",115,"17","0","Klarer Himmel",143
"9/13/2016 1:00","17",51,"17","0","Klarer Himmel",68
"9/13/2016 2:00","8",28,"17","0","Klarer Himmel",36
"9/13/2016 3:00","2",20,"19","4","Nebel",22
"9/13/2016 4:00","14",5,"18","0","Klarer Himmel",19
"9/13/2016 5:00","32",22,"16","0","Klarer Himmel",54
"9/13/2016 6:00","127",56,"18","2","Klarer Himmel",183
"9/13/2016 7:00","548",221,"19","2","Klarer Himmel",769
"9/13/2016 8:00","507",366,"22","2","Klarer Himmel",873
"9/13/2016 9:00","455",297,"23","7","Klarer Himmel",752
"9/13/2016 10:00","318",266,"25","9","Klarer Himmel",584
"9/13/2016 11:00","297",243,"28","7","Klarer Himmel",540
"9/13/2016 12:00","350",400,"30","7","Klarer Himmel",750
"9/13/2016 13:00","387",380,"31","9","Klarer Himmel",767
"9/13/2016 14:00","457",393,"32","9","Klarer Himmel",850
"9/13/2016 15:00","479",430,"33","9","Klarer Himmel",909
"9/13/2016 16:00","492",435,"33","11","Klarer Himmel",927
"9/13/2016 17:00","497",534,"32","6","Klarer Himmel",1031
"9/13/2016 18:00","503",568,"31","6","Klarer Himmel",1071
"9/13/2016 19:00","502",454,"26","4","Klarer Himmel",956
"9/13/2016 20:00","287",363,"24","6","Klarer Himmel",650
"9/13/2016 21:00","173",291,"24","6","Klarer Himmel",464
"9/13/2016 22:00","126",275,"24","7","Klarer Himmel",401
"9/13/2016 23:00","61",226,"21","2","Klarer Himmel",287
"9/14/2016 0:00","33",85,"19","6","Klarer Himmel",118
"9/14/2016 1:00","16",61,"22","6","Klarer Himmel",77
"9/14/2016 2:00","9",22,"22","4","Klarer Himmel",31
"9/14/2016 3:00","2",15,"22","6","Klarer Himmel",17
"9/14/2016 4:00","15",6,"22","6","Klarer Himmel",21
"9/14/2016 5:00","37",18,"21","6","Klarer Himmel",55
"9/14/2016 6:00","117",50,"19","6","Klarer Himmel",167
"9/14/2016 7:00","556",228,"20","6","Klarer Himmel",784
"9/14/2016 8:00","511",363,"21","4","Klarer Himmel",874
"9/14/2016 9:00","401",298,"23","4","Klarer Himmel",699
"9/14/2016 10:00","376",308,"26","9","Klarer Himmel",684
"9/14/2016 11:00","315",285,"29","9","Klarer Himmel",600
"9/14/2016 12:00","402",373,"30","9","Klarer Himmel",775
"9/14/2016 13:00","386",405,"31","9","Klarer Himmel",791
"9/14/2016 14:00","397",453,"31","6","Klarer Himmel",850
"9/14/2016 15:00","444",378,"32","9","Klarer Himmel",822
"9/14/2016 16:00","505",461,"32","4","Klarer Himmel",966
"9/14/2016 17:00","531",495,"31","6","Klarer Himmel",1026
"9/14/2016 18:00","523",547,"29","4","Klarer Himmel",1070
"9/14/2016 19:00","489",471,"27","6","Klarer Himmel",960
"9/14/2016 20:00","317",379,"22","6","Klarer Himmel",696
"9/14/2016 21:00","204",297,"23","7","Klarer Himmel",501
"9/14/2016 22:00","148",255,"24","7","Klarer Himmel",403
"9/14/2016 23:00","120",195,"23","6","Klarer Himmel",315
"9/15/2016 0:00","65",126,"23","9","Klarer Himmel",191
"9/15/2016 1:00","35",100,"22","7","Klarer Himmel",135
"9/15/2016 2:00","5",66,"21","9","Klarer Himmel",71
"9/15/2016 3:00","12",71,"21","7","Klarer Himmel",83
"9/15/2016 4:00","16",59,"19","7","Klarer Himmel",75
"9/15/2016 5:00","29",31,"17","6","Klarer Himmel",60
"9/15/2016 6:00","124",67,"17","7","Klarer Himmel",191
"9/15/2016 7:00","561",215,"18","4","Klarer Himmel",776
"9/15/2016 8:00","530",343,"20","6","Klarer Himmel",873
"9/15/2016 9:00","440",274,"22","9","Klarer Himmel",714
"9/15/2016 10:00","270",249,"24","11","Klarer Himmel",519
"9/15/2016 11:00","308",275,"25","11","Klarer Himmel",583
"9/15/2016 12:00","353",415,"27","11","Klarer Himmel",768
"9/15/2016 13:00","393",364,"29","13","Klarer Himmel",757
"9/15/2016 14:00","442",421,"29","13","Klarer Himmel",863
"9/15/2016 15:00","452",454,"29","17","Klarer Himmel",906
"9/15/2016 16:00","474",460,"29","13","Klarer Himmel",934
"9/15/2016 17:00","532",590,"28","15","Klarer Himmel",1122
"9/15/2016 18:00","529",509,"26","9","Klarer Himmel",1038
"9/15/2016 19:00","405",482,"24","7","Klarer Himmel",887
"9/15/2016 20:00","236",399,"23","7","Klarer Himmel",635
"9/15/2016 21:00","213",270,"24","11","Klarer Himmel",483
"9/15/2016 22:00","174",313,"23","7","Klarer Himmel",487
"9/15/2016 23:00","109",192,"21","11","Klarer Himmel",301
"9/16/2016 0:00","45",113,"22","13","Klarer Himmel",158
"9/16/2016 1:00","25",57,"20","15","Klarer Himmel",82
"9/16/2016 2:00","13",30,"20","11","Klarer Himmel",43
"9/16/2016 3:00","11",9,"19","15","Regen",20
"9/16/2016 4:00","12",14,"18","19","Regen",26
"9/16/2016 5:00","21",17,"16","13","Regen",38
"9/16/2016 6:00","99",48,"16","7","wolkig",147
"9/16/2016 7:00","464",184,"15","6","wolkig",648
"9/16/2016 8:00","406",291,"16","6","",697
"9/16/2016 9:00","353",214,"18","9","wolkig",567
"9/16/2016 10:00","279",216,"18","11","wolkig",495
"9/16/2016 11:00","299",235,"19","15","wolkig",534
"9/16/2016 12:00","331",299,"20","17","teilweise bewölkt",630
"9/16/2016 13:00","347",352,"21","15","wolkig",699
"9/16/2016 14:00","426",380,"22","17","wolkig",806
"9/16/2016 15:00","396",406,"22","17","wolkig",802
"9/16/2016 16:00","373",372,"21","13","wolkig",745
"9/16/2016 17:00","372",418,"21","7","wolkig",790
"9/16/2016 18:00","355",422,"20","7","wolkig",777
"9/16/2016 19:00","403",344,"19","6","wolkig",747
"9/16/2016 20:00","225",271,"17","6","Klarer Himmel",496
"9/16/2016 21:00","214",192,"17","4","Klarer Himmel",406
"9/16/2016 22:00","134",219,"16","2","Klarer Himmel",353
"9/16/2016 23:00","108",187,"16","2","Klarer Himmel",295
"9/17/2016 0:00","93",140,"16","0","Klarer Himmel",233
"9/17/2016 1:00","74",138,"15","4","Klarer Himmel",212
"9/17/2016 2:00","49",131,"15","0","Klarer Himmel",180
"9/17/2016 3:00","40",99,"15","0","Klarer Himmel",139
"9/17/2016 4:00","23",63,"14","0","Klarer Himmel",86
"9/17/2016 5:00","39",44,"14","0","Klarer Himmel",83
"9/17/2016 6:00","48",40,"14","0","Klarer Himmel",88
"9/17/2016 7:00","120",19,"14","0","Nebel",139
"9/17/2016 8:00","235",58,"15","0","wolkig",293
"9/17/2016 9:00","371",111,"17","2","Klarer Himmel",482
"9/17/2016 10:00","367",187,"18","7","Klarer Himmel",554
"9/17/2016 11:00","430",204,"18","7","Regen",634
"9/17/2016 12:00","392",297,"18","11","Regen",689
"9/17/2016 13:00","385",295,"19","11","Regen",680
"9/17/2016 14:00","323",308,"19","9","Regen",631
"9/17/2016 15:00","226",353,"19","9","Regen",579
"9/17/2016 16:00","238",381,"19","11","wolkig",619
"9/17/2016 17:00","195",343,"19","7","wolkig",538
"9/17/2016 18:00","287",297,"19","6","wolkig",584
"9/17/2016 19:00","235",222,"19","2","wolkig",457
"9/17/2016 20:00","180",203,"18","7","Klarer Himmel",383
"9/17/2016 21:00","155",158,"18","9","wolkig",313
"9/17/2016 22:00","94",122,"18","13","Klarer Himmel",216
"9/17/2016 23:00","114",173,"17","7","Klarer Himmel",287
"9/18/2016 0:00","109",139,"17","15","Klarer Himmel",248
"9/18/2016 1:00","60",130,"16","11","wolkig",190
"9/18/2016 2:00","46",118,"16","19","wolkig",164
"9/18/2016 3:00","30",100,"16","17","wolkig",130
"9/18/2016 4:00","18",77,"16","17","wolkig",95
"9/18/2016 5:00","10",31,"16","15","wolkig",41
"9/18/2016 6:00","29",19,"15","11","wolkig",48
"9/18/2016 7:00","33",21,"15","11","wolkig",54
"9/18/2016 8:00","52",21,"14","17","wolkig",73
"9/18/2016 9:00","139",51,"15","17","",190
"9/18/2016 10:00","234",80,"16","15","wolkig",314
"9/18/2016 11:00","186",144,"17","17","teilweise bewölkt",330
"9/18/2016 12:00","205",183,"19","9","teilweise bewölkt",388
"9/18/2016 13:00","218",204,"19","13","teilweise bewölkt",422
"9/18/2016 14:00","241",204,"19","13","teilweise bewölkt",445
"9/18/2016 15:00","226",225,"19","19","teilweise bewölkt",451
"9/18/2016 16:00","214",274,"20","15","Klarer Himmel",488
"9/18/2016 17:00","209",256,"19","11","Klarer Himmel",465
"9/18/2016 18:00","240",250,"18","11","Klarer Himmel",490
"9/18/2016 19:00","215",250,"18","13","Klarer Himmel",465
"9/18/2016 20:00","125",204,"17","11","Klarer Himmel",329
"9/18/2016 21:00","64",127,"17","13","Klarer Himmel",191
"9/18/2016 22:00","53",112,"16","11","Klarer Himmel",165
"9/18/2016 23:00","43",80,"16","11","Klarer Himmel",123
"9/19/2016 0:00","13",46,"15","11","Klarer Himmel",59
"9/19/2016 1:00","13",17,"15","9","Klarer Himmel",30
"9/19/2016 2:00","1",14,"15","9","Klarer Himmel",15
"9/19/2016 3:00","8",3,"15","9","Klarer Himmel",11
"9/19/2016 4:00","7",0,"14","9","Klarer Himmel",7
"9/19/2016 5:00","28",21,"14","11","Klarer Himmel",49
"9/19/2016 6:00","114",51,"14","15","Klarer Himmel",165
"9/19/2016 7:00","534",181,"12","13","Klarer Himmel",715
"9/19/2016 8:00","455",361,"14","11","Klarer Himmel",816
"9/19/2016 9:00","355",291,"15","19","Klarer Himmel",646
"9/19/2016 10:00","282",265,"16","17","Klarer Himmel",547
"9/19/2016 11:00","309",221,"16","15","teilweise bewölkt",530
"9/19/2016 12:00","325",267,"17","9","teilweise bewölkt",592
"9/19/2016 13:00","348",367,"17","6","teilweise bewölkt",715
"9/19/2016 14:00","354",362,"18","9","teilweise bewölkt",716
"9/19/2016 15:00","403",425,"18","6","wolkig",828
"9/19/2016 16:00","455",476,"18","4","wolkig",931
"9/19/2016 17:00","486",566,"17","2","wolkig",1052
"9/19/2016 18:00","469",542,"17","9","teilweise bewölkt",1011
"9/19/2016 19:00","342",389,"16","4","teilweise bewölkt",731
"9/19/2016 20:00","215",326,"15","0","teilweise bewölkt",541
"9/19/2016 21:00","154",198,"14","0","Klarer Himmel",352
"9/19/2016 22:00","108",154,"14","0","Klarer Himmel",262
"9/19/2016 23:00","52",159,"14","0","Klarer Himmel",211
"9/20/2016 0:00","21",110,"14","4","Klarer Himmel",131
"9/20/2016 1:00","13",47,"14","0","Klarer Himmel",60
"9/20/2016 2:00","17",22,"13","0","Klarer Himmel",39
"9/20/2016 3:00","1",7,"13","0","Klarer Himmel",8
"9/20/2016 4:00","10",8,"13","0","Klarer Himmel",18
"9/20/2016 5:00","41",15,"13","0","wolkig",56
"9/20/2016 6:00","129",46,"13","0","Klarer Himmel",175
"9/20/2016 7:00","498",227,"13","0","Klarer Himmel",725
"9/20/2016 8:00","493",378,"14","0","Klarer Himmel",871
"9/20/2016 9:00","407",281,"14","4","Klarer Himmel",688
"9/20/2016 10:00","267",246,"15","4","Klarer Himmel",513
"9/20/2016 11:00","309",249,"16","6","Klarer Himmel",558
"9/20/2016 12:00","323",291,"17","7","wolkig",614
"9/20/2016 13:00","352",357,"18","9","wolkig",709
"9/20/2016 14:00","435",361,"18","9","wolkig",796
"9/20/2016 15:00","387",409,"18","6","wolkig",796
"9/20/2016 16:00","466",496,"19","0","wolkig",962
"9/20/2016 17:00","545",566,"18","2","wolkig",1111
"9/20/2016 18:00","498",589,"17","0","Klarer Himmel",1087
"9/20/2016 19:00","390",453,"16","0","Klarer Himmel",843
"9/20/2016 20:00","237",272,"16","4","Klarer Himmel",509
"9/20/2016 21:00","164",195,"15","6","Klarer Himmel",359
"9/20/2016 22:00","134",274,"14","4","Klarer Himmel",408
"9/20/2016 23:00","72",192,"13","4","Klarer Himmel",264
"9/21/2016 0:00","27",119,"11","2","Klarer Himmel",146
"9/21/2016 1:00","17",68,"9","0","Klarer Himmel",85
"9/21/2016 2:00","5",29,"8","0","Klarer Himmel",34
"9/21/2016 3:00","4",13,"7","0","Klarer Himmel",17
"9/21/2016 4:00","13",8,"7","0","Nebel",21
"9/21/2016 5:00","40",15,"6","0","Nebel",55
"9/21/2016 6:00","123",43,"6","0","Nebel",166
"9/21/2016 7:00","568",193,"6","0","Nebel",761
"9/21/2016 8:00","517",353,"10","0","Klarer Himmel",870
"9/21/2016 9:00","462",318,"14","2","Klarer Himmel",780
"9/21/2016 10:00","357",268,"17","4","wolkig",625
"9/21/2016 11:00","454",262,"18","7","wolkig",716
"9/21/2016 12:00","389",360,"19","9","Klarer Himmel",749
"9/21/2016 13:00","361",401,"19","7","Klarer Himmel",762
"9/21/2016 14:00","363",458,"20","7","Klarer Himmel",821
"9/21/2016 15:00","465",423,"21","7","Klarer Himmel",888
"9/21/2016 16:00","493",497,"20","6","Klarer Himmel",990
"9/21/2016 17:00","551",574,"20","6","Klarer Himmel",1125
"9/21/2016 18:00","450",513,"18","4","Klarer Himmel",963
"9/21/2016 19:00","441",441,"15","6","Klarer Himmel",882
"9/21/2016 20:00","269",332,"12","0","Klarer Himmel",601
"9/21/2016 21:00","180",255,"11","4","Klarer Himmel",435
"9/21/2016 22:00","144",285,"10","0","Klarer Himmel",429
"9/21/2016 23:00","138",170,"10","4","Klarer Himmel",308
"9/22/2016 0:00","107",125,"8","0","Klarer Himmel",232
"9/22/2016 1:00","42",76,"8","0","Klarer Himmel",118
"9/22/2016 2:00","17",75,"8","0","Klarer Himmel",92
"9/22/2016 3:00","5",68,"8","4","Klarer Himmel",73
"9/22/2016 4:00","16",30,"8","2","Klarer Himmel",46
"9/22/2016 5:00","37",26,"7","2","",63
"9/22/2016 6:00","117",55,"7","4","Nebel",172
"9/22/2016 7:00","560",213,"8","2","Nebel",773
"9/22/2016 8:00","492",353,"9","2","Klarer Himmel",845
"9/22/2016 9:00","417",259,"13","6","Klarer Himmel",676
"9/22/2016 10:00","302",231,"16","7","Klarer Himmel",533
"9/22/2016 11:00","369",241,"18","9","Klarer Himmel",610
"9/22/2016 12:00","347",325,"20","13","Klarer Himmel",672
"9/22/2016 13:00","343",366,"20","9","Klarer Himmel",709
"9/22/2016 14:00","399",355,"21","11","Klarer Himmel",754
"9/22/2016 15:00","415",397,"22","9","Klarer Himmel",812
"9/22/2016 16:00","513",519,"21","9","Klarer Himmel",1032
"9/22/2016 17:00","531",535,"20","9","Klarer Himmel",1066
"9/22/2016 18:00","505",508,"17","2","Klarer Himmel",1013
"9/22/2016 19:00","344",477,"16","0","Klarer Himmel",821
"9/22/2016 20:00","228",362,"13","0","Klarer Himmel",590
"9/22/2016 21:00","144",236,"13","0","Klarer Himmel",380
"9/22/2016 22:00","115",216,"12","0","Klarer Himmel",331
"9/22/2016 23:00","62",149,"12","0","Klarer Himmel",211
"9/23/2016 0:00","38",86,"11","0","Klarer Himmel",124
"9/23/2016 1:00","24",57,"10","0","",81
"9/23/2016 2:00","6",34,"9","0","Nebel",40
"9/23/2016 3:00","6",22,"9","0","Nebel",28
"9/23/2016 4:00","11",14,"9","0","Nebel",25
"9/23/2016 5:00","33",23,"10","2","Nebel",56
"9/23/2016 6:00","102",48,"9","2","Nebel",150
"9/23/2016 7:00","477",183,"9","0","Nebel",660
"9/23/2016 8:00","485",281,"11","6","Klarer Himmel",766
"9/23/2016 9:00","397",240,"14","6","Klarer Himmel",637
"9/23/2016 10:00","308",193,"15","4","Regen",501
"9/23/2016 11:00","333",258,"16","2","wolkig",591
"9/23/2016 12:00","333",304,"19","11","teilweise bewölkt",637
"9/23/2016 13:00","379",385,"21","13","teilweise bewölkt",764
"9/23/2016 14:00","347",408,"21","17","teilweise bewölkt",755
"9/23/2016 15:00","429",427,"20","15","teilweise bewölkt",856
"9/23/2016 16:00","419",379,"21","13","teilweise bewölkt",798
"9/23/2016 17:00","412",380,"21","19","teilweise bewölkt",792
"9/23/2016 18:00","380",328,"19","17","teilweise bewölkt",708
"9/23/2016 19:00","335",361,"16","6","Klarer Himmel",696
"9/23/2016 20:00","306",250,"13","2","Klarer Himmel",556
"9/23/2016 21:00","158",210,"11","0","Klarer Himmel",368
"9/23/2016 22:00","107",167,"10","0","Klarer Himmel",274
"9/23/2016 23:00","102",158,"9","0","Nebel",260
"9/24/2016 0:00","98",155,"8","0","Nebel",253
"9/24/2016 1:00","74",157,"7","0","Nebel",231
"9/24/2016 2:00","28",112,"7","0","Nebel",140
"9/24/2016 3:00","19",98,"7","0","Nebel",117
"9/24/2016 4:00","10",79,"7","4","Nebel",89
"9/24/2016 5:00","24",44,"7","2","Nebel",68
"9/24/2016 6:00","28",24,"8","6","Nebel",52
"9/24/2016 7:00","57",30,"9","4","Klarer Himmel",87
"9/24/2016 8:00","134",64,"10","6","teilweise bewölkt",198
"9/24/2016 9:00","290",82,"12","6","teilweise bewölkt",372
"9/24/2016 10:00","360",151,"15","9","Klarer Himmel",511
"9/24/2016 11:00","439",232,"18","11","Klarer Himmel",671
"9/24/2016 12:00","485",281,"21","11","",766
"9/24/2016 13:00","429",268,"23","15","Klarer Himmel",697
"9/24/2016 14:00","328",362,"23","15","Klarer Himmel",690
"9/24/2016 15:00","251",326,"24","9","Klarer Himmel",577
"9/24/2016 16:00","237",378,"23","9","Klarer Himmel",615
"9/24/2016 17:00","270",321,"23","7","Klarer Himmel",591
"9/24/2016 18:00","294",347,"19","4","Klarer Himmel",641
"9/24/2016 19:00","275",308,"15","2","Klarer Himmel",583
"9/24/2016 20:00","213",217,"13","0","Klarer Himmel",430
"9/24/2016 21:00","189",120,"13","4","Klarer Himmel",309
"9/24/2016 22:00","119",137,"15","7","Klarer Himmel",256
"9/24/2016 23:00","142",156,"14","6","Klarer Himmel",298
"9/25/2016 0:00","109",149,"12","6","Klarer Himmel",258
"9/25/2016 1:00","78",165,"12","4","Klarer Himmel",243
"9/25/2016 2:00","26",112,"12","4","Klarer Himmel",138
"9/25/2016 3:00","27",127,"12","6","Klarer Himmel",154
"9/25/2016 4:00","25",61,"11","7","Klarer Himmel",86
"9/25/2016 5:00","16",39,"11","7","Klarer Himmel",55
"9/25/2016 6:00","27",40,"10","4","Klarer Himmel",67
"9/25/2016 7:00","27",16,"10","7","Klarer Himmel",43
"9/25/2016 8:00","61",19,"12","7","Klarer Himmel",80
"9/25/2016 9:00","162",63,"15","13","Klarer Himmel",225
"9/25/2016 10:00","244",109,"18","15","Klarer Himmel",353
"9/25/2016 11:00","269",197,"22","11","Klarer Himmel",466
"9/25/2016 12:00","333",277,"23","13","Klarer Himmel",610
"9/25/2016 13:00","376",259,"25","17","Klarer Himmel",635
"9/25/2016 14:00","426",315,"26","11","Klarer Himmel",741
"9/25/2016 15:00","429",288,"27","13","Klarer Himmel",717
"9/25/2016 16:00","305",333,"27","20","Klarer Himmel",638
"9/25/2016 17:00","296",336,"26","13","Klarer Himmel",632
"9/25/2016 18:00","295",352,"22","6","Klarer Himmel",647
"9/25/2016 19:00","248",280,"18","0","Klarer Himmel",528
"9/25/2016 20:00","144",233,"21","24","Klarer Himmel",377
"9/25/2016 21:00","63",98,"18","20","Klarer Himmel",161
"9/25/2016 22:00","60",191,"17","11","Klarer Himmel",251
"9/25/2016 23:00","46",75,"17","9","Klarer Himmel",121
"9/26/2016 0:00","20",50,"16","11","Klarer Himmel",70
"9/26/2016 1:00","7",17,"15","7","Klarer Himmel",24
"9/26/2016 2:00","8",4,"14","6","wolkig",12
"9/26/2016 3:00","3",6,"14","4","wolkig",9
"9/26/2016 4:00","10",4,"14","4","wolkig",14
"9/26/2016 5:00","40",13,"14","6","Klarer Himmel",53
"9/26/2016 6:00","96",49,"13","6","Klarer Himmel",145
"9/26/2016 7:00","581",224,"12","4","Nebel",805
"9/26/2016 8:00","474",345,"13","0","Klarer Himmel",819
"9/26/2016 9:00","409",300,"14","6","Klarer Himmel",709
"9/26/2016 10:00","363",319,"17","4","Klarer Himmel",682
"9/26/2016 11:00","324",252,"19","7","Klarer Himmel",576
"9/26/2016 12:00","350",303,"20","2","",653
"9/26/2016 13:00","395",387,"20","7","teilweise bewölkt",782
"9/26/2016 14:00","382",362,"21","7","Klarer Himmel",744
"9/26/2016 15:00","439",387,"21","7","Klarer Himmel",826
"9/26/2016 16:00","494",483,"21","6","Klarer Himmel",977
"9/26/2016 17:00","519",565,"20","7","Klarer Himmel",1084
"9/26/2016 18:00","496",555,"16","0","Klarer Himmel",1051
"9/26/2016 19:00","362",439,"15","4","Klarer Himmel",801
"9/26/2016 20:00","207",310,"15","2","Klarer Himmel",517
"9/26/2016 21:00","149",167,"13","0","Klarer Himmel",316
"9/26/2016 22:00","107",199,"11","0","Klarer Himmel",306
"9/26/2016 23:00","67",185,"10","0","Klarer Himmel",252
"9/27/2016 0:00","32",101,"10","0","Klarer Himmel",133
"9/27/2016 1:00","21",78,"10","0","Klarer Himmel",99
"9/27/2016 2:00","18",32,"9","0","Klarer Himmel",50
"9/27/2016 3:00","5",11,"9","0","Klarer Himmel",16
"9/27/2016 4:00","10",7,"8","4","Klarer Himmel",17
"9/27/2016 5:00","39",15,"8","0","Nebel",54
"9/27/2016 6:00","119",43,"7","0","",162
"9/27/2016 7:00","542",211,"7","0","",753
"9/27/2016 8:00","543",405,"9","0","Klarer Himmel",948
"9/27/2016 9:00","447",329,"14","0","Klarer Himmel",776
"9/27/2016 10:00","335",247,"16","7","Klarer Himmel",582
"9/27/2016 11:00","331",275,"19","6","teilweise bewölkt",606
"9/27/2016 12:00","384",383,"20","7","teilweise bewölkt",767
"9/27/2016 13:00","497",368,"21","9","teilweise bewölkt",865
"9/27/2016 14:00","468",369,"22","11","teilweise bewölkt",837
"9/27/2016 15:00","422",425,"22","13","Klarer Himmel",847
"9/27/2016 16:00","512",523,"22","11","Klarer Himmel",1035
"9/27/2016 17:00","540",645,"22","13","Klarer Himmel",1185
"9/27/2016 18:00","483",637,"20","7","Klarer Himmel",1120
"9/27/2016 19:00","539",467,"14","6","Klarer Himmel",1006
"9/27/2016 20:00","327",323,"13","2","Klarer Himmel",650
"9/27/2016 21:00","171",286,"12","0","Klarer Himmel",457
"9/27/2016 22:00","141",264,"12","7","Klarer Himmel",405
"9/27/2016 23:00","90",275,"13","7","Klarer Himmel",365
"9/28/2016 0:00","47",100,"13","7","Klarer Himmel",147
"9/28/2016 1:00","28",61,"13","7","Klarer Himmel",89
"9/28/2016 2:00","11",49,"14","11","wolkig",60
"9/28/2016 3:00","7",11,"15","13","wolkig",18
"9/28/2016 4:00","13",6,"15","11","wolkig",19
"9/28/2016 5:00","46",13,"15","17","teilweise bewölkt",59
"9/28/2016 6:00","114",48,"15","11","wolkig",162
"9/28/2016 7:00","524",210,"16","13","teilweise bewölkt",734
"9/28/2016 8:00","548",400,"16","19","wolkig",948
"9/28/2016 9:00","508",364,"17","19","wolkig",872
"9/28/2016 10:00","376",281,"18","24","wolkig",657
"9/28/2016 11:00","431",252,"19","26","wolkig",683
"9/28/2016 12:00","399",377,"20","28","wolkig",776
"9/28/2016 13:00","406",374,"20","32","wolkig",780
"9/28/2016 14:00","406",391,"21","24","wolkig",797
"9/28/2016 15:00","437",480,"21","24","wolkig",917
"9/28/2016 16:00","518",453,"21","28","Klarer Himmel",971
"9/28/2016 17:00","541",550,"22","26","Klarer Himmel",1091
"9/28/2016 18:00","511",573,"21","19","Klarer Himmel",1084
"9/28/2016 19:00","495",451,"20","19","Klarer Himmel",946
"9/28/2016 20:00","289",348,"20","13","wolkig",637
"9/28/2016 21:00","203",247,"20","13","wolkig",450
"9/28/2016 22:00","176",232,"19","15","Klarer Himmel",408
"9/28/2016 23:00","135",171,"19","17","wolkig",306
"9/29/2016 0:00","98",147,"19","19","wolkig",245
"9/29/2016 1:00","36",165,"19","17","wolkig",201
"9/29/2016 2:00","31",99,"19","22","wolkig",130
"9/29/2016 3:00","12",97,"19","20","Klarer Himmel",109
"9/29/2016 4:00","22",62,"18","20","wolkig",84
"9/29/2016 5:00","37",36,"18","20","wolkig",73
"9/29/2016 6:00","127",61,"18","20","wolkig",188
"9/29/2016 7:00","516",222,"17","20","Klarer Himmel",738
"9/29/2016 8:00","533",348,"18","22","Klarer Himmel",881
"9/29/2016 9:00","474",359,"18","20","Klarer Himmel",833
"9/29/2016 10:00","381",296,"20","26","wolkig",677
"9/29/2016 11:00","320",277,"20","30","wolkig",597
"9/29/2016 12:00","374",308,"21","37","wolkig",682
"9/29/2016 13:00","401",402,"21","33","wolkig",803
"9/29/2016 14:00","458",433,"20","28","wolkig",891
"9/29/2016 15:00","485",458,"21","32","wolkig",943
"9/29/2016 16:00","462",481,"20","28","wolkig",943
"9/29/2016 17:00","473",548,"20","33","wolkig",1021
"9/29/2016 18:00","472",502,"20","30","wolkig",974
"9/29/2016 19:00","313",382,"19","26","wolkig",695
"9/29/2016 20:00","221",272,"18","39","Regen",493
"9/29/2016 21:00","164",193,"16","26","Regen",357
"9/29/2016 22:00","109",169,"15","19","wolkig",278
"9/29/2016 23:00","84",135,"15","19","Regen",219
"9/30/2016 0:00","39",82,"15","15","Regen",121
"9/30/2016 1:00","19",63,"15","13","wolkig",82
"9/30/2016 2:00","10",30,"14","13","wolkig",40
"9/30/2016 3:00","9",35,"14","7","wolkig",44
"9/30/2016 4:00","13",21,"14","9","wolkig",34
"9/30/2016 5:00","28",25,"14","9","wolkig",53
"9/30/2016 6:00","98",53,"14","9","wolkig",151
"9/30/2016 7:00","490",172,"13","7","",662
"9/30/2016 8:00","442",262,"14","9","wolkig",704
"9/30/2016 9:00","343",270,"15","15","wolkig",613
"9/30/2016 10:00","315",247,"15","15","wolkig",562
"9/30/2016 11:00","350",265,"16","17","wolkig",615
"9/30/2016 12:00","353",306,"16","20","wolkig",659
"9/30/2016 13:00","435",393,"17","24","wolkig",828
"9/30/2016 14:00","397",350,"18","24","wolkig",747
"9/30/2016 15:00","387",385,"19","24","teilweise bewölkt",772
"9/30/2016 16:00","358",357,"18","28","Klarer Himmel",715
"9/30/2016 17:00","379",431,"18","17","Klarer Himmel",810
"9/30/2016 18:00","358",413,"17","9","Klarer Himmel",771
"9/30/2016 19:00","291",353,"13","7","Klarer Himmel",644
"9/30/2016 20:00","232",257,"11","2","Klarer Himmel",489
"9/30/2016 21:00","151",186,"9","0","Klarer Himmel",337
"9/30/2016 22:00","95",180,"8","0","Klarer Himmel",275
"9/30/2016 23:00","134",173,"9","4","Klarer Himmel",307
"10/1/2016 0:00","112",154,"9","2","Klarer Himmel",266
"10/1/2016 1:00","87",135,"10","4","Klarer Himmel",222
"10/1/2016 2:00","46",78,"10","6","Klarer Himmel",124
"10/1/2016 3:00","44",68,"10","6","Regen",112
"10/1/2016 4:00","28",69,"10","2","Regen",97
"10/1/2016 5:00","35",59,"10","4","wolkig",94
"10/1/2016 6:00","37",21,"11","2","wolkig",58
"10/1/2016 7:00","63",15,"11","6","wolkig",78
"10/1/2016 8:00","108",41,"11","6","wolkig",149
"10/1/2016 9:00","246",79,"12","6","wolkig",325
"10/1/2016 10:00","271",129,"13","7","Regen",400
"10/1/2016 11:00","296",132,"14","7","Regen",428
"10/1/2016 12:00","364",274,"15","11","wolkig",638
"10/1/2016 13:00","326",225,"16","7","wolkig",551
"10/1/2016 14:00","259",257,"16","6","wolkig",516
"10/1/2016 15:00","268",243,"16","6","wolkig",511
"10/1/2016 16:00","249",270,"16","7","wolkig",519
"10/1/2016 17:00","284",295,"16","7","wolkig",579
"10/1/2016 18:00","206",283,"16","7","wolkig",489
"10/1/2016 19:00","212",252,"13","6","teilweise bewölkt",464
"10/1/2016 20:00","182",154,"12","7","Klarer Himmel",336
"10/1/2016 21:00","142",138,"11","4","wolkig",280
"10/1/2016 22:00","56",100,"11","6","Regen",156
"10/1/2016 23:00","87",123,"11","7","wolkig",210
"10/2/2016 0:00","46",99,"11","7","Regen",145
"10/2/2016 1:00","47",106,"11","7","",153
"10/2/2016 2:00","29",59,"11","13","",88
"10/2/2016 3:00","21",73,"11","11","Klarer Himmel",94
"10/2/2016 4:00","11",53,"10","11","Klarer Himmel",64
"10/2/2016 5:00","8",32,"10","6","Klarer Himmel",40
"10/2/2016 6:00","17",26,"9","9","Klarer Himmel",43
"10/2/2016 7:00","32",10,"9","11","teilweise bewölkt",42
"10/2/2016 8:00","38",23,"11","11","teilweise bewölkt",61
"10/2/2016 9:00","152",42,"12","17","teilweise bewölkt",194
"10/2/2016 10:00","146",71,"13","19","wolkig",217
"10/2/2016 11:00","192",111,"12","17","Regen",303
"10/2/2016 12:00","90",113,"12","17","wolkig",203
"10/2/2016 13:00","153",110,"12","13","wolkig",263
"10/2/2016 14:00","144",149,"13","19","wolkig",293
"10/2/2016 15:00","226",204,"14","15","wolkig",430
"10/2/2016 16:00","263",163,"14","17","wolkig",426
"10/2/2016 17:00","269",215,"14","17","Regen",484
"10/2/2016 18:00","197",206,"12","17","Regen",403
"10/2/2016 19:00","169",139,"12","15","wolkig",308
"10/2/2016 20:00","109",104,"12","13","Regen",213
"10/2/2016 21:00","97",107,"12","13","Regen",204
"10/2/2016 22:00","42",75,"12","13","wolkig",117
"10/2/2016 23:00","63",87,"13","11","Regen",150
"10/3/2016 0:00","44",50,"12","13","wolkig",94
"10/3/2016 1:00","27",45,"11","17","wolkig",72
"10/3/2016 2:00","24",43,"9","9","teilweise bewölkt",67
"10/3/2016 3:00","11",21,"9","6","wolkig",32
"10/3/2016 4:00","15",12,"10","6","wolkig",27
"10/3/2016 5:00","16",26,"10","4","wolkig",42
"10/3/2016 6:00","26",11,"10","9","wolkig",37
"10/3/2016 7:00","266",65,"10","0","Nebel",331
"10/3/2016 8:00","223",86,"11","2","wolkig",309
"10/3/2016 9:00","415",132,"11","4","wolkig",547
"10/3/2016 10:00","399",125,"12","9","wolkig",524
"10/3/2016 11:00","633",200,"13","9","wolkig",833
"10/3/2016 12:00","622",186,"15","9","teilweise bewölkt",808
"10/3/2016 13:00","779",323,"16","11","teilweise bewölkt",1102
"10/3/2016 14:00","653",309,"16","7","wolkig",962
"10/3/2016 15:00","658",385,"14","2","Regen",1043
"10/3/2016 16:00","312",312,"13","7","Regen",624
"10/3/2016 17:00","209",224,"13","4","wolkig",433
"10/3/2016 18:00","211",172,"13","2","Regen",383
"10/3/2016 19:00","158",127,"12","2","Nebel",285
"10/3/2016 20:00","97",123,"10","6","Nebel",220
"10/3/2016 21:00","63",142,"9","4","Nebel",205
"10/3/2016 22:00","51",106,"9","0","Nebel",157
"10/3/2016 23:00","36",66,"10","0","Nebel",102
"10/4/2016 0:00","12",32,"11","9","wolkig",44
"10/4/2016 1:00","13",10,"10","2","wolkig",23
"10/4/2016 2:00","3",4,"11","17","wolkig",7
"10/4/2016 3:00","2",5,"11","17","wolkig",7
"10/4/2016 4:00","14",3,"11","11","wolkig",17
"10/4/2016 5:00","27",12,"12","15","wolkig",39
"10/4/2016 6:00","114",40,"11","9","wolkig",154
"10/4/2016 7:00","452",214,"11","4","teilweise bewölkt",666
"10/4/2016 8:00","503",359,"11","6","teilweise bewölkt",862
"10/4/2016 9:00","458",406,"12","17","wolkig",864
"10/4/2016 10:00","417",248,"12","11","wolkig",665
"10/4/2016 11:00","371",267,"14","9","wolkig",638
"10/4/2016 12:00","390",403,"15","17","teilweise bewölkt",793
"10/4/2016 13:00","351",431,"15","13","teilweise bewölkt",782
"10/4/2016 14:00","439",624,"16","15","teilweise bewölkt",1063
"10/4/2016 15:00","573",561,"17","15","teilweise bewölkt",1134
"10/4/2016 16:00","591",572,"16","15","teilweise bewölkt",1163
"10/4/2016 17:00","572",580,"15","11","teilweise bewölkt",1152
"10/4/2016 18:00","536",569,"14","7","teilweise bewölkt",1105
"10/4/2016 19:00","510",459,"12","7","teilweise bewölkt",969
"10/4/2016 20:00","255",336,"9","0","Klarer Himmel",591
"10/4/2016 21:00","190",216,"9","6","Klarer Himmel",406
"10/4/2016 22:00","130",236,"10","13","Klarer Himmel",366
"10/4/2016 23:00","95",168,"10","11","Klarer Himmel",263
"10/5/2016 0:00","45",124,"10","7","Klarer Himmel",169
"10/5/2016 1:00","19",130,"9","11","Klarer Himmel",149
"10/5/2016 2:00","11",90,"8","11","Klarer Himmel",101
"10/5/2016 3:00","5",32,"8","7","Klarer Himmel",37
"10/5/2016 4:00","15",13,"7","11","Klarer Himmel",28
"10/5/2016 5:00","36",8,"7","9","Klarer Himmel",44
"10/5/2016 6:00","122",53,"6","9","Klarer Himmel",175
"10/5/2016 7:00","555",212,"5","6","Klarer Himmel",767
"10/5/2016 8:00","525",401,"7","15","Klarer Himmel",926
"10/5/2016 9:00","468",362,"8","13","Klarer Himmel",830
"10/5/2016 10:00","439",402,"9","17","teilweise bewölkt",841
"10/5/2016 11:00","453",360,"","","",813
"10/5/2016 12:00","501",337,"12","11","teilweise bewölkt",838
"10/5/2016 13:00","476",420,"13","17","teilweise bewölkt",896
"10/5/2016 14:00","435",432,"13","24","",867
"10/5/2016 15:00","496",482,"12","15","Klarer Himmel",978
"10/5/2016 16:00","539",492,"13","17","Klarer Himmel",1031
"10/5/2016 17:00","600",621,"12","20","Klarer Himmel",1221
"10/5/2016 18:00","515",531,"10","11","Klarer Himmel",1046
"10/5/2016 19:00","513",487,"8","9","Klarer Himmel",1000
"10/5/2016 20:00","369",323,"7","9","Klarer Himmel",692
"10/5/2016 21:00","205",239,"8","13","Klarer Himmel",444
"10/5/2016 22:00","167",215,"6","7","Klarer Himmel",382
"10/5/2016 23:00","139",222,"6","11","Klarer Himmel",361
"10/6/2016 0:00","72",154,"5","2","teilweise bewölkt",226
"10/6/2016 1:00","46",125,"4","7","Klarer Himmel",171
"10/6/2016 2:00","20",131,"6","15","Klarer Himmel",151
"10/6/2016 3:00","7",101,"6","13","wolkig",108
"10/6/2016 4:00","12",41,"7","9","wolkig",53
"10/6/2016 5:00","43",43,"7","11","wolkig",86
"10/6/2016 6:00","103",56,"8","13","wolkig",159
"10/6/2016 7:00","444",176,"8","13","wolkig",620
"10/6/2016 8:00","514",362,"8","13","wolkig",876
"10/6/2016 9:00","353",369,"8","19","wolkig",722
"10/6/2016 10:00","364",347,"9","19","wolkig",711
"10/6/2016 11:00","301",236,"9","13","Regen",537
"10/6/2016 12:00","357",343,"10","15","wolkig",700
"10/6/2016 13:00","454",355,"11","17","wolkig",809
"10/6/2016 14:00","472",404,"11","17","wolkig",876
"10/6/2016 15:00","570",457,"11","17","wolkig",1027
"10/6/2016 16:00","615",465,"11","19","wolkig",1080
"10/6/2016 17:00","591",479,"11","22","wolkig",1070
"10/6/2016 18:00","472",487,"10","15","wolkig",959
"10/6/2016 19:00","373",372,"10","19","wolkig",745
"10/6/2016 20:00","183",239,"11","19","wolkig",422
"10/6/2016 21:00","113",192,"10","19","wolkig",305
"10/6/2016 22:00","87",169,"10","15","wolkig",256
"10/6/2016 23:00","60",171,"10","17","wolkig",231
"10/7/2016 0:00","32",184,"10","19","wolkig",216
"10/7/2016 1:00","16",146,"10","20","wolkig",162
"10/7/2016 2:00","9",74,"10","22","wolkig",83
"10/7/2016 3:00","7",18,"10","17","wolkig",25
"10/7/2016 4:00","15",2,"10","19","wolkig",17
"10/7/2016 5:00","37",15,"10","11","wolkig",52
"10/7/2016 6:00","117",60,"10","15","wolkig",177
"10/7/2016 7:00","464",235,"10","15","wolkig",699
"10/7/2016 8:00","454",306,"10","11","wolkig",760
"10/7/2016 9:00","407",285,"11","15","wolkig",692
"10/7/2016 10:00","297",211,"11","13","wolkig",508
"10/7/2016 11:00","347",241,"12","9","wolkig",588
"10/7/2016 12:00","369",319,"13","11","wolkig",688
"10/7/2016 13:00","413",394,"14","15","teilweise bewölkt",807
"10/7/2016 14:00","396",401,"13","15","teilweise bewölkt",797
"10/7/2016 15:00","443",368,"13","17","wolkig",811
"10/7/2016 16:00","413",351,"14","15","wolkig",764
"10/7/2016 17:00","471",399,"13","19","wolkig",870
"10/7/2016 18:00","367",379,"12","17","wolkig",746
"10/7/2016 19:00","329",282,"12","11","wolkig",611
"10/7/2016 20:00","265",230,"12","17","wolkig",495
"10/7/2016 21:00","167",143,"11","11","Regen",310
"10/7/2016 22:00","107",158,"11","13","wolkig",265
"10/7/2016 23:00","88",131,"11","15","Regen",219
"10/8/2016 0:00","81",166,"10","11","wolkig",247
"10/8/2016 1:00","90",129,"10","11","wolkig",219
"10/8/2016 2:00","31",108,"10","11","wolkig",139
"10/8/2016 3:00","20",74,"8","7","Klarer Himmel",94
"10/8/2016 4:00","20",51,"7","4","Klarer Himmel",71
"10/8/2016 5:00","13",51,"6","2","Nebel",64
"10/8/2016 6:00","31",26,"5","4","Nebel",57
"10/8/2016 7:00","58",24,"6","0","Nebel",82
"10/8/2016 8:00","147",52,"8","6","teilweise bewölkt",199
"10/8/2016 9:00","263",78,"10","13","Klarer Himmel",341
"10/8/2016 10:00","359",112,"11","15","teilweise bewölkt",471
"10/8/2016 11:00","402",181,"12","13","teilweise bewölkt",583
"10/8/2016 12:00","446",248,"12","15","teilweise bewölkt",694
"10/8/2016 13:00","373",267,"12","22","teilweise bewölkt",640
"10/8/2016 14:00","327",330,"13","9","teilweise bewölkt",657
"10/8/2016 15:00","312",321,"13","11","teilweise bewölkt",633
"10/8/2016 16:00","241",286,"13","11","teilweise bewölkt",527
"10/8/2016 17:00","242",327,"12","15","teilweise bewölkt",569
"10/8/2016 18:00","236",323,"10","7","wolkig",559
"10/8/2016 19:00","266",250,"8","4","wolkig",516
"10/8/2016 20:00","225",245,"8","0","Klarer Himmel",470
"10/8/2016 21:00","126",133,"8","0","wolkig",259
"10/8/2016 22:00","102",142,"8","4","wolkig",244
"10/8/2016 23:00","125",131,"8","4","wolkig",256
"10/9/2016 0:00","106",148,"8","4","wolkig",254
"10/9/2016 1:00","77",149,"7","4","wolkig",226
"10/9/2016 2:00","55",121,"6","6","Klarer Himmel",176
"10/9/2016 3:00","27",85,"6","0","Klarer Himmel",112
"10/9/2016 4:00","13",63,"5","2","Nebel",76
"10/9/2016 5:00","17",52,"4","0","Nebel",69
"10/9/2016 6:00","23",17,"3","4","Nebel",40
"10/9/2016 7:00","27",14,"2","0","Nebel",41
"10/9/2016 8:00","57",22,"4","0","Nebel",79
"10/9/2016 9:00","110",55,"6","4","Klarer Himmel",165
"10/9/2016 10:00","191",68,"8","6","Klarer Himmel",259
"10/9/2016 11:00","158",108,"11","7","teilweise bewölkt",266
"10/9/2016 12:00","199",134,"11","13","wolkig",333
"10/9/2016 13:00","231",199,"11","9","wolkig",430
"10/9/2016 14:00","216",199,"12","9","wolkig",415
"10/9/2016 15:00","219",190,"12","11","wolkig",409
"10/9/2016 16:00","205",212,"11","9","wolkig",417
"10/9/2016 17:00","222",279,"11","7","wolkig",501
"10/9/2016 18:00","193",239,"10","6","Regen",432
"10/9/2016 19:00","176",232,"8","0","wolkig",408
"10/9/2016 20:00","99",149,"9","0","wolkig",248
"10/9/2016 21:00","55",109,"8","0","wolkig",164
"10/9/2016 22:00","50",130,"8","0","wolkig",180
"10/9/2016 23:00","40",57,"7","0","wolkig",97
"10/10/2016 0:00","22",41,"8","4","wolkig",63
"10/10/2016 1:00","11",19,"7","4","wolkig",30
"10/10/2016 2:00","3",9,"5","4","teilweise bewölkt",12
"10/10/2016 3:00","2",1,"7","7","wolkig",3
"10/10/2016 4:00","11",2,"7","0","wolkig",13
"10/10/2016 5:00","24",19,"6","7","wolkig",43
"10/10/2016 6:00","112",53,"6","6","Nebel",165
"10/10/2016 7:00","280",233,"6","4","Nebel",513
"10/10/2016 8:00","476",325,"6","6","Nebel",801
"10/10/2016 9:00","595",474,"6","4","Nebel",1069
"10/10/2016 10:00","368",234,"8","4","teilweise bewölkt",602
"10/10/2016 11:00","327",296,"10","4","teilweise bewölkt",623
"10/10/2016 12:00","405",302,"10","11","teilweise bewölkt",707
"10/10/2016 13:00","518",352,"10","11","wolkig",870
"10/10/2016 14:00","479",346,"11","9","wolkig",825
"10/10/2016 15:00","531",412,"11","11","wolkig",943
"10/10/2016 16:00","540",549,"11","9","wolkig",1089
"10/10/2016 17:00","541",617,"10","9","wolkig",1158
"10/10/2016 18:00","556",527,"8","6","teilweise bewölkt",1083
"10/10/2016 19:00","559",429,"6","0","teilweise bewölkt",988
"10/10/2016 20:00","338",303,"6","0","wolkig",641
"10/10/2016 21:00","199",212,"5","0","Nebel",411
"10/10/2016 22:00","113",210,"4","2","Nebel",323
"10/10/2016 23:00","89",225,"2","0","Nebel",314
"10/11/2016 0:00","49",166,"2","0","Nebel",215
"10/11/2016 1:00","37",149,"1","0","Nebel",186
"10/11/2016 2:00","11",103,"0","0","Nebel",114
"10/11/2016 3:00","9",75,"1","4","Nebel",84
"10/11/2016 4:00","15",31,"1","4","Nebel",46
"10/11/2016 5:00","24",34,"3","6","Nebel",58
"10/11/2016 6:00","106",44,"4","4","wolkig",150
"10/11/2016 7:00","261",324,"4","0","wolkig",585
"10/11/2016 8:00","487",386,"5","0","wolkig",873
"10/11/2016 9:00","440",334,"6","2","Regen",774
"10/11/2016 10:00","372",252,"7","4","Regen",624
"10/11/2016 11:00","372",308,"8","0","Regen",680
"10/11/2016 12:00","417",326,"9","2","wolkig",743
"10/11/2016 13:00","485",348,"9","2","wolkig",833
"10/11/2016 14:00","532",338,"10","2","wolkig",870
"10/11/2016 15:00","533",386,"10","6","wolkig",919
"10/11/2016 16:00","424",516,"10","6","wolkig",940
"10/11/2016 17:00","535",517,"10","6","wolkig",1052
"10/11/2016 18:00","520",559,"10","6","wolkig",1079
"10/11/2016 19:00","555",402,"9","6","wolkig",957
"10/11/2016 20:00","409",243,"9","6","Regen",652
"10/11/2016 21:00","237",180,"9","7","Regen",417
"10/11/2016 22:00","138",222,"9","11","Regen",360
"10/11/2016 23:00","122",191,"9","13","wolkig",313
"10/12/2016 0:00","83",139,"9","13","wolkig",222
"10/12/2016 1:00","33",159,"8","15","wolkig",192
"10/12/2016 2:00","12",110,"8","13","wolkig",122
"10/12/2016 3:00","8",119,"8","11","wolkig",127
"10/12/2016 4:00","12",85,"8","11","Regen",97
"10/12/2016 5:00","31",52,"8","9","wolkig",83
"10/12/2016 6:00","107",54,"7","13","wolkig",161
"10/12/2016 7:00","258",233,"7","13","wolkig",491
"10/12/2016 8:00","519",390,"7","9","wolkig",909
"10/12/2016 9:00","404",332,"8","13","wolkig",736
"10/12/2016 10:00","371",222,"8","9","wolkig",593
"10/12/2016 11:00","438",306,"8","11","Regen",744
"10/12/2016 12:00","483",345,"8","13","wolkig",828
"10/12/2016 13:00","533",347,"8","7","wolkig",880
"10/12/2016 14:00","468",416,"9","11","wolkig",884
"10/12/2016 15:00","463",446,"9","11","wolkig",909
"10/12/2016 16:00","488",508,"9","7","wolkig",996
"10/12/2016 17:00","449",584,"8","11","Regen",1033
"10/12/2016 18:00","471",503,"8","9","wolkig",974
"10/12/2016 19:00","512",364,"7","6","wolkig",876
"10/12/2016 20:00","409",282,"7","9","wolkig",691
"10/12/2016 21:00","375",246,"7","6","wolkig",621
"10/12/2016 22:00","197",187,"8","6","wolkig",384
"10/12/2016 23:00","294",193,"8","11","wolkig",487
"10/13/2016 0:00","186",191,"8","11","wolkig",377
"10/13/2016 1:00","83",171,"8","7","wolkig",254
"10/13/2016 2:00","42",246,"8","9","wolkig",288
"10/13/2016 3:00","10",193,"8","9","wolkig",203
"10/13/2016 4:00","19",90,"8","7","wolkig",109
"10/13/2016 5:00","48",51,"8","9","wolkig",99
"10/13/2016 6:00","90",68,"8","7","wolkig",158
"10/13/2016 7:00","265",221,"8","11","wolkig",486
"10/13/2016 8:00","399",349,"8","7","wolkig",748
"10/13/2016 9:00","396",319,"8","9","wolkig",715
"10/13/2016 10:00","290",187,"9","11","wolkig",477
"10/13/2016 11:00","399",256,"9","11","wolkig",655
"10/13/2016 12:00","413",323,"9","11","wolkig",736
"10/13/2016 13:00","489",328,"9","11","wolkig",817
"10/13/2016 14:00","465",668,"9","13","wolkig",1133
"10/13/2016 15:00","562",527,"10","17","wolkig",1089
"10/13/2016 16:00","713",464,"10","11","wolkig",1177
"10/13/2016 17:00","640",495,"9","15","wolkig",1135
"10/13/2016 18:00","531",481,"9","13","wolkig",1012
"10/13/2016 19:00","442",350,"9","11","wolkig",792
"10/13/2016 20:00","298",263,"8","13","wolkig",561
"10/13/2016 21:00","190",185,"8","15","wolkig",375
"10/13/2016 22:00","117",195,"8","11","wolkig",312
"10/13/2016 23:00","78",129,"8","13","wolkig",207
"10/14/2016 0:00","63",122,"8","13","teilweise bewölkt",185
"10/14/2016 1:00","46",128,"7","11","Klarer Himmel",174
"10/14/2016 2:00","32",132,"7","11","teilweise bewölkt",164
"10/14/2016 3:00","10",117,"7","13","teilweise bewölkt",127
"10/14/2016 4:00","16",63,"7","11","wolkig",79
"10/14/2016 5:00","28",51,"7","11","Klarer Himmel",79
"10/14/2016 6:00","90",62,"7","11","Klarer Himmel",152
"10/14/2016 7:00","253",171,"7","9","Klarer Himmel",424
"10/14/2016 8:00","382",331,"7","13","Klarer Himmel",713
"10/14/2016 9:00","390",237,"8","15","Klarer Himmel",627
"10/14/2016 10:00","345",155,"9","15","wolkig",500
"10/14/2016 11:00","354",218,"10","15","wolkig",572
"10/14/2016 12:00","401",340,"12","17","wolkig",741
"10/14/2016 13:00","438",350,"13","11","Klarer Himmel",788
"10/14/2016 14:00","465",371,"13","15","Klarer Himmel",836
"10/14/2016 15:00","442",350,"13","11","Klarer Himmel",792
"10/14/2016 16:00","385",346,"12","13","Klarer Himmel",731
"10/14/2016 17:00","437",345,"12","9","Klarer Himmel",782
"10/14/2016 18:00","395",402,"12","11","Klarer Himmel",797
"10/14/2016 19:00","342",328,"10","13","Klarer Himmel",670
"10/14/2016 20:00","286",229,"10","9","Klarer Himmel",515
"10/14/2016 21:00","187",189,"9","11","Klarer Himmel",376
"10/14/2016 22:00","136",157,"9","7","Klarer Himmel",293
"10/14/2016 23:00","129",167,"9","7","Klarer Himmel",296
"10/15/2016 0:00","128",189,"10","9","Regen",317
"10/15/2016 1:00","57",164,"10","9","Klarer Himmel",221
"10/15/2016 2:00","46",146,"10","6","Klarer Himmel",192
"10/15/2016 3:00","32",115,"10","6","Klarer Himmel",147
"10/15/2016 4:00","16",89,"9","6","Klarer Himmel",105
"10/15/2016 5:00","27",34,"9","9","Klarer Himmel",61
"10/15/2016 6:00","36",26,"8","4","Klarer Himmel",62
"10/15/2016 7:00","71",27,"8","7","teilweise bewölkt",98
"10/15/2016 8:00","105",66,"9","7","wolkig",171
"10/15/2016 9:00","226",61,"10","11","Regen",287
"10/15/2016 10:00","308",113,"11","9","wolkig",421
"10/15/2016 11:00","277",155,"11","9","",432
"10/15/2016 12:00","367",187,"12","7","wolkig",554
"10/15/2016 13:00","307",221,"13","17","Regen",528
"10/15/2016 14:00","233",233,"13","13","wolkig",466
"10/15/2016 15:00","209",260,"13","11","Regen",469
"10/15/2016 16:00","179",199,"13","9","Regen",378
"10/15/2016 17:00","204",272,"13","6","wolkig",476
"10/15/2016 18:00","204",265,"12","6","wolkig",469
"10/15/2016 19:00","241",257,"11","7","Nebel",498
"10/15/2016 20:00","217",204,"8","0","Nebel",421
"10/15/2016 21:00","180",142,"7","4","Nebel",322
"10/15/2016 22:00","129",142,"7","0","Nebel",271
"10/15/2016 23:00","104",135,"7","2","Nebel",239
"10/16/2016 0:00","111",130,"5","6","Nebel",241
"10/16/2016 1:00","88",140,"4","0","Nebel",228
"10/16/2016 2:00","52",104,"5","0","Nebel",156
"10/16/2016 3:00","27",98,"5","0","Nebel",125
"10/16/2016 4:00","18",64,"6","4","Nebel",82
"10/16/2016 5:00","15",39,"6","4","Nebel",54
"10/16/2016 6:00","33",28,"6","4","Nebel",61
"10/16/2016 7:00","24",15,"5","4","Nebel",39
"10/16/2016 8:00","42",38,"6","4","Nebel",80
"10/16/2016 9:00","135",44,"8","4","Klarer Himmel",179
"10/16/2016 10:00","206",81,"10","6","Klarer Himmel",287
"10/16/2016 11:00","200",128,"12","7","Klarer Himmel",328
"10/16/2016 12:00","272",172,"15","7","Klarer Himmel",444
"10/16/2016 13:00","318",215,"17","7","Klarer Himmel",533
"10/16/2016 14:00","418",251,"18","9","Klarer Himmel",669
"10/16/2016 15:00","429",297,"18","6","Klarer Himmel",726
"10/16/2016 16:00","335",316,"17","6","Klarer Himmel",651
"10/16/2016 17:00","312",400,"16","4","Klarer Himmel",712
"10/16/2016 18:00","266",280,"13","6","Klarer Himmel",546
"10/16/2016 19:00","177",237,"13","6","Klarer Himmel",414
"10/16/2016 20:00","99",175,"13","6","Klarer Himmel",274
"10/16/2016 21:00","54",138,"12","7","Klarer Himmel",192
"10/16/2016 22:00","75",156,"12","7","Klarer Himmel",231
"10/16/2016 23:00","39",83,"11","11","Klarer Himmel",122
"10/17/2016 0:00","22",52,"11","7","Klarer Himmel",74
"10/17/2016 1:00","6",16,"11","7","Klarer Himmel",22
"10/17/2016 2:00","4",7,"11","7","Klarer Himmel",11
"10/17/2016 3:00","4",0,"10","6","Klarer Himmel",4
"10/17/2016 4:00","10",3,"10","2","Klarer Himmel",13
"10/17/2016 5:00","36",20,"10","6","Klarer Himmel",56
"10/17/2016 6:00","86",70,"10","6","Klarer Himmel",156
"10/17/2016 7:00","548",307,"10","6","Klarer Himmel",855
"10/17/2016 8:00","539",462,"10","2","Klarer Himmel",1001
"10/17/2016 9:00","669",452,"11","7","Klarer Himmel",1121
"10/17/2016 10:00","534",313,"13","7","wolkig",847
"10/17/2016 11:00","542",631,"15","7","Klarer Himmel",1173
"10/17/2016 12:00","604",527,"15","9","wolkig",1131
"10/17/2016 13:00","695",664,"16","7","wolkig",1359
"10/17/2016 14:00","658",543,"15","13","wolkig",1201
"10/17/2016 15:00","630",767,"15","7","wolkig",1397
"10/17/2016 16:00","696",621,"15","7","wolkig",1317
"10/17/2016 17:00","802",741,"14","6","Klarer Himmel",1543
"10/17/2016 18:00","541",632,"13","6","Klarer Himmel",1173
"10/17/2016 19:00","565",461,"12","6","Klarer Himmel",1026
"10/17/2016 20:00","272",279,"10","0","Nebel",551
"10/17/2016 21:00","184",296,"10","4","Nebel",480
"10/17/2016 22:00","87",269,"9","2","Nebel",356
"10/17/2016 23:00","74",210,"7","7","Nebel",284
"10/18/2016 0:00","44",95,"9","4","Nebel",139
"10/18/2016 1:00","12",71,"10","6","Nebel",83
"10/18/2016 2:00","9",17,"9","4","Nebel",26
"10/18/2016 3:00","9",2,"7","4","Nebel",11
"10/18/2016 4:00","13",2,"7","4","Nebel",15
"10/18/2016 5:00","33",18,"7","4","Nebel",51
"10/18/2016 6:00","111",56,"8","6","Nebel",167
"10/18/2016 7:00","590",521,"8","7","Nebel",1111
"10/18/2016 8:00","636",552,"8","6","Nebel",1188
"10/18/2016 9:00","691",819,"10","13","wolkig",1510
"10/18/2016 10:00","695",365,"11","15","wolkig",1060
"10/18/2016 11:00","799",653,"12","15","wolkig",1452
"10/18/2016 12:00","819",472,"14","17","wolkig",1291
"10/18/2016 13:00","795",777,"15","20","wolkig",1572
"10/18/2016 14:00","628",455,"15","19","wolkig",1083
"10/18/2016 15:00","811",742,"14","13","Regen",1553
"10/18/2016 16:00","652",592,"13","15","Regen",1244
"10/18/2016 17:00","662",711,"13","17","Regen",1373
"10/18/2016 18:00","577",531,"12","17","Regen",1108
"10/18/2016 19:00","361",404,"11","15","Regen",765
"10/18/2016 20:00","245",232,"9","4","Regen",477
"10/18/2016 21:00","210",264,"10","11","wolkig",474
"10/18/2016 22:00","164",239,"10","11","Klarer Himmel",403
"10/18/2016 23:00","98",159,"9","13","",257
"10/19/2016 0:00","86",105,"8","9","teilweise bewölkt",191
"10/19/2016 1:00","22",49,"8","11","wolkig",71
"10/19/2016 2:00","7",59,"9","15","Regen",66
"10/19/2016 3:00","12",75,"8","17","wolkig",87
"10/19/2016 4:00","14",50,"7","17","wolkig",64
"10/19/2016 5:00","31",36,"8","17","wolkig",67
"10/19/2016 6:00","91",52,"7","13","Regen",143
"10/19/2016 7:00","525",437,"7","15","Regen",962
"10/19/2016 8:00","626",431,"8","15","Regen",1057
"10/19/2016 9:00","432",531,"8","11","Regen",963
"10/19/2016 10:00","343",271,"7","15","Regen",614
"10/19/2016 11:00","395",331,"7","11","Regen",726
"10/19/2016 12:00","343",287,"7","13","Regen",630
"10/19/2016 13:00","498",313,"7","17","Regen",811
"10/19/2016 14:00","411",262,"7","19","Regen",673
"10/19/2016 15:00","390",392,"7","20","Regen",782
"10/19/2016 16:00","356",411,"8","15","wolkig",767
"10/19/2016 17:00","485",489,"7","9","wolkig",974
"10/19/2016 18:00","507",369,"8","7","wolkig",876
"10/19/2016 19:00","540",500,"7","11","wolkig",1040
"10/19/2016 20:00","314",343,"7","9","Regen",657
"10/19/2016 21:00","178",282,"8","4","Regen",460
"10/19/2016 22:00","197",289,"7","11","Regen",486
"10/19/2016 23:00","163",239,"7","7","wolkig",402
"10/20/2016 0:00","312",166,"6","4","wolkig",478
"10/20/2016 1:00","157",165,"5","2","Nebel",322
"10/20/2016 2:00","57",155,"5","0","Nebel",212
"10/20/2016 3:00","102",163,"4","2","Nebel",265
"10/20/2016 4:00","53",103,"2","0","Nebel",156
"10/20/2016 5:00","40",26,"3","0","Nebel",66
"10/20/2016 6:00","79",55,"4","4","Nebel",134
"10/20/2016 7:00","425",469,"4","0","Nebel",894
"10/20/2016 8:00","557",427,"4","6","Nebel",984
"10/20/2016 9:00","606",519,"6","0","Nebel",1125
"10/20/2016 10:00","658",355,"7","2","wolkig",1013
"10/20/2016 11:00","619",551,"8","4","wolkig",1170
"10/20/2016 12:00","560",471,"9","6","wolkig",1031
"10/20/2016 13:00","623",640,"9","6","wolkig",1263
"10/20/2016 14:00","640",435,"9","7","wolkig",1075
"10/20/2016 15:00","629",614,"9","7","wolkig",1243
"10/20/2016 16:00","645",611,"9","7","wolkig",1256
"10/20/2016 17:00","661",608,"8","4","wolkig",1269
"10/20/2016 18:00","481",415,"8","9","Regen",896
"10/20/2016 19:00","409",385,"8","6","wolkig",794
"10/20/2016 20:00","247",277,"8","6","wolkig",524
"10/20/2016 21:00","130",207,"7","6","wolkig",337
"10/20/2016 22:00","123",239,"7","7","wolkig",362
"10/20/2016 23:00","122",180,"7","7","wolkig",302
"10/21/2016 0:00","67",99,"7","4","wolkig",166
"10/21/2016 1:00","64",80,"7","11","wolkig",144
"10/21/2016 2:00","16",49,"7","11","wolkig",65
"10/21/2016 3:00","6",32,"5","6","Nebel",38
"10/21/2016 4:00","13",23,"6","9","wolkig",36
"10/21/2016 5:00","29",28,"6","9","wolkig",57
"10/21/2016 6:00","91",43,"6","6","wolkig",134
"10/21/2016 7:00","365",316,"6","13","wolkig",681
"10/21/2016 8:00","458",421,"6","9","wolkig",879
"10/21/2016 9:00","467",452,"6","11","wolkig",919
"10/21/2016 10:00","625",293,"7","9","wolkig",918
"10/21/2016 11:00","531",483,"7","13","wolkig",1014
"10/21/2016 12:00","540",382,"8","11","wolkig",922
"10/21/2016 13:00","545",462,"9","19","wolkig",1007
"10/21/2016 14:00","449",415,"8","22","Regen",864
"10/21/2016 15:00","410",387,"8","17","Regen",797
"10/21/2016 16:00","339",329,"8","13","Regen",668
"10/21/2016 17:00","272",290,"8","11","Regen",562
"10/21/2016 18:00","242",246,"8","11","Regen",488
"10/21/2016 19:00","246",214,"8","9","Regen",460
"10/21/2016 20:00","225",177,"8","7","Regen",402
"10/21/2016 21:00","169",160,"8","6","wolkig",329
"10/21/2016 22:00","106",123,"8","4","wolkig",229
"10/21/2016 23:00","109",105,"8","4","wolkig",214
"10/22/2016 0:00","74",109,"8","6","wolkig",183
"10/22/2016 1:00","103",112,"8","6","wolkig",215
"10/22/2016 2:00","53",98,"8","7","wolkig",151
"10/22/2016 3:00","37",106,"7","7","wolkig",143
"10/22/2016 4:00","25",72,"7","7","wolkig",97
"10/22/2016 5:00","20",39,"7","7","wolkig",59
"10/22/2016 6:00","27",26,"7","7","wolkig",53
"10/22/2016 7:00","84",24,"7","9","wolkig",108
"10/22/2016 8:00","116",72,"7","11","wolkig",188
"10/22/2016 9:00","233",106,"7","11","wolkig",339
"10/22/2016 10:00","293",128,"7","9","wolkig",421
"10/22/2016 11:00","289",150,"8","11","wolkig",439
"10/22/2016 12:00","383",248,"8","7","wolkig",631
"10/22/2016 13:00","354",296,"8","11","wolkig",650
"10/22/2016 14:00","350",339,"8","9","wolkig",689
"10/22/2016 15:00","360",356,"8","9","Regen",716
"10/22/2016 16:00","317",292,"8","6","wolkig",609
"10/22/2016 17:00","282",316,"8","4","wolkig",598
"10/22/2016 18:00","284",280,"7","4","Nebel",564
"10/22/2016 19:00","299",274,"7","0","",573
"10/22/2016 20:00","269",248,"6","0","Nebel",517
"10/22/2016 21:00","192",193,"5","2","Nebel",385
"10/22/2016 22:00","105",195,"4","4","Nebel",300
"10/22/2016 23:00","108",170,"2","0","Nebel",278
"10/23/2016 0:00","112",199,"2","2","Nebel",311
"10/23/2016 1:00","127",156,"1","0","Nebel",283
"10/23/2016 2:00","60",120,"1","4","Nebel",180
"10/23/2016 3:00","69",109,"1","2","Nebel",178
"10/23/2016 4:00","59",85,"1","4","Nebel",144
"10/23/2016 5:00","32",32,"1","2","Nebel",64
"10/23/2016 6:00","21",24,"1","2","Nebel",45
"10/23/2016 7:00","44",17,"1","4","Nebel",61
"10/23/2016 8:00","64",36,"2","4","Nebel",100
"10/23/2016 9:00","113",35,"2","6","Nebel",148
"10/23/2016 10:00","173",44,"3","4","Nebel",217
"10/23/2016 11:00","173",103,"4","6","Nebel",276
"10/23/2016 12:00","184",159,"6","6","wolkig",343
"10/23/2016 13:00","261",178,"7","6","teilweise bewölkt",439
"10/23/2016 14:00","322",196,"9","6","teilweise bewölkt",518
"10/23/2016 15:00","370",272,"10","7","teilweise bewölkt",642
"10/23/2016 16:00","402",316,"11","4","teilweise bewölkt",718
"10/23/2016 17:00","346",368,"9","4","teilweise bewölkt",714
"10/23/2016 18:00","318",307,"6","4","Nebel",625
"10/23/2016 19:00","201",257,"5","6","Nebel",458
"10/23/2016 20:00","116",321,"5","6","Nebel",437
"10/23/2016 21:00","80",146,"5","4","Nebel",226
"10/23/2016 22:00","70",169,"4","6","Nebel",239
"10/23/2016 23:00","36",73,"5","4","Nebel",109
"10/24/2016 0:00","18",28,"5","6","Nebel",46
"10/24/2016 1:00","9",13,"4","6","Nebel",22
"10/24/2016 2:00","6",4,"4","7","Nebel",10
"10/24/2016 3:00","2",1,"4","6","Nebel",3
"10/24/2016 4:00","11",3,"4","6","Nebel",14
"10/24/2016 5:00","26",18,"5","7","",44
"10/24/2016 6:00","118",53,"5","7","",171
"10/24/2016 7:00","624",399,"5","9","",1023
"10/24/2016 8:00","637",457,"5","6","",1094
"10/24/2016 9:00","570",597,"6","9","",1167
"10/24/2016 10:00","598",339,"7","11","Klarer Himmel",937
"10/24/2016 11:00","611",683,"8","9","Klarer Himmel",1294
"10/24/2016 12:00","562",526,"8","9","Klarer Himmel",1088
"10/24/2016 13:00","694",652,"9","6","Klarer Himmel",1346
"10/24/2016 14:00","568",456,"9","7","Regen",1024
"10/24/2016 15:00","680",721,"8","7","Regen",1401
"10/24/2016 16:00","518",439,"8","9","Regen",957
"10/24/2016 17:00","680",725,"8","7","Regen",1405
"10/24/2016 18:00","579",479,"8","6","Regen",1058
"10/24/2016 19:00","476",467,"8","6","Regen",943
"10/24/2016 20:00","243",310,"8","4","Regen",553
"10/24/2016 21:00","154",214,"8","6","Regen",368
"10/24/2016 22:00","125",154,"8","4","wolkig",279
"10/24/2016 23:00","59",82,"8","7","wolkig",141
"10/25/2016 0:00","32",95,"8","6","wolkig",127
"10/25/2016 1:00","13",66,"8","6","Regen",79
"10/25/2016 2:00","12",40,"8","2","Regen",52
"10/25/2016 3:00","10",19,"8","6","Regen",29
"10/25/2016 4:00","16",12,"8","4","Regen",28
"10/25/2016 5:00","24",22,"8","4","Regen",46
"10/25/2016 6:00","95",54,"8","6","Regen",149
"10/25/2016 7:00","592",515,"8","4","wolkig",1107
"10/25/2016 8:00","787",556,"8","7","wolkig",1343
"10/25/2016 9:00","669",769,"8","7","wolkig",1438
"10/25/2016 10:00","577",351,"8","7","wolkig",928
"10/25/2016 11:00","641",653,"8","9","wolkig",1294
"10/25/2016 12:00","719",464,"9","7","wolkig",1183
"10/25/2016 13:00","635",745,"9","7","wolkig",1380
"10/25/2016 14:00","699",475,"9","6","wolkig",1174
"10/25/2016 15:00","779",721,"9","4","wolkig",1500
"10/25/2016 16:00","720",599,"9","4","wolkig",1319
"10/25/2016 17:00","844",877,"9","6","wolkig",1721
"10/25/2016 18:00","738",624,"7","0","Nebel",1362
"10/25/2016 19:00","698",597,"6","0","Nebel",1295
"10/25/2016 20:00","336",390,"7","2","Nebel",726
"10/25/2016 21:00","241",383,"4","0","Nebel",624
"10/25/2016 22:00","181",366,"5","4","Nebel",547
"10/25/2016 23:00","109",181,"4","4","Nebel",290
"10/26/2016 0:00","technische Störung",88,"2","2","Nebel",88
"10/26/2016 1:00","technische Störung",45,"2","0","Nebel",45
"10/26/2016 2:00","technische Störung",64,"2","0","Nebel",64
"10/26/2016 3:00","technische Störung",44,"3","2","wolkig",44
"10/26/2016 4:00","technische Störung",6,"4","0","wolkig",6
"10/26/2016 5:00","technische Störung",32,"5","0","wolkig",32
"10/26/2016 6:00","technische Störung",46,"5","0","wolkig",46
"10/26/2016 7:00","technische Störung",478,"5","0","wolkig",478
"10/26/2016 8:00","technische Störung",517,"6","0","wolkig",517
"10/26/2016 9:00","technische Störung",615,"7","6","wolkig",615
"10/26/2016 10:00","technische Störung",373,"8","2","wolkig",373
"10/26/2016 11:00","technische Störung",585,"9","0","wolkig",585
"10/26/2016 12:00","technische Störung",434,"10","6","wolkig",434
"10/26/2016 13:00","technische Störung",652,"10","4","wolkig",652
"10/26/2016 14:00","technische Störung",525,"10","4","wolkig",525
"10/26/2016 15:00","technische Störung",834,"11","4","wolkig",834
"10/26/2016 16:00","technische Störung",593,"11","6","wolkig",593
"10/26/2016 17:00","technische Störung",835,"10","6","",835
"10/26/2016 18:00","technische Störung",672,"8","6","Nebel",672
"10/26/2016 19:00","technische Störung",649,"8","6","wolkig",649
"10/26/2016 20:00","technische Störung",466,"8","7","wolkig",466
"10/26/2016 21:00","technische Störung",442,"8","6","wolkig",442
"10/26/2016 22:00","technische Störung",456,"8","7","wolkig",456
"10/26/2016 23:00","technische Störung",254,"9","9","wolkig",254
"10/27/2016 0:00","technische Störung",150,"9","7","",150
"10/27/2016 1:00","technische Störung",124,"9","6","wolkig",124
"10/27/2016 2:00","technische Störung",81,"9","6","wolkig",81
"10/27/2016 3:00","technische Störung",72,"9","7","wolkig",72
"10/27/2016 4:00","technische Störung",39,"9","7","wolkig",39
"10/27/2016 5:00","technische Störung",34,"9","6","wolkig",34
"10/27/2016 6:00","technische Störung",59,"9","7","wolkig",59
"10/27/2016 7:00","technische Störung",512,"10","9","wolkig",512
"10/27/2016 8:00","technische Störung",505,"10","9","wolkig",505
"10/27/2016 9:00","technische Störung",625,"10","9","wolkig",625
"10/27/2016 10:00","technische Störung",367,"10","11","wolkig",367
"10/27/2016 11:00","technische Störung",750,"11","11","wolkig",750
"10/27/2016 12:00","93",516,"12","13","wolkig",609
"10/27/2016 13:00","578",730,"12","13","wolkig",1308
"10/27/2016 14:00","526",475,"12","15","wolkig",1001
"10/27/2016 15:00","770",688,"12","17","wolkig",1458
"10/27/2016 16:00","658",567,"12","11","wolkig",1225
"10/27/2016 17:00","924",778,"12","13","wolkig",1702
"10/27/2016 18:00","706",643,"11","11","wolkig",1349
"10/27/2016 19:00","530",611,"11","9","wolkig",1141
"10/27/2016 20:00","362",427,"11","13","wolkig",789
"10/27/2016 21:00","257",336,"11","13","wolkig",593
"10/27/2016 22:00","174",344,"11","11","teilweise bewölkt",518
"10/27/2016 23:00","91",188,"11","17","wolkig",279
"10/28/2016 0:00","56",104,"11","17","wolkig",160
"10/28/2016 1:00","21",61,"12","15","wolkig",82
"10/28/2016 2:00","6",32,"11","15","teilweise bewölkt",38
"10/28/2016 3:00","6",34,"12","17","wolkig",40
"10/28/2016 4:00","14",24,"12","19","wolkig",38
"10/28/2016 5:00","28",22,"12","19","wolkig",50
"10/28/2016 6:00","115",57,"12","17","wolkig",172
"10/28/2016 7:00","479",410,"12","17","wolkig",889
"10/28/2016 8:00","559",431,"12","19","wolkig",990
"10/28/2016 9:00","538",453,"12","19","wolkig",991
"10/28/2016 10:00","607",306,"13","19","wolkig",913
"10/28/2016 11:00","590",493,"13","22","wolkig",1083
"10/28/2016 12:00","595",358,"13","24","Regen",953
"10/28/2016 13:00","549",616,"13","24","Regen",1165
"10/28/2016 14:00","472",437,"13","19","Regen",909
"10/28/2016 15:00","488",463,"13","20","wolkig",951
"10/28/2016 16:00","494",400,"13","19","Regen",894
"10/28/2016 17:00","433",516,"13","17","Regen",949
"10/28/2016 18:00","421",420,"13","15","Regen",841
"10/28/2016 19:00","429",318,"13","11","wolkig",747
"10/28/2016 20:00","381",270,"12","9","wolkig",651
"10/28/2016 21:00","206",260,"12","11","wolkig",466
"10/28/2016 22:00","146",232,"11","11","wolkig",378
"10/28/2016 23:00","100",199,"9","7","",299
"10/29/2016 0:00","137",177,"8","7","Nebel",314
"10/29/2016 1:00","93",144,"8","7","Nebel",237
"10/29/2016 2:00","36",115,"6","6","Nebel",151
"10/29/2016 3:00","44",70,"7","6","Nebel",114
"10/29/2016 4:00","25",39,"6","4","Nebel",64
"10/29/2016 5:00","22",30,"7","6","Nebel",52
"10/29/2016 6:00","29",20,"6","9","Nebel",49
"10/29/2016 7:00","71",25,"6","0","Nebel",96
"10/29/2016 8:00","141",61,"5","0","Nebel",202
"10/29/2016 9:00","278",137,"8","0","Nebel",415
"10/29/2016 10:00","329",160,"9","6","teilweise bewölkt",489
"10/29/2016 11:00","408",182,"11","7","teilweise bewölkt",590
"10/29/2016 12:00","441",255,"12","13","teilweise bewölkt",696
"10/29/2016 13:00","464",305,"13","13","teilweise bewölkt",769
"10/29/2016 14:00","392",378,"14","13","teilweise bewölkt",770
"10/29/2016 15:00","382",367,"13","9","teilweise bewölkt",749
"10/29/2016 16:00","326",379,"13","6","teilweise bewölkt",705
"10/29/2016 17:00","356",373,"11","6","teilweise bewölkt",729
"10/29/2016 18:00","312",438,"9","4","teilweise bewölkt",750
"10/29/2016 19:00","277",322,"8","6","teilweise bewölkt",599
"10/29/2016 20:00","225",282,"7","2","Nebel",507
"10/29/2016 21:00","216",231,"5","0","Nebel",447
"10/29/2016 22:00","128",193,"5","0","Nebel",321
"10/29/2016 23:00","118",226,"5","2","Klarer Himmel",344
"10/30/2016 0:00","92",207,"7","0","Klarer Himmel",299
"10/30/2016 1:00","105",190,"6","2","Nebel",295
"10/30/2016 2:00","156",238,"6","2","Nebel",394
"10/30/2016 3:00","45",70,"4","0","Nebel",115
"10/30/2016 4:00","35",37,"5","4","Nebel",72
"10/30/2016 5:00","19",31,"6","9","wolkig",50
"10/30/2016 6:00","23",19,"5","4","Nebel",42
"10/30/2016 7:00","31",12,"6","4","wolkig",43
"10/30/2016 8:00","56",48,"7","2","",104
"10/30/2016 9:00","158",65,"8","2","wolkig",223
"10/30/2016 10:00","210",135,"9","4","wolkig",345
"10/30/2016 11:00","227",113,"10","6","wolkig",340
"10/30/2016 12:00","226",176,"12","4","wolkig",402
"10/30/2016 13:00","287",195,"12","2","wolkig",482
"10/30/2016 14:00","303",214,"12","7","wolkig",517
"10/30/2016 15:00","353",272,"12","2","wolkig",625
"10/30/2016 16:00","316",304,"9","2","Nebel",620
"10/30/2016 17:00","337",323,"8","0","Nebel",660
"10/30/2016 18:00","241",253,"9","0","wolkig",494
"10/30/2016 19:00","223",256,"9","4","wolkig",479
"10/30/2016 20:00","127",239,"9","4","wolkig",366
"10/30/2016 21:00","91",167,"9","4","wolkig",258
"10/30/2016 22:00","62",157,"9","6","wolkig",219
"10/30/2016 23:00","29",76,"","","",105
"10/31/2016 0:00","25",34,"9","4","wolkig",59
"10/31/2016 1:00","6",27,"9","4","wolkig",33
"10/31/2016 2:00","2",4,"9","0","wolkig",6
"10/31/2016 3:00","4",5,"10","7","wolkig",9
"10/31/2016 4:00","0",1,"9","2","wolkig",1
"10/31/2016 5:00","27",20,"9","2","wolkig",47
"10/31/2016 6:00","92",51,"9","2","wolkig",143
"10/31/2016 7:00","503",362,"9","2","wolkig",865
"10/31/2016 8:00","525",421,"10","6","wolkig",946
"10/31/2016 9:00","562",519,"10","6","wolkig",1081
"10/31/2016 10:00","598",324,"11","2","wolkig",922
"10/31/2016 11:00","580",541,"13","4","wolkig",1121
"10/31/2016 12:00","594",453,"13","6","wolkig",1047
"10/31/2016 13:00","660",681,"15","6","wolkig",1341
"10/31/2016 14:00","590",521,"15","6","wolkig",1111
"10/31/2016 15:00","728",694,"14","9","wolkig",1422
"10/31/2016 16:00","663",563,"13","4","wolkig",1226
"10/31/2016 17:00","730",868,"11","4","teilweise bewölkt",1598
"10/31/2016 18:00","533",521,"9","4","Klarer Himmel",1054
"10/31/2016 19:00","484",581,"8","0","Nebel",1065
"10/31/2016 20:00","451",400,"8","4","Nebel",851
"10/31/2016 21:00","399",339,"6","2","Nebel",738
"10/31/2016 22:00","243",299,"5","2","Nebel",542
"10/31/2016 23:00","186",251,"6","6","Nebel",437
"11/1/2016 0:00","227",261,"technische Störung","technische Störung","",488
"11/1/2016 1:00","206",268,"technische Störung","technische Störung","",474
"11/1/2016 2:00","167",280,"technische Störung","technische Störung","",447
"11/1/2016 3:00","144",201,"technische Störung","technische Störung","",345
"11/1/2016 4:00","83",156,"technische Störung","technische Störung","",239
"11/1/2016 5:00","36",92,"technische Störung","technische Störung","",128
"11/1/2016 6:00","32",42,"technische Störung","technische Störung","",74
"11/1/2016 7:00","40",26,"technische Störung","technische Störung","",66
"11/1/2016 8:00","76",61,"technische Störung","technische Störung","",137
"11/1/2016 9:00","142",94,"technische Störung","technische Störung","",236
"11/1/2016 10:00","174",102,"technische Störung","technische Störung","",276
"11/1/2016 11:00","196",132,"technische Störung","technische Störung","",328
"11/1/2016 12:00","224",196,"technische Störung","technische Störung","",420
"11/1/2016 13:00","253",197,"technische Störung","technische Störung","",450
"11/1/2016 14:00","266",201,"technische Störung","technische Störung","",467
"11/1/2016 15:00","242",210,"technische Störung","technische Störung","",452
"11/1/2016 16:00","249",226,"technische Störung","technische Störung","",475
"11/1/2016 17:00","222",278,"technische Störung","technische Störung","",500
"11/1/2016 18:00","208",222,"technische Störung","technische Störung","",430
"11/1/2016 19:00","190",180,"technische Störung","technische Störung","",370
"11/1/2016 20:00","131",186,"technische Störung","technische Störung","",317
"11/1/2016 21:00","87",120,"technische Störung","technische Störung","",207
"11/1/2016 22:00","80",172,"technische Störung","technische Störung","",252
"11/1/2016 23:00","46",96,"technische Störung","technische Störung","",142
"11/2/2016 0:00","13",28,"4","9","Nebel",41
"11/2/2016 1:00","15",13,"5","9","Klarer Himmel",28
"11/2/2016 2:00","3",3,"4","9","teilweise bewölkt",6
"11/2/2016 3:00","4",3,"4","11","teilweise bewölkt",7
"11/2/2016 4:00","7",4,"4","7","teilweise bewölkt",11
"11/2/2016 5:00","34",20,"5","15","wolkig",54
"11/2/2016 6:00","117",55,"5","13","Klarer Himmel",172
"11/2/2016 7:00","594",399,"6","15","Regen",993
"11/2/2016 8:00","710",494,"6","17","teilweise bewölkt",1204
"11/2/2016 9:00","601",600,"8","28","wolkig",1201
"11/2/2016 10:00","488",360,"9","26","teilweise bewölkt",848
"11/2/2016 11:00","591",546,"9","20","Regen",1137
"11/2/2016 12:00","629",422,"10","22","wolkig",1051
"11/2/2016 13:00","668",602,"5","26","Regen",1270
"11/2/2016 14:00","580",483,"10","24","Regen",1063
"11/2/2016 15:00","599",763,"8","20","Regen",1362
"11/2/2016 16:00","612",526,"8","11","Regen",1138
"11/2/2016 17:00","692",872,"6","11","teilweise bewölkt",1564
"11/2/2016 18:00","567",613,"6","15","teilweise bewölkt",1180
"11/2/2016 19:00","571",572,"7","15","wolkig",1143
"11/2/2016 20:00","400",353,"6","11","teilweise bewölkt",753
"11/2/2016 21:00","247",221,"5","6","teilweise bewölkt",468
"11/2/2016 22:00","187",266,"5","4","wolkig",453
"11/2/2016 23:00","132",215,"5","0","wolkig",347
"11/3/2016 0:00","113",130,"6","2","wolkig",243
"11/3/2016 1:00","23",95,"5","6","wolkig",118
"11/3/2016 2:00","7",80,"6","7","wolkig",87
"11/3/2016 3:00","11",125,"6","7","wolkig",136
"11/3/2016 4:00","15",96,"6","9","wolkig",111
"11/3/2016 5:00","39",39,"5","4","wolkig",78
"11/3/2016 6:00","114",59,"3","6","Nebel",173
"11/3/2016 7:00","529",481,"4","6","Nebel",1010
"11/3/2016 8:00","686",498,"5","7","wolkig",1184
"11/3/2016 9:00","721",634,"6","7","wolkig",1355
"11/3/2016 10:00","593",365,"7","7","wolkig",958
"11/3/2016 11:00","639",645,"8","11","teilweise bewölkt",1284
"11/3/2016 12:00","570",488,"9","15","teilweise bewölkt",1058
"11/3/2016 13:00","656",731,"9","17","teilweise bewölkt",1387
"11/3/2016 14:00","624",504,"9","17","teilweise bewölkt",1128
"11/3/2016 15:00","616",700,"8","11","wolkig",1316
"11/3/2016 16:00","688",656,"8","11","Klarer Himmel",1344
"11/3/2016 17:00","771",782,"8","7","wolkig",1553
"11/3/2016 18:00","665",531,"7","7","Klarer Himmel",1196
"11/3/2016 19:00","511",604,"7","7","",1115
"11/3/2016 20:00","307",366,"7","9","",673
"11/3/2016 21:00","213",293,"7","9","wolkig",506
"11/3/2016 22:00","159",289,"7","7","wolkig",448
"11/3/2016 23:00","87",222,"7","11","wolkig",309
"11/4/2016 0:00","54",117,"7","9","wolkig",171
"11/4/2016 1:00","32",76,"7","11","wolkig",108
"11/4/2016 2:00","9",22,"7","13","Klarer Himmel",31
"11/4/2016 3:00","7",19,"7","15","Klarer Himmel",26
"11/4/2016 4:00","9",6,"7","15","Klarer Himmel",15
"11/4/2016 5:00","37",19,"7","13","wolkig",56
"11/4/2016 6:00","95",64,"7","15","Klarer Himmel",159
"11/4/2016 7:00","549",402,"7","11","Klarer Himmel",951
"11/4/2016 8:00","653",443,"7","17","wolkig",1096
"11/4/2016 9:00","558",483,"8","17","Klarer Himmel",1041
"11/4/2016 10:00","524",285,"8","15","Klarer Himmel",809
"11/4/2016 11:00","517",423,"9","13","wolkig",940
"11/4/2016 12:00","575",373,"10","15","wolkig",948
"11/4/2016 13:00","586",595,"10","17","wolkig",1181
"11/4/2016 14:00","537",454,"10","11","Klarer Himmel",991
"11/4/2016 15:00","493",536,"10","9","Klarer Himmel",1029
"11/4/2016 16:00","450",412,"8","6","Klarer Himmel",862
"11/4/2016 17:00","489",532,"7","7","Klarer Himmel",1021
"11/4/2016 18:00","390",386,"7","7","Klarer Himmel",776
"11/4/2016 19:00","355",331,"6","7","Klarer Himmel",686
"11/4/2016 20:00","238",255,"6","9","Klarer Himmel",493
"11/4/2016 21:00","165",195,"6","9","Klarer Himmel",360
"11/4/2016 22:00","129",189,"6","11","Klarer Himmel",318
"11/4/2016 23:00","124",179,"6","9","Klarer Himmel",303
"11/5/2016 0:00","105",152,"7","11","wolkig",257
"11/5/2016 1:00","51",131,"7","9","wolkig",182
"11/5/2016 2:00","48",113,"7","9","wolkig",161
"11/5/2016 3:00","47",72,"7","9","wolkig",119
"11/5/2016 4:00","19",66,"7","7","Regen",85
"11/5/2016 5:00","24",33,"6","9","Regen",57
"11/5/2016 6:00","21",17,"7","9","wolkig",38
"11/5/2016 7:00","100",31,"7","11","Regen",131
"11/5/2016 8:00","137",50,"7","13","wolkig",187
"11/5/2016 9:00","275",107,"7","17","wolkig",382
"11/5/2016 10:00","279",95,"7","13","wolkig",374
"11/5/2016 11:00","287",144,"8","15","wolkig",431
"11/5/2016 12:00","336",231,"8","11","wolkig",567
"11/5/2016 13:00","289",239,"8","17","wolkig",528
"11/5/2016 14:00","276",291,"9","19","teilweise bewölkt",567
"11/5/2016 15:00","305",256,"9","11","teilweise bewölkt",561
"11/5/2016 16:00","214",284,"7","7","wolkig",498
"11/5/2016 17:00","151",312,"6","7","wolkig",463
"11/5/2016 18:00","168",268,"6","7","wolkig",436
"11/5/2016 19:00","186",202,"5","9","Klarer Himmel",388
"11/5/2016 20:00","186",149,"6","11","wolkig",335
"11/5/2016 21:00","125",151,"6","13","teilweise bewölkt",276
"11/5/2016 22:00","66",131,"6","15","wolkig",197
"11/5/2016 23:00","84",101,"6","13","wolkig",185
"11/6/2016 0:00","71",135,"6","13","teilweise bewölkt",206
"11/6/2016 1:00","87",136,"6","15","wolkig",223
"11/6/2016 2:00","48",86,"5","11","teilweise bewölkt",134
"11/6/2016 3:00","21",77,"5","15","teilweise bewölkt",98
"11/6/2016 4:00","16",37,"5","13","wolkig",53
"11/6/2016 5:00","10",32,"5","19","wolkig",42
"11/6/2016 6:00","14",19,"5","17","wolkig",33
"11/6/2016 7:00","21",29,"5","13","wolkig",50
"11/6/2016 8:00","30",23,"6","19","wolkig",53
"11/6/2016 9:00","148",41,"6","17","wolkig",189
"11/6/2016 10:00","154",93,"6","17","wolkig",247
"11/6/2016 11:00","137",88,"7","19","wolkig",225
"11/6/2016 12:00","151",142,"7","22","wolkig",293
"11/6/2016 13:00","197",163,"7","20","wolkig",360
"11/6/2016 14:00","186",164,"7","20","wolkig",350
"11/6/2016 15:00","171",188,"7","13","Regen",359
"11/6/2016 16:00","142",167,"7","15","Regen",309
"11/6/2016 17:00","168",180,"6","9","Regen",348
"11/6/2016 18:00","127",139,"6","13","wolkig",266
"11/6/2016 19:00","146",162,"6","11","wolkig",308
"11/6/2016 20:00","81",123,"6","9","wolkig",204
"11/6/2016 21:00","62",103,"6","7","wolkig",165
"11/6/2016 22:00","33",108,"6","7","wolkig",141
"11/6/2016 23:00","26",63,"6","4","wolkig",89
"11/7/2016 0:00","14",26,"6","4","wolkig",40
"11/7/2016 1:00","2",11,"6","4","wolkig",13
"11/7/2016 2:00","4",7,"6","4","wolkig",11
"11/7/2016 3:00","1",2,"6","6","wolkig",3
"11/7/2016 4:00","6",7,"6","2","wolkig",13
"11/7/2016 5:00","27",21,"6","4","Regen",48
"11/7/2016 6:00","119",56,"6","2","Regen",175
"11/7/2016 7:00","568",346,"6","2","Regen",914
"11/7/2016 8:00","636",441,"6","2","Regen",1077
"11/7/2016 9:00","504",461,"6","9","Regen",965
"11/7/2016 10:00","471",274,"6","13","Regen",745
"11/7/2016 11:00","347",505,"5","9","Regen",852
"11/7/2016 12:00","352",314,"5","11","Regen",666
"11/7/2016 13:00","415",517,"5","13","Regen",932
"11/7/2016 14:00","366",304,"5","7","Regen",670
"11/7/2016 15:00","461",517,"4","13","Regen",978
"11/7/2016 16:00","539",416,"4","6","Regen",955
"11/7/2016 17:00","551",703,"4","13","Regen",1254
"11/7/2016 18:00","428",494,"3","15","Regen",922
"11/7/2016 19:00","323",397,"3","15","Regen",720
"11/7/2016 20:00","218",227,"3","15","Regen",445
"11/7/2016 21:00","138",196,"2","13","Regen",334
"11/7/2016 22:00","123",157,"2","13","Regen",280
"11/7/2016 23:00","49",80,"2","11","Regen",129
"11/8/2016 0:00","15",49,"2","11","Regen",64
"11/8/2016 1:00","9",25,"2","11","wolkig",34
"11/8/2016 2:00","3",9,"2","9","Regen",12
"11/8/2016 3:00","1",1,"2","11","wolkig",2
"11/8/2016 4:00","12",6,"2","9","wolkig",18
"11/8/2016 5:00","25",18,"2","9","wolkig",43
"11/8/2016 6:00","110",50,"2","11","wolkig",160
"11/8/2016 7:00","506",464,"2","9","wolkig",970
"11/8/2016 8:00","754",489,"2","7","wolkig",1243
"11/8/2016 9:00","626",678,"2","7","wolkig",1304
"11/8/2016 10:00","574",376,"3","11","wolkig",950
"11/8/2016 11:00","541",546,"3","7","wolkig",1087
"11/8/2016 12:00","665",422,"3","7","wolkig",1087
"11/8/2016 13:00","633",647,"3","7","wolkig",1280
"11/8/2016 14:00","570",400,"4","13","wolkig",970
"11/8/2016 15:00","677",730,"3","7","wolkig",1407
"11/8/2016 16:00","651",522,"2","6","teilweise bewölkt",1173
"11/8/2016 17:00","635",748,"0","4","Klarer Himmel",1383
"11/8/2016 18:00","565",535,"0","6","wolkig",1100
"11/8/2016 19:00","504",537,"0","6","wolkig",1041
"11/8/2016 20:00","314",331,"0","6","wolkig",645
"11/8/2016 21:00","172",277,"0","6","",449
"11/8/2016 22:00","166",285,"0","7","",451
"11/8/2016 23:00","74",134,"0","7","wolkig",208
"11/9/2016 0:00","31",92,"1","9","wolkig",123
"11/9/2016 1:00","27",36,"1","11","Schnee",63
"11/9/2016 2:00","13",18,"1","7","wolkig",31
"11/9/2016 3:00","6",11,"1","7","wolkig",17
"11/9/2016 4:00","17",10,"0","6","teilweise bewölkt",27
"11/9/2016 5:00","29",24,"0","4","",53
"11/9/2016 6:00","146",54,"0","4","wolkig",200
"11/9/2016 7:00","593",418,"0","6","teilweise bewölkt",1011
"11/9/2016 8:00","736",521,"0","6","teilweise bewölkt",1257
"11/9/2016 9:00","524",556,"1","6","wolkig",1080
"11/9/2016 10:00","524",363,"2","9","teilweise bewölkt",887
"11/9/2016 11:00","529",472,"3","7","teilweise bewölkt",1001
"11/9/2016 12:00","588",409,"4","7","wolkig",997
"11/9/2016 13:00","591",575,"4","11","wolkig",1166
"11/9/2016 14:00","571",422,"5","11","Regen",993
"11/9/2016 15:00","581",677,"4","7","Regen",1258
"11/9/2016 16:00","546",529,"4","6","Regen",1075
"11/9/2016 17:00","627",742,"4","7","Regen",1369
"11/9/2016 18:00","479",490,"3","6","Regen",969
"11/9/2016 19:00","440",488,"3","7","Regen",928
"11/9/2016 20:00","267",309,"3","7","Regen",576
"11/9/2016 21:00","191",220,"3","6","Regen",411
"11/9/2016 22:00","149",205,"3","6","Regen",354
"11/9/2016 23:00","101",237,"3","4","wolkig",338
"11/10/2016 0:00","75",117,"3","4","wolkig",192
"11/10/2016 1:00","38",94,"3","4","wolkig",132
"11/10/2016 2:00","11",54,"3","6","wolkig",65
"11/10/2016 3:00","5",64,"3","4","wolkig",69
"11/10/2016 4:00","15",37,"3","2","wolkig",52
"11/10/2016 5:00","31",26,"3","4","wolkig",57
"11/10/2016 6:00","111",54,"3","4","wolkig",165
"11/10/2016 7:00","550",395,"3","2","Regen",945
"11/10/2016 8:00","639",487,"3","2","Regen",1126
"11/10/2016 9:00","554",445,"3","2","Regen",999
"11/10/2016 10:00","494",148,"4","0","wolkig",642
"11/10/2016 11:00","416",516,"4","4","wolkig",932
"11/10/2016 12:00","440",362,"4","7","wolkig",802
"11/10/2016 13:00","499",554,"4","7","wolkig",1053
"11/10/2016 14:00","487",403,"4","4","wolkig",890
"11/10/2016 15:00","520",618,"4","6","wolkig",1138
"11/10/2016 16:00","572",469,"4","4","wolkig",1041
"11/10/2016 17:00","649",636,"4","4","wolkig",1285
"11/10/2016 18:00","547",460,"4","4","wolkig",1007
"11/10/2016 19:00","370",558,"4","6","wolkig",928
"11/10/2016 20:00","276",270,"4","7","wolkig",546
"11/10/2016 21:00","181",232,"4","7","wolkig",413
"11/10/2016 22:00","150",224,"4","9","wolkig",374
"11/10/2016 23:00","102",126,"4","6","wolkig",228
"11/11/2016 0:00","31",88,"4","7","Regen",119
"11/11/2016 1:00","22",60,"4","15","Regen",82
"11/11/2016 2:00","4",23,"3","15","Regen",27
"11/11/2016 3:00","3",26,"3","13","Regen",29
"11/11/2016 4:00","10",37,"3","17","Regen",47
"11/11/2016 5:00","28",25,"3","22","wolkig",53
"11/11/2016 6:00","108",62,"3","24","wolkig",170
"11/11/2016 7:00","479",343,"3","17","wolkig",822
"11/11/2016 8:00","579",411,"2","20","wolkig",990
"11/11/2016 9:00","413",436,"2","15","wolkig",849
"11/11/2016 10:00","511",290,"2","19","wolkig",801
"11/11/2016 11:00","497",349,"3","19","teilweise bewölkt",846
"11/11/2016 12:00","480",340,"3","11","teilweise bewölkt",820
"11/11/2016 13:00","444",508,"3","17","teilweise bewölkt",952
"11/11/2016 14:00","422",405,"3","13","wolkig",827
"11/11/2016 15:00","417",349,"3","11","wolkig",766
"11/11/2016 16:00","365",366,"2","7","wolkig",731
"11/11/2016 17:00","377",370,"2","9","wolkig",747
"11/11/2016 18:00","374",331,"1","7","wolkig",705
"11/11/2016 19:00","289",250,"1","4","wolkig",539
"11/11/2016 20:00","222",202,"1","9","wolkig",424
"11/11/2016 21:00","151",159,"-1","4","teilweise bewölkt",310
"11/11/2016 22:00","96",138,"-2","2","",234
"11/11/2016 23:00","89",149,"-3","0","Nebel",238
"11/12/2016 0:00","51",143,"-3","0","Nebel",194
"11/12/2016 1:00","48",88,"-2","4","Nebel",136
"11/12/2016 2:00","47",111,"-2","4","Nebel",158
"11/12/2016 3:00","12",85,"-2","7","Nebel",97
"11/12/2016 4:00","11",39,"-2","6","Nebel",50
"11/12/2016 5:00","12",32,"-2","4","Nebel",44
"11/12/2016 6:00","17",26,"-2","6","Nebel",43
"11/12/2016 7:00","88",30,"-2","7","Nebel",118
"11/12/2016 8:00","149",91,"-2","9","Nebel",240
"11/12/2016 9:00","213",110,"-1","7","",323
"11/12/2016 10:00","250",103,"1","9","",353
"11/12/2016 11:00","271",140,"2","13","Klarer Himmel",411
"11/12/2016 12:00","362",210,"3","13","Klarer Himmel",572
"11/12/2016 13:00","360",262,"3","19","Klarer Himmel",622
"11/12/2016 14:00","308",312,"3","17","Klarer Himmel",620
"11/12/2016 15:00","274",363,"3","9","wolkig",637
"11/12/2016 16:00","223",286,"1","6","Klarer Himmel",509
"11/12/2016 17:00","210",269,"1","9","wolkig",479
"11/12/2016 18:00","203",245,"1","9","Klarer Himmel",448
"11/12/2016 19:00","205",214,"1","11","Klarer Himmel",419
"11/12/2016 20:00","184",167,"1","9","Klarer Himmel",351
"11/12/2016 21:00","150",133,"1","7","Klarer Himmel",283
"11/12/2016 22:00","96",136,"1","11","Klarer Himmel",232
"11/12/2016 23:00","85",149,"1","7","Klarer Himmel",234
"11/13/2016 0:00","94",122,"1","7","Klarer Himmel",216
"11/13/2016 1:00","62",113,"1","7","Klarer Himmel",175
"11/13/2016 2:00","50",121,"1","7","Klarer Himmel",171
"11/13/2016 3:00","35",75,"1","7","Klarer Himmel",110
"11/13/2016 4:00","13",50,"1","7","Klarer Himmel",63
"11/13/2016 5:00","16",35,"1","11","Klarer Himmel",51
"11/13/2016 6:00","17",22,"1","9","Klarer Himmel",39
"11/13/2016 7:00","39",22,"1","11","Klarer Himmel",61
"11/13/2016 8:00","36",28,"1","7","Klarer Himmel",64
"11/13/2016 9:00","137",50,"1","9","Klarer Himmel",187
"11/13/2016 10:00","132",83,"2","9","Klarer Himmel",215
"11/13/2016 11:00","134",103,"3","11","Klarer Himmel",237
"11/13/2016 12:00","113",131,"3","7","Klarer Himmel",244
"11/13/2016 13:00","183",139,"4","7","Klarer Himmel",322
"11/13/2016 14:00","201",194,"4","6","Klarer Himmel",395
"11/13/2016 15:00","205",171,"3","6","Klarer Himmel",376
"11/13/2016 16:00","194",170,"2","6","Klarer Himmel",364
"11/13/2016 17:00","149",207,"1","6","Klarer Himmel",356
"11/13/2016 18:00","197",176,"1","6","Klarer Himmel",373
"11/13/2016 19:00","131",153,"0","4","Klarer Himmel",284
"11/13/2016 20:00","90",148,"-1","4","Klarer Himmel",238
"11/13/2016 21:00","54",92,"0","6","Klarer Himmel",146
"11/13/2016 22:00","56",160,"-1","4","Klarer Himmel",216
"11/13/2016 23:00","25",73,"-2","4","Klarer Himmel",98
"11/14/2016 0:00","11",26,"-2","6","Klarer Himmel",37
"11/14/2016 1:00","8",16,"-2","2","Klarer Himmel",24
"11/14/2016 2:00","3",12,"-2","2","Klarer Himmel",15
"11/14/2016 3:00","4",2,"-2","4","Klarer Himmel",6
"11/14/2016 4:00","7",2,"-3","4","Klarer Himmel",9
"11/14/2016 5:00","34",19,"-3","4","Klarer Himmel",53
"11/14/2016 6:00","115",51,"-3","6","Klarer Himmel",166
"11/14/2016 7:00","542",376,"-3","7","Klarer Himmel",918
"11/14/2016 8:00","649",460,"-2","6","Klarer Himmel",1109
"11/14/2016 9:00","481",547,"0","11","Klarer Himmel",1028
"11/14/2016 10:00","507",295,"2","9","Klarer Himmel",802
"11/14/2016 11:00","448",541,"3","11","Klarer Himmel",989
"11/14/2016 12:00","482",412,"4","15","Klarer Himmel",894
"11/14/2016 13:00","530",564,"4","13","Klarer Himmel",1094
"11/14/2016 14:00","495",383,"4","11","Klarer Himmel",878
"11/14/2016 15:00","620",641,"4","6","Klarer Himmel",1261
"11/14/2016 16:00","600",462,"4","6","Klarer Himmel",1062
"11/14/2016 17:00","686",825,"4","7","wolkig",1511
"11/14/2016 18:00","544",559,"3","6","Regen",1103
"11/14/2016 19:00","419",527,"4","11","Regen",946
"11/14/2016 20:00","226",305,"4","15","Regen",531
"11/14/2016 21:00","190",264,"4","17","Regen",454
"11/14/2016 22:00","116",219,"3","17","wolkig",335
"11/14/2016 23:00","64",81,"3","15","Regen",145
"11/15/2016 0:00","28",45,"3","13","Regen",73
"11/15/2016 1:00","10",29,"3","11","Regen",39
"11/15/2016 2:00","5",0,"3","11","Regen",5
"11/15/2016 3:00","6",2,"3","11","Regen",8
"11/15/2016 4:00","10",6,"4","11","Regen",16
"11/15/2016 5:00","33",13,"5","11","Regen",46
"11/15/2016 6:00","100",46,"5","11","Regen",146
"11/15/2016 7:00","468",424,"6","13","Regen",892
"11/15/2016 8:00","696",454,"6","13","Regen",1150
"11/15/2016 9:00","532",613,"6","15","Regen",1145
"11/15/2016 10:00","561",273,"7","13","Regen",834
"11/15/2016 11:00","502",514,"7","15","Regen",1016
"11/15/2016 12:00","575",365,"8","17","Regen",940
"11/15/2016 13:00","534",594,"8","15","Regen",1128
"11/15/2016 14:00","537",346,"9","15","Regen",883
"11/15/2016 15:00","491",585,"9","13","Regen",1076
"11/15/2016 16:00","572",469,"9","15","wolkig",1041
"11/15/2016 17:00","583",678,"10","15","Regen",1261
"11/15/2016 18:00","560",518,"","","",1078
"11/15/2016 19:00","447",466,"10","11","Regen",913
"11/15/2016 20:00","218",328,"10","11","Regen",546
"11/15/2016 21:00","160",251,"10","11","Regen",411
"11/15/2016 22:00","163",250,"10","9","Regen",413
"11/15/2016 23:00","65",144,"10","9","wolkig",209
"11/16/2016 0:00","40",71,"10","6","Regen",111
"11/16/2016 1:00","11",33,"10","6","wolkig",44
"11/16/2016 2:00","7",5,"10","7","wolkig",12
"11/16/2016 3:00","5",6,"10","7","Nebel",11
"11/16/2016 4:00","8",7,"10","7","Nebel",15
"11/16/2016 5:00","34",16,"10","7","Regen",50
"11/16/2016 6:00","139",53,"10","11","Regen",192
"11/16/2016 7:00","497",338,"10","13","Regen",835
"11/16/2016 8:00","704",449,"11","15","Regen",1153
"11/16/2016 9:00","400",457,"12","17","Regen",857
"11/16/2016 10:00","428",299,"13","19","wolkig",727
"11/16/2016 11:00","477",379,"13","20","Regen",856
"11/16/2016 12:00","531",365,"13","19","Regen",896
"11/16/2016 13:00","540",485,"13","20","wolkig",1025
"11/16/2016 14:00","478",373,"13","24","wolkig",851
"11/16/2016 15:00","537",612,"13","24","wolkig",1149
"11/16/2016 16:00","585",494,"12","17","wolkig",1079
"11/16/2016 17:00","647",650,"12","17","wolkig",1297
"11/16/2016 18:00","519",535,"12","15","wolkig",1054
"11/16/2016 19:00","449",470,"12","24","wolkig",919
"11/16/2016 20:00","327",302,"11","19","wolkig",629
"11/16/2016 21:00","245",237,"11","20","teilweise bewölkt",482
"11/16/2016 22:00","140",252,"11","17","teilweise bewölkt",392
"11/16/2016 23:00","106",163,"11","20","wolkig",269
"11/17/2016 0:00","89",106,"11","24","Regen",195
"11/17/2016 1:00","64",83,"10","20","wolkig",147
"11/17/2016 2:00","18",66,"9","11","wolkig",84
"11/17/2016 3:00","9",83,"9","11","Regen",92
"11/17/2016 4:00","18",66,"9","9","Regen",84
"11/17/2016 5:00","29",76,"8","6","Regen",105
"11/17/2016 6:00","92",49,"8","6","Regen",141
"11/17/2016 7:00","460",337,"8","6","wolkig",797
"11/17/2016 8:00","624",461,"8","13","Regen",1085
"11/17/2016 9:00","535",467,"9","15","wolkig",1002
"11/17/2016 10:00","564",337,"9","17","wolkig",901
"11/17/2016 11:00","530",517,"10","22","wolkig",1047
"11/17/2016 12:00","505",441,"11","20","wolkig",946
"11/17/2016 13:00","591",584,"11","24","wolkig",1175
"11/17/2016 14:00","508",395,"10","22","wolkig",903
"11/17/2016 15:00","546",601,"10","17","teilweise bewölkt",1147
"11/17/2016 16:00","544",455,"9","20","wolkig",999
"11/17/2016 17:00","645",591,"9","19","wolkig",1236
"11/17/2016 18:00","536",487,"11","26","Regen",1023
"11/17/2016 19:00","396",472,"10","28","Regen",868
"11/17/2016 20:00","254",291,"10","24","Regen",545
"11/17/2016 21:00","186",244,"11","20","wolkig",430
"11/17/2016 22:00","124",210,"12","22","wolkig",334
"11/17/2016 23:00","95",149,"11","22","wolkig",244
"11/18/2016 0:00","43",95,"11","19","Regen",138
"11/18/2016 1:00","24",72,"8","24","Regen",96
"11/18/2016 2:00","13",34,"8","7","Regen",47
"11/18/2016 3:00","9",27,"7","9","Regen",36
"11/18/2016 4:00","11",46,"7","4","Regen",57
"11/18/2016 5:00","25",22,"6","19","Regen",47
"11/18/2016 6:00","93",50,"6","13","teilweise bewölkt",143
"11/18/2016 7:00","407",283,"5","17","wolkig",690
"11/18/2016 8:00","544",391,"5","15","teilweise bewölkt",935
"11/18/2016 9:00","458",412,"6","19","teilweise bewölkt",870
"11/18/2016 10:00","561",258,"8","20","wolkig",819
"11/18/2016 11:00","460",339,"9","22","wolkig",799
"11/18/2016 12:00","465",347,"8","22","teilweise bewölkt",812
"11/18/2016 13:00","501",532,"9","28","teilweise bewölkt",1033
"11/18/2016 14:00","470",388,"9","26","teilweise bewölkt",858
"11/18/2016 15:00","471",408,"8","28","teilweise bewölkt",879
"11/18/2016 16:00","426",315,"7","20","teilweise bewölkt",741
"11/18/2016 17:00","420",414,"6","11","Klarer Himmel",834
"11/18/2016 18:00","297",357,"6","9","Regen",654
"11/18/2016 19:00","340",254,"5","19","teilweise bewölkt",594
"11/18/2016 20:00","251",218,"6","30","wolkig",469
"11/18/2016 21:00","200",150,"6","19","wolkig",350
"11/18/2016 22:00","126",179,"6","17","wolkig",305
"11/18/2016 23:00","112",180,"5","9","teilweise bewölkt",292
"11/19/2016 0:00","78",164,"6","9","wolkig",242
"11/19/2016 1:00","56",136,"4","9","teilweise bewölkt",192
"11/19/2016 2:00","32",156,"4","13","teilweise bewölkt",188
"11/19/2016 3:00","26",87,"4","13","teilweise bewölkt",113
"11/19/2016 4:00","19",57,"4","11","teilweise bewölkt",76
"11/19/2016 5:00","18",30,"4","11","teilweise bewölkt",48
"11/19/2016 6:00","38",9,"5","15","wolkig",47
"11/19/2016 7:00","95",19,"5","15","wolkig",114
"11/19/2016 8:00","146",79,"6","7","wolkig",225
"11/19/2016 9:00","272",103,"6","13","wolkig",375
"11/19/2016 10:00","273",95,"7","15","Regen",368
"11/19/2016 11:00","258",150,"6","17","Regen",408
"11/19/2016 12:00","270",198,"7","19","teilweise bewölkt",468
"11/19/2016 13:00","309",240,"7","22","teilweise bewölkt",549
"11/19/2016 14:00","253",268,"7","26","teilweise bewölkt",521
"11/19/2016 15:00","284",232,"7","17","teilweise bewölkt",516
"11/19/2016 16:00","228",249,"6","11","",477
"11/19/2016 17:00","211",271,"6","11","Klarer Himmel",482
"11/19/2016 18:00","241",269,"5","7","Klarer Himmel",510
"11/19/2016 19:00","202",182,"5","11","Klarer Himmel",384
"11/19/2016 20:00","166",181,"5","9","teilweise bewölkt",347
"11/19/2016 21:00","149",141,"4","9","teilweise bewölkt",290
"11/19/2016 22:00","90",145,"5","11","wolkig",235
"11/19/2016 23:00","87",166,"5","13","wolkig",253
"11/20/2016 0:00","121",117,"5","15","Klarer Himmel",238
"11/20/2016 1:00","85",140,"4","11","Klarer Himmel",225
"11/20/2016 2:00","46",101,"4","13","Klarer Himmel",147
"11/20/2016 3:00","25",100,"5","11","Klarer Himmel",125
"11/20/2016 4:00","26",62,"5","13","Klarer Himmel",88
"11/20/2016 5:00","13",71,"5","13","Klarer Himmel",84
"11/20/2016 6:00","28",15,"5","17","Klarer Himmel",43
"11/20/2016 7:00","17",14,"6","22","Klarer Himmel",31
"11/20/2016 8:00","51",14,"7","24","wolkig",65
"11/20/2016 9:00","96",40,"7","22","Regen",136
"11/20/2016 10:00","102",47,"7","17","wolkig",149
"11/20/2016 11:00","107",74,"10","30","teilweise bewölkt",181
"11/20/2016 12:00","122",102,"11","30","wolkig",224
"11/20/2016 13:00","149",123,"13","32","wolkig",272
"11/20/2016 14:00","137",134,"14","35","Klarer Himmel",271
"11/20/2016 15:00","142",135,"14","30","Klarer Himmel",277
"11/20/2016 16:00","141",173,"14","35","Klarer Himmel",314
"11/20/2016 17:00","105",185,"14","28","wolkig",290
"11/20/2016 18:00","172",172,"12","26","wolkig",344
"11/20/2016 19:00","149",163,"12","26","teilweise bewölkt",312
"11/20/2016 20:00","81",141,"12","19","wolkig",222
"11/20/2016 21:00","51",111,"11","7","teilweise bewölkt",162
"11/20/2016 22:00","45",108,"12","11","wolkig",153
"11/20/2016 23:00","31",59,"11","13","Regen",90
"11/21/2016 0:00","16",28,"10","6","Regen",44
"11/21/2016 1:00","10",15,"10","6","teilweise bewölkt",25
"11/21/2016 2:00","7",1,"10","7","wolkig",8
"11/21/2016 3:00","5",5,"10","11","wolkig",10
"11/21/2016 4:00","14",5,"10","11","wolkig",19
"11/21/2016 5:00","34",17,"11","11","Regen",51
"11/21/2016 6:00","126",57,"12","11","wolkig",183
"11/21/2016 7:00","529",313,"12","11","wolkig",842
"11/21/2016 8:00","640",463,"12","13","Regen",1103
"11/21/2016 9:00","487",438,"13","17","Regen",925
"11/21/2016 10:00","523",308,"12","13","Regen",831
"11/21/2016 11:00","376",420,"13","20","Regen",796
"11/21/2016 12:00","429",340,"12","9","Regen",769
"11/21/2016 13:00","483",482,"12","6","Regen",965
"11/21/2016 14:00","473",365,"13","11","Regen",838
"11/21/2016 15:00","567",611,"13","9","Regen",1178
"11/21/2016 16:00","604",496,"13","11","wolkig",1100
"11/21/2016 17:00","702",805,"13","11","Klarer Himmel",1507
"11/21/2016 18:00","581",505,"12","7","Klarer Himmel",1086
"11/21/2016 19:00","454",568,"12","9","Klarer Himmel",1022
"11/21/2016 20:00","242",461,"12","7","wolkig",703
"11/21/2016 21:00","151",289,"13","7","wolkig",440
"11/21/2016 22:00","103",253,"13","11","wolkig",356
"11/21/2016 23:00","54",159,"14","22","Klarer Himmel",213
"11/22/2016 0:00","41",72,"14","20","Klarer Himmel",113
"11/22/2016 1:00","14",25,"14","22","Klarer Himmel",39
"11/22/2016 2:00","5",9,"13","17","Klarer Himmel",14
"11/22/2016 3:00","4",3,"13","22","Klarer Himmel",7
"11/22/2016 4:00","13",6,"13","15","Klarer Himmel",19
"11/22/2016 5:00","29",13,"12","13","Klarer Himmel",42
"11/22/2016 6:00","125",61,"11","9","Klarer Himmel",186
"11/22/2016 7:00","507",434,"10","9","Klarer Himmel",941
"11/22/2016 8:00","860",520,"11","9","Klarer Himmel",1380
"11/22/2016 9:00","578",687,"12","9","Klarer Himmel",1265
"11/22/2016 10:00","586",317,"12","11","Klarer Himmel",903
"11/22/2016 11:00","581",529,"13","11","Klarer Himmel",1110
"11/22/2016 12:00","684",439,"14","13","Klarer Himmel",1123
"11/22/2016 13:00","600",596,"14","13","Klarer Himmel",1196
"11/22/2016 14:00","582",454,"13","11","Klarer Himmel",1036
"11/22/2016 15:00","702",718,"12","7","Klarer Himmel",1420
"11/22/2016 16:00","690",612,"12","7","Klarer Himmel",1302
"11/22/2016 17:00","638",754,"11","6","Klarer Himmel",1392
"11/22/2016 18:00","575",584,"11","6","Klarer Himmel",1159
"11/22/2016 19:00","470",595,"11","4","Regen",1065
"11/22/2016 20:00","263",474,"10","4","Regen",737
"11/22/2016 21:00","129",265,"9","7","Regen",394
"11/22/2016 22:00","136",396,"9","7","Klarer Himmel",532
"11/22/2016 23:00","67",209,"9","4","wolkig",276
"11/23/2016 0:00","43",122,"9","2","wolkig",165
"11/23/2016 1:00","42",41,"8","2","",83
"11/23/2016 2:00","47",19,"9","2","wolkig",66
"11/23/2016 3:00","55",9,"9","0","wolkig",64
"11/23/2016 4:00","27",5,"8","2","wolkig",32
"11/23/2016 5:00","31",16,"9","0","wolkig",47
"11/23/2016 6:00","129",61,"8","0","teilweise bewölkt",190
"11/23/2016 7:00","504",417,"7","0","Nebel",921
"11/23/2016 8:00","791",388,"7","0","Nebel",1179
"11/23/2016 9:00","549",515,"7","2","Nebel",1064
"11/23/2016 10:00","579",346,"9","2","Klarer Himmel",925
"11/23/2016 11:00","576",436,"10","4","Klarer Himmel",1012
"11/23/2016 12:00","637",389,"12","7","Klarer Himmel",1026
"11/23/2016 13:00","609",588,"12","6","Klarer Himmel",1197
"11/23/2016 14:00","553",495,"12","4","Klarer Himmel",1048
"11/23/2016 15:00","663",604,"11","9","Klarer Himmel",1267
"11/23/2016 16:00","640",613,"9","6","Klarer Himmel",1253
"11/23/2016 17:00","726",668,"9","6","Klarer Himmel",1394
"11/23/2016 18:00","603",631,"9","4","Klarer Himmel",1234
"11/23/2016 19:00","480",635,"8","7","Klarer Himmel",1115
"11/23/2016 20:00","274",539,"9","9","Klarer Himmel",813
"11/23/2016 21:00","192",354,"9","9","Klarer Himmel",546
"11/23/2016 22:00","142",343,"9","7","Klarer Himmel",485
"11/23/2016 23:00","91",227,"8","11","Klarer Himmel",318
"11/24/2016 0:00","107",130,"8","11","Klarer Himmel",237
"11/24/2016 1:00","40",97,"8","11","Klarer Himmel",137
"11/24/2016 2:00","13",81,"8","9","Klarer Himmel",94
"11/24/2016 3:00","15",43,"8","17","Klarer Himmel",58
"11/24/2016 4:00","17",38,"7","17","Klarer Himmel",55
"11/24/2016 5:00","28",20,"8","13","wolkig",48
"11/24/2016 6:00","109",59,"8","20","wolkig",168
"11/24/2016 7:00","484",401,"7","19","wolkig",885
"11/24/2016 8:00","705",507,"7","17","wolkig",1212
"11/24/2016 9:00","658",503,"7","17","wolkig",1161
"11/24/2016 10:00","620",343,"7","17","wolkig",963
"11/24/2016 11:00","541",642,"7","15","wolkig",1183
"11/24/2016 12:00","508",420,"7","13","wolkig",928
"11/24/2016 13:00","653",593,"7","19","wolkig",1246
"11/24/2016 14:00","547",455,"7","22","wolkig",1002
"11/24/2016 15:00","650",670,"7","20","Klarer Himmel",1320
"11/24/2016 16:00","725",557,"6","17","Klarer Himmel",1282
"11/24/2016 17:00","759",707,"6","19","Klarer Himmel",1466
"11/24/2016 18:00","502",532,"5","13","Klarer Himmel",1034
"11/24/2016 19:00","405",572,"5","11","Klarer Himmel",977
"11/24/2016 20:00","193",395,"5","13","teilweise bewölkt",588
"11/24/2016 21:00","155",289,"4","15","Klarer Himmel",444
"11/24/2016 22:00","112",263,"4","9","Klarer Himmel",375
"11/24/2016 23:00","137",150,"3","17","Klarer Himmel",287
"11/25/2016 0:00","116",104,"3","11","Klarer Himmel",220
"11/25/2016 1:00","32",75,"2","7","Klarer Himmel",107
"11/25/2016 2:00","20",79,"2","9","Klarer Himmel",99
"11/25/2016 3:00","6",70,"1","9","teilweise bewölkt",76
"11/25/2016 4:00","11",34,"1","13","teilweise bewölkt",45
"11/25/2016 5:00","19",20,"1","11","",39
"11/25/2016 6:00","89",55,"1","11","Klarer Himmel",144
"11/25/2016 7:00","397",322,"2","6","Klarer Himmel",719
"11/25/2016 8:00","630",435,"2","9","Klarer Himmel",1065
"11/25/2016 9:00","466",458,"3","13","Klarer Himmel",924
"11/25/2016 10:00","555",283,"4","13","Klarer Himmel",838
"11/25/2016 11:00","515",396,"6","11","Klarer Himmel",911
"11/25/2016 12:00","481",327,"7","13","Klarer Himmel",808
"11/25/2016 13:00","571",525,"6","17","Klarer Himmel",1096
"11/25/2016 14:00","483",449,"6","15","Klarer Himmel",932
"11/25/2016 15:00","535",514,"4","11","Klarer Himmel",1049
"11/25/2016 16:00","492",401,"2","11","Klarer Himmel",893
"11/25/2016 17:00","378",424,"1","7","Klarer Himmel",802
"11/25/2016 18:00","389",415,"1","6","Klarer Himmel",804
"11/25/2016 19:00","301",357,"0","11","Klarer Himmel",658
"11/25/2016 20:00","218",336,"0","6","",554
"11/25/2016 21:00","150",308,"0","6","",458
"11/25/2016 22:00","76",202,"-1","7","",278
"11/25/2016 23:00","77",210,"0","6","",287
"11/26/2016 0:00","86",168,"-1","2","",254
"11/26/2016 1:00","66",123,"-2","4","Nebel",189
"11/26/2016 2:00","61",101,"-2","2","",162
"11/26/2016 3:00","50",76,"-3","6","Nebel",126
"11/26/2016 4:00","24",27,"-3","6","Nebel",51
"11/26/2016 5:00","20",37,"-3","4","Nebel",57
"11/26/2016 6:00","28",18,"-4","0","Nebel",46
"11/26/2016 7:00","67",25,"-3","2","Nebel",92
"11/26/2016 8:00","139",61,"-3","4","Nebel",200
"11/26/2016 9:00","269",101,"-3","2","Nebel",370
"11/26/2016 10:00","309",134,"-1","2","wolkig",443
"11/26/2016 11:00","283",167,"-1","9","Nebel",450
"11/26/2016 12:00","342",214,"-1","4","Nebel",556
"11/26/2016 13:00","308",256,"-1","6","Nebel",564
"11/26/2016 14:00","245",259,"-1","6","Nebel",504
"11/26/2016 15:00","236",256,"-1","6","Nebel",492
"11/26/2016 16:00","224",225,"-1","4","Nebel",449
"11/26/2016 17:00","188",275,"-1","2","Nebel",463
"11/26/2016 18:00","250",245,"-2","4","Nebel",495
"11/26/2016 19:00","188",216,"-2","4","Nebel",404
"11/26/2016 20:00","142",212,"-2","4","Nebel",354
"11/26/2016 21:00","150",150,"-1","0","wolkig",300
"11/26/2016 22:00","63",116,"-1","4","wolkig",179
"11/26/2016 23:00","63",146,"-1","4","wolkig",209
"11/27/2016 0:00","62",135,"0","2","Regen",197
"11/27/2016 1:00","56",135,"0","2","wolkig",191
"11/27/2016 2:00","37",107,"0","0","Regen",144
"11/27/2016 3:00","11",85,"1","0","wolkig",96
"11/27/2016 4:00","9",51,"1","4","wolkig",60
"11/27/2016 5:00","10",37,"2","0","Nebel",47
"11/27/2016 6:00","12",16,"2","4","wolkig",28
"11/27/2016 7:00","16",18,"4","7","wolkig",34
"11/27/2016 8:00","49",13,"4","9","wolkig",62
"11/27/2016 9:00","158",37,"5","11","wolkig",195
"11/27/2016 10:00","164",63,"6","9","wolkig",227
"11/27/2016 11:00","125",116,"7","9","wolkig",241
"11/27/2016 12:00","143",131,"8","9","wolkig",274
"11/27/2016 13:00","173",137,"8","9","wolkig",310
"11/27/2016 14:00","207",139,"9","7","wolkig",346
"11/27/2016 15:00","236",157,"7","6","wolkig",393
"11/27/2016 16:00","200",207,"4","0","Nebel",407
"11/27/2016 17:00","249",189,"3","0","Nebel",438
"11/27/2016 18:00","191",199,"1","0","Nebel",390
"11/27/2016 19:00","100",234,"0","0","Nebel",334
"11/27/2016 20:00","77",239,"-1","6","Nebel",316
"11/27/2016 21:00","53",131,"0","11","Klarer Himmel",184
"11/27/2016 22:00","31",130,"1","11","Klarer Himmel",161
"11/27/2016 23:00","15",68,"0","6","Klarer Himmel",83
"11/28/2016 0:00","10",23,"-1","6","Nebel",33
"11/28/2016 1:00","7",14,"-2","2","Nebel",21
"11/28/2016 2:00","3",8,"-3","4","Nebel",11
"11/28/2016 3:00","4",3,"-5","7","Nebel",7
"11/28/2016 4:00","7",4,"-3","2","Nebel",11
"11/28/2016 5:00","23",19,"-5","6","Nebel",42
"11/28/2016 6:00","98",50,"-5","4","Nebel",148
"11/28/2016 7:00","471",322,"-4","2","Klarer Himmel",793
"11/28/2016 8:00","651",426,"-5","7","Klarer Himmel",1077
"11/28/2016 9:00","469",503,"-1","7","Klarer Himmel",972
"11/28/2016 10:00","494",324,"1","11","Klarer Himmel",818
"11/28/2016 11:00","420",521,"2","13","Klarer Himmel",941
"11/28/2016 12:00","528",392,"3","13","Klarer Himmel",920
"11/28/2016 13:00","517",565,"3","7","teilweise bewölkt",1082
"11/28/2016 14:00","491",395,"3","9","Klarer Himmel",886
"11/28/2016 15:00","786",647,"2","7","Klarer Himmel",1433
"11/28/2016 16:00","595",623,"0","6","Klarer Himmel",1218
"11/28/2016 17:00","590",721,"-2","2","Klarer Himmel",1311
"11/28/2016 18:00","575",512,"-3","2","Klarer Himmel",1087
"11/28/2016 19:00","339",632,"-4","2","Klarer Himmel",971
"11/28/2016 20:00","183",399,"-4","2","Klarer Himmel",582
"11/28/2016 21:00","135",295,"-5","2","Nebel",430
"11/28/2016 22:00","119",415,"-4","6","Nebel",534
"11/28/2016 23:00","55",98,"-5","6","Nebel",153
"11/29/2016 0:00","26",51,"-5","0","Nebel",77
"11/29/2016 1:00","12",31,"-5","0","Nebel",43
"11/29/2016 2:00","5",3,"-6","2","Nebel",8
"11/29/2016 3:00","0",1,"-7","0","Nebel",1
"11/29/2016 4:00","7",10,"-7","2","Nebel",17
"11/29/2016 5:00","21",20,"-7","2","Nebel",41
"11/29/2016 6:00","106",52,"-7","0","Nebel",158
"11/29/2016 7:00","396",401,"-7","0","Nebel",797
"11/29/2016 8:00","699",533,"-7","0","",1232
"11/29/2016 9:00","526",648,"-5","2","",1174
"11/29/2016 10:00","557",365,"-2","2","Klarer Himmel",922
"11/29/2016 11:00","533",520,"0","4","Klarer Himmel",1053
"11/29/2016 12:00","623",421,"1","4","Klarer Himmel",1044
"11/29/2016 13:00","548",651,"1","6","Klarer Himmel",1199
"11/29/2016 14:00","555",422,"2","4","Klarer Himmel",977
"11/29/2016 15:00","629",667,"0","2","Klarer Himmel",1296
"11/29/2016 16:00","608",555,"-3","2","Nebel",1163
"11/29/2016 17:00","594",705,"-3","0","Nebel",1299
"11/29/2016 18:00","622",548,"-4","6","Nebel",1170
"11/29/2016 19:00","429",549,"-5","4","Nebel",978
"11/29/2016 20:00","184",435,"-6","2","Nebel",619
"11/29/2016 21:00","111",299,"-6","4","Nebel",410
"11/29/2016 22:00","105",351,"-6","6","Klarer Himmel",456
"11/29/2016 23:00","53",167,"-7","2","Klarer Himmel",220
"11/30/2016 0:00","20",75,"-7","2","Klarer Himmel",95
"11/30/2016 1:00","5",44,"-7","0","Klarer Himmel",49
"11/30/2016 2:00","4",30,"-8","7","Klarer Himmel",34
"11/30/2016 3:00","8",6,"-8","2","Klarer Himmel",14
"11/30/2016 4:00","10",6,"-7","4","Klarer Himmel",16
"11/30/2016 5:00","20",18,"-7","4","Klarer Himmel",38
"11/30/2016 6:00","104",54,"-6","2","Klarer Himmel",158
"11/30/2016 7:00","399",351,"-7","2","Klarer Himmel",750
"11/30/2016 8:00","618",481,"-7","4","Klarer Himmel",1099
"11/30/2016 9:00","462",495,"-4","4","wolkig",957
"11/30/2016 10:00","486",344,"-2","7","wolkig",830
"11/30/2016 11:00","517",445,"0","11","wolkig",962
"11/30/2016 12:00","559",341,"2","13","wolkig",900
"11/30/2016 13:00","529",526,"2","15","wolkig",1055
"11/30/2016 14:00","514",404,"2","19","wolkig",918
"11/30/2016 15:00","546",541,"2","17","wolkig",1087
"11/30/2016 16:00","584",527,"3","19","wolkig",1111
"11/30/2016 17:00","622",647,"3","17","wolkig",1269
"11/30/2016 18:00","505",564,"4","17","wolkig",1069
"11/30/2016 19:00","423",576,"3","17","wolkig",999
"11/30/2016 20:00","250",449,"4","17","wolkig",699
"11/30/2016 21:00","186",341,"4","19","wolkig",527
"11/30/2016 22:00","159",272,"4","15","wolkig",431
"11/30/2016 23:00","94",185,"4","19","wolkig",279
"12/1/2016 0:00","76",150,"4","17","wolkig",226
"12/1/2016 1:00","29",92,"4","17","wolkig",121
"12/1/2016 2:00","8",87,"4","22","wolkig",95
"12/1/2016 3:00","6",53,"4","20","wolkig",59
"12/1/2016 4:00","11",25,"4","17","wolkig",36
"12/1/2016 5:00","26",26,"4","17","wolkig",52
"12/1/2016 6:00","97",40,"4","19","wolkig",137
"12/1/2016 7:00","389",308,"5","20","wolkig",697
"12/1/2016 8:00","685",493,"5","20","wolkig",1178
"12/1/2016 9:00","561",462,"5","20","wolkig",1023
"12/1/2016 10:00","555",303,"5","20","wolkig",858
"12/1/2016 11:00","469",511,"6","24","wolkig",980
"12/1/2016 12:00","488",420,"6","26","wolkig",908
"12/1/2016 13:00","545",576,"6","28","wolkig",1121
"12/1/2016 14:00","503",495,"7","24","wolkig",998
"12/1/2016 15:00","600",635,"7","22","wolkig",1235
"12/1/2016 16:00","581",493,"7","22","wolkig",1074
"12/1/2016 17:00","615",687,"7","22","wolkig",1302
"12/1/2016 18:00","623",524,"8","24","wolkig",1147
"12/1/2016 19:00","355",562,"8","24","wolkig",917
"12/1/2016 20:00","246",434,"8","28","wolkig",680
"12/1/2016 21:00","177",283,"8","20","wolkig",460
"12/1/2016 22:00","140",259,"8","19","wolkig",399
"12/1/2016 23:00","66",174,"9","22","wolkig",240
"12/2/2016 0:00","63",98,"8","19","wolkig",161
"12/2/2016 1:00","22",78,"8","19","Regen",100
"12/2/2016 2:00","8",48,"8","20","Regen",56
"12/2/2016 3:00","14",56,"8","19","Regen",70
"12/2/2016 4:00","10",40,"7","17","wolkig",50
"12/2/2016 5:00","22",37,"8","17","Regen",59
"12/2/2016 6:00","93",37,"8","17","Regen",130
"12/2/2016 7:00","359",275,"7","9","wolkig",634
"12/2/2016 8:00","555",413,"8","9","wolkig",968
"12/2/2016 9:00","428",460,"7","11","teilweise bewölkt",888
"12/2/2016 10:00","514",290,"8","9","teilweise bewölkt",804
"12/2/2016 11:00","489",335,"8","11","teilweise bewölkt",824
"12/2/2016 12:00","613",355,"8","15","teilweise bewölkt",968
"12/2/2016 13:00","539",494,"8","13","teilweise bewölkt",1033
"12/2/2016 14:00","455",397,"7","13","teilweise bewölkt",852
"12/2/2016 15:00","488",378,"7","11","Klarer Himmel",866
"12/2/2016 16:00","386",395,"4","2","Klarer Himmel",781
"12/2/2016 17:00","394",411,"2","0","Klarer Himmel",805
"12/2/2016 18:00","397",380,"1","0","Klarer Himmel",777
"12/2/2016 19:00","301",345,"0","0","Nebel",646
"12/2/2016 20:00","219",347,"-1","0","Nebel",566
"12/2/2016 21:00","148",347,"-2","0","Nebel",495
"12/2/2016 22:00","125",259,"-2","0","Nebel",384
"12/2/2016 23:00","83",246,"-3","0","Nebel",329
"12/3/2016 0:00","71",197,"-2","2","Nebel",268
"12/3/2016 1:00","93",189,"-3","2","Nebel",282
"12/3/2016 2:00","68",120,"-3","2","",188
"12/3/2016 3:00","98",85,"-2","4","wolkig",183
"12/3/2016 4:00","54",36,"-3","0","wolkig",90
"12/3/2016 5:00","39",27,"-3","4","Nebel",66
"12/3/2016 6:00","26",16,"-3","2","Nebel",42
"12/3/2016 7:00","79",11,"-2","4","Nebel",90
"12/3/2016 8:00","186",52,"-2","2","wolkig",238
"12/3/2016 9:00","236",121,"-1","4","wolkig",357
"12/3/2016 10:00","276",114,"0","6","wolkig",390
"12/3/2016 11:00","326",173,"0","4","wolkig",499
"12/3/2016 12:00","339",180,"1","4","wolkig",519
"12/3/2016 13:00","283",250,"2","2","teilweise bewölkt",533
"12/3/2016 14:00","292",260,"3","4","teilweise bewölkt",552
"12/3/2016 15:00","305",286,"2","4","teilweise bewölkt",591
"12/3/2016 16:00","255",267,"0","2","Nebel",522
"12/3/2016 17:00","237",271,"-2","0","Nebel",508
"12/3/2016 18:00","222",271,"-2","0","Nebel",493
"12/3/2016 19:00","215",225,"-3","0","Nebel",440
"12/3/2016 20:00","143",247,"-3","0","Nebel",390
"12/3/2016 21:00","99",248,"-4","4","Nebel",347
"12/3/2016 22:00","63",195,"-4","0","Nebel",258
"12/3/2016 23:00","58",187,"-4","0","Nebel",245
"12/4/2016 0:00","82",125,"-5","4","Nebel",207
"12/4/2016 1:00","58",136,"-5","4","Nebel",194
"12/4/2016 2:00","51",100,"-4","2","Nebel",151
"12/4/2016 3:00","33",81,"-5","2","Nebel",114
"12/4/2016 4:00","18",47,"-6","4","Nebel",65
"12/4/2016 5:00","7",39,"-5","6","Nebel",46
"12/4/2016 6:00","16",14,"-6","4","Nebel",30
"12/4/2016 7:00","16",15,"-6","2","Nebel",31
"12/4/2016 8:00","44",25,"-6","2","Klarer Himmel",69
"12/4/2016 9:00","125",48,"-3","0","Klarer Himmel",173
"12/4/2016 10:00","176",83,"-1","0","Klarer Himmel",259
"12/4/2016 11:00","148",103,"1","4","Klarer Himmel",251
"12/4/2016 12:00","171",113,"3","4","Klarer Himmel",284
"12/4/2016 13:00","172",138,"5","6","Klarer Himmel",310
"12/4/2016 14:00","225",184,"5","4","Klarer Himmel",409
"12/4/2016 15:00","223",202,"4","4","Klarer Himmel",425
"12/4/2016 16:00","170",205,"0","6","Klarer Himmel",375
"12/4/2016 17:00","166",238,"-2","4","Klarer Himmel",404
"12/4/2016 18:00","157",232,"-2","6","Klarer Himmel",389
"12/4/2016 19:00","110",212,"-2","6","Klarer Himmel",322
"12/4/2016 20:00","69",167,"0","4","Klarer Himmel",236
"12/4/2016 21:00","51",112,"-1","4","Klarer Himmel",163
"12/4/2016 22:00","47",134,"-2","6","Klarer Himmel",181
"12/4/2016 23:00","31",60,"-4","2","Klarer Himmel",91
"12/5/2016 0:00","9",30,"-4","4","Klarer Himmel",39
"12/5/2016 1:00","13",20,"-4","4","Klarer Himmel",33
"12/5/2016 2:00","1",5,"-4","2","Klarer Himmel",6
"12/5/2016 3:00","1",3,"-4","4","Klarer Himmel",4
"12/5/2016 4:00","5",5,"-5","2","Klarer Himmel",10
"12/5/2016 5:00","24",21,"-6","4","Klarer Himmel",45
"12/5/2016 6:00","105",49,"-7","2","Klarer Himmel",154
"12/5/2016 7:00","396",272,"-6","0","Klarer Himmel",668
"12/5/2016 8:00","622",450,"-7","2","Klarer Himmel",1072
"12/5/2016 9:00","434",451,"-4","0","Klarer Himmel",885
"12/5/2016 10:00","514",321,"0","0","Klarer Himmel",835
"12/5/2016 11:00","419",502,"2","4","Klarer Himmel",921
"12/5/2016 12:00","441",380,"4","0","Klarer Himmel",821
"12/5/2016 13:00","528",501,"4","2","Klarer Himmel",1029
"12/5/2016 14:00","499",408,"5","0","Klarer Himmel",907
"12/5/2016 15:00","591",634,"4","0","Klarer Himmel",1225
"12/5/2016 16:00","600",477,"-1","0","Klarer Himmel",1077
"12/5/2016 17:00","556",792,"-3","0","Klarer Himmel",1348
"12/5/2016 18:00","530",595,"-4","0","Klarer Himmel",1125
"12/5/2016 19:00","349",603,"-4","2","Klarer Himmel",952
"12/5/2016 20:00","196",439,"-5","0","Klarer Himmel",635
"12/5/2016 21:00","138",297,"-6","0","Klarer Himmel",435
"12/5/2016 22:00","104",272,"-6","0","Nebel",376
"12/5/2016 23:00","65",123,"-7","0","Nebel",188
"12/6/2016 0:00","11",61,"-7","2","Nebel",72
"12/6/2016 1:00","12",44,"-7","0","Nebel",56
"12/6/2016 2:00","5",9,"-7","4","Nebel",14
"12/6/2016 3:00","0",8,"-7","0","Klarer Himmel",8
"12/6/2016 4:00","6",4,"-7","2","Klarer Himmel",10
"12/6/2016 5:00","23",25,"-7","4","Klarer Himmel",48
"12/6/2016 6:00","96",46,"-7","0","Klarer Himmel",142
"12/6/2016 7:00","368",388,"-7","2","Klarer Himmel",756
"12/6/2016 8:00","708",506,"-6","4","Klarer Himmel",1214
"12/6/2016 9:00","466",648,"-3","4","Klarer Himmel",1114
"12/6/2016 10:00","564",352,"-1","4","Klarer Himmel",916
"12/6/2016 11:00","479",530,"1","6","Klarer Himmel",1009
"12/6/2016 12:00","635",429,"2","6","Klarer Himmel",1064
"12/6/2016 13:00","533",633,"3","6","Klarer Himmel",1166
"12/6/2016 14:00","532",443,"3","4","Klarer Himmel",975
"12/6/2016 15:00","664",607,"2","2","Klarer Himmel",1271
"12/6/2016 16:00","607",518,"0","4","Klarer Himmel",1125
"12/6/2016 17:00","565",752,"0","6","Klarer Himmel",1317
"12/6/2016 18:00","521",563,"0","6","Klarer Himmel",1084
"12/6/2016 19:00","395",594,"-1","6","Klarer Himmel",989
"12/6/2016 20:00","200",452,"-2","2","Klarer Himmel",652
"12/6/2016 21:00","128",383,"-1","6","Klarer Himmel",511
"12/6/2016 22:00","136",333,"-2","7","Klarer Himmel",469
"12/6/2016 23:00","43",180,"-1","6","Klarer Himmel",223
"12/7/2016 0:00","28",74,"-2","6","Klarer Himmel",102
"12/7/2016 1:00","27",44,"-2","6","Klarer Himmel",71
"12/7/2016 2:00","10",11,"-2","6","Klarer Himmel",21
"12/7/2016 3:00","3",13,"-2","6","Klarer Himmel",16
"12/7/2016 4:00","8",11,"-2","7","Klarer Himmel",19
"12/7/2016 5:00","27",13,"-1","7","Klarer Himmel",40
"12/7/2016 6:00","114",48,"-1","7","Klarer Himmel",162
"12/7/2016 7:00","395",343,"-1","9","Klarer Himmel",738
"12/7/2016 8:00","702",483,"-1","7","Klarer Himmel",1185
"12/7/2016 9:00","462",475,"0","7","wolkig",937
"12/7/2016 10:00","534",340,"1","9","Klarer Himmel",874
"12/7/2016 11:00","494",449,"3","9","Klarer Himmel",943
"12/7/2016 12:00","538",415,"4","11","Klarer Himmel",953
"12/7/2016 13:00","587",559,"6","6","Klarer Himmel",1146
"12/7/2016 14:00","481",445,"7","9","Klarer Himmel",926
"12/7/2016 15:00","551",594,"7","9","Klarer Himmel",1145
"12/7/2016 16:00","560",455,"7","9","Klarer Himmel",1015
"12/7/2016 17:00","624",664,"7","9","Klarer Himmel",1288
"12/7/2016 18:00","590",523,"7","9","Klarer Himmel",1113
"12/7/2016 19:00","468",569,"8","11","Klarer Himmel",1037
"12/7/2016 20:00","284",500,"8","11","Klarer Himmel",784
"12/7/2016 21:00","174",358,"8","13","Klarer Himmel",532
"12/7/2016 22:00","146",385,"8","19","Klarer Himmel",531
"12/7/2016 23:00","150",207,"8","17","Klarer Himmel",357
"12/8/2016 0:00","161",111,"8","19","Klarer Himmel",272
"12/8/2016 1:00","63",91,"8","17","Klarer Himmel",154
"12/8/2016 2:00","12",64,"8","15","Klarer Himmel",76
"12/8/2016 3:00","8",93,"8","17","Klarer Himmel",101
"12/8/2016 4:00","10",81,"8","15","Klarer Himmel",91
"12/8/2016 5:00","36",72,"8","13","Klarer Himmel",108
"12/8/2016 6:00","115",54,"7","13","Klarer Himmel",169
"12/8/2016 7:00","386",319,"7","15","Klarer Himmel",705
"12/8/2016 8:00","646",477,"7","17","Klarer Himmel",1123
"12/8/2016 9:00","574",540,"8","19","Klarer Himmel",1114
"12/8/2016 10:00","628",323,"9","22","Klarer Himmel",951
"12/8/2016 11:00","467",492,"9","19","Klarer Himmel",959
"12/8/2016 12:00","534",423,"10","15","Klarer Himmel",957
"12/8/2016 13:00","580",530,"9","13","Klarer Himmel",1110
"12/8/2016 14:00","517",497,"9","13","Klarer Himmel",1014
"12/8/2016 15:00","589",615,"9","13","Klarer Himmel",1204
"12/8/2016 16:00","592",543,"8","11","Klarer Himmel",1135
"12/8/2016 17:00","671",571,"8","13","Klarer Himmel",1242
"12/8/2016 18:00","569",569,"8","13","Klarer Himmel",1138
"12/8/2016 19:00","392",580,"8","19","wolkig",972
"12/8/2016 20:00","235",386,"8","17","wolkig",621
"12/8/2016 21:00","186",329,"7","19","Regen",515
"12/8/2016 22:00","152",298,"7","15","Regen",450
"12/8/2016 23:00","104",186,"7","13","Regen",290
"12/9/2016 0:00","62",133,"7","15","wolkig",195
"12/9/2016 1:00","47",74,"7","17","Regen",121
"12/9/2016 2:00","10",62,"7","17","Regen",72
"12/9/2016 3:00","3",18,"8","15","Regen",21
"12/9/2016 4:00","7",21,"8","20","wolkig",28
"12/9/2016 5:00","25",29,"8","19","Regen",54
"12/9/2016 6:00","90",39,"8","17","Regen",129
"12/9/2016 7:00","378",284,"9","17","wolkig",662
"12/9/2016 8:00","526",407,"9","19","wolkig",933
"12/9/2016 9:00","453",418,"9","15","wolkig",871
"12/9/2016 10:00","565",287,"9","15","wolkig",852
"12/9/2016 11:00","517",326,"9","11","wolkig",843
"12/9/2016 12:00","561",325,"9","13","wolkig",886
"12/9/2016 13:00","478",525,"9","13","wolkig",1003
"12/9/2016 14:00","452",456,"9","11","wolkig",908
"12/9/2016 15:00","458",364,"9","9","Regen",822
"12/9/2016 16:00","407",386,"10","13","wolkig",793
"12/9/2016 17:00","441",432,"9","7","wolkig",873
"12/9/2016 18:00","474",378,"10","13","wolkig",852
"12/9/2016 19:00","351",329,"10","15","wolkig",680
"12/9/2016 20:00","203",253,"9","13","Klarer Himmel",456
"12/9/2016 21:00","150",289,"9","13","Klarer Himmel",439
"12/9/2016 22:00","145",255,"9","11","Klarer Himmel",400
"12/9/2016 23:00","96",210,"9","11","Klarer Himmel",306
"12/10/2016 0:00","80",160,"9","9","Klarer Himmel",240
"12/10/2016 1:00","93",169,"8","11","Klarer Himmel",262
"12/10/2016 2:00","44",119,"8","9","Klarer Himmel",163
"12/10/2016 3:00","29",104,"8","15","Klarer Himmel",133
"12/10/2016 4:00","18",66,"8","15","Klarer Himmel",84
"12/10/2016 5:00","27",55,"8","13","Klarer Himmel",82
"12/10/2016 6:00","19",33,"7","15","Klarer Himmel",52
"12/10/2016 7:00","66",18,"8","17","Klarer Himmel",84
"12/10/2016 8:00","134",76,"7","13","Klarer Himmel",210
"12/10/2016 9:00","282",102,"8","11","wolkig",384
"12/10/2016 10:00","304",119,"8","13","wolkig",423
"12/10/2016 11:00","363",153,"8","19","wolkig",516
"12/10/2016 12:00","386",216,"8","19","Regen",602
"12/10/2016 13:00","318",255,"7","13","Regen",573
"12/10/2016 14:00","343",309,"7","13","Regen",652
"12/10/2016 15:00","227",248,"7","11","Regen",475
"12/10/2016 16:00","211",305,"7","11","Regen",516
"12/10/2016 17:00","201",244,"7","7","",445
"12/10/2016 18:00","193",266,"7","7","Regen",459
"12/10/2016 19:00","210",233,"8","9","Regen",443
"12/10/2016 20:00","147",180,"8","9","Regen",327
"12/10/2016 21:00","120",158,"8","9","Regen",278
"12/10/2016 22:00","97",160,"8","9","Regen",257
"12/10/2016 23:00","50",145,"9","11","Regen",195
"12/11/2016 0:00","56",127,"9","20","Regen",183
"12/11/2016 1:00","70",136,"9","20","Regen",206
"12/11/2016 2:00","41",78,"9","26","Regen",119
"12/11/2016 3:00","12",68,"9","26","Regen",80
"12/11/2016 4:00","14",37,"9","32","Regen",51
"12/11/2016 5:00","10",37,"9","35","Regen",47
"12/11/2016 6:00","19",19,"8","24","wolkig",38
"12/11/2016 7:00","21",9,"7","22","wolkig",30
"12/11/2016 8:00","38",23,"7","19","wolkig",61
"12/11/2016 9:00","117",56,"7","20","wolkig",173
"12/11/2016 10:00","156",60,"8","22","wolkig",216
"12/11/2016 11:00","152",66,"9","24","wolkig",218
"12/11/2016 12:00","151",127,"9","28","wolkig",278
"12/11/2016 13:00","166",132,"9","26","wolkig",298
"12/11/2016 14:00","202",152,"8","22","wolkig",354
"12/11/2016 15:00","205",161,"8","15","Regen",366
"12/11/2016 16:00","221",187,"8","19","Regen",408
"12/11/2016 17:00","175",220,"8","20","wolkig",395
"12/11/2016 18:00","176",200,"7","20","wolkig",376
"12/11/2016 19:00","107",216,"7","20","Regen",323
"12/11/2016 20:00","97",219,"7","17","Regen",316
"12/11/2016 21:00","67",90,"7","15","Regen",157
"12/11/2016 22:00","62",176,"7","15","wolkig",238
"12/11/2016 23:00","31",71,"7","17","wolkig",102
"12/12/2016 0:00","16",37,"7","15","wolkig",53
"12/12/2016 1:00","17",15,"7","17","wolkig",32
"12/12/2016 2:00","3",3,"7","13","wolkig",6
"12/12/2016 3:00","0",4,"7","15","wolkig",4
"12/12/2016 4:00","10",4,"7","13","Regen",14
"12/12/2016 5:00","29",22,"7","11","Regen",51
"12/12/2016 6:00","112",50,"7","9","wolkig",162
"12/12/2016 7:00","425",281,"6","9","Nebel",706
"12/12/2016 8:00","617",419,"7","7","wolkig",1036
"12/12/2016 9:00","486",434,"7","9","wolkig",920
"12/12/2016 10:00","509",324,"8","9","wolkig",833
"12/12/2016 11:00","418",469,"8","9","wolkig",887
"12/12/2016 12:00","478",380,"8","9","wolkig",858
"12/12/2016 13:00","519",485,"8","13","wolkig",1004
"12/12/2016 14:00","545",398,"7","13","wolkig",943
"12/12/2016 15:00","580",622,"7","9","wolkig",1202
"12/12/2016 16:00","645",501,"7","4","wolkig",1146
"12/12/2016 17:00","628",667,"7","9","wolkig",1295
"12/12/2016 18:00","508",531,"7","6","wolkig",1039
"12/12/2016 19:00","358",562,"6","4","wolkig",920
"12/12/2016 20:00","215",455,"6","6","wolkig",670
"12/12/2016 21:00","175",236,"6","6","wolkig",411
"12/12/2016 22:00","125",265,"6","6","wolkig",390
"12/12/2016 23:00","75",144,"6","7","wolkig",219
"12/13/2016 0:00","47",59,"6","7","wolkig",106
"12/13/2016 1:00","15",32,"6","6","wolkig",47
"12/13/2016 2:00","6",13,"5","7","wolkig",19
"12/13/2016 3:00","4",18,"5","7","wolkig",22
"12/13/2016 4:00","8",7,"4","6","wolkig",15
"12/13/2016 5:00","36",32,"5","7","wolkig",68
"12/13/2016 6:00","116",43,"5","7","Klarer Himmel",159
"12/13/2016 7:00","404",364,"6","7","Regen",768
"12/13/2016 8:00","612",459,"6","7","Regen",1071
"12/13/2016 9:00","579",551,"6","7","wolkig",1130
"12/13/2016 10:00","599",331,"6","7","wolkig",930
"12/13/2016 11:00","498",467,"6","6","Regen",965
"12/13/2016 12:00","544",381,"6","11","Regen",925
"12/13/2016 13:00","563",573,"6","9","Regen",1136
"12/13/2016 14:00","559",398,"6","13","Regen",957
"12/13/2016 15:00","646",535,"6","9","wolkig",1181
"12/13/2016 16:00","602",531,"6","9","wolkig",1133
"12/13/2016 17:00","632",672,"6","7","wolkig",1304
"12/13/2016 18:00","661",564,"7","6","wolkig",1225
"12/13/2016 19:00","397",511,"7","7","wolkig",908
"12/13/2016 20:00","204",430,"7","6","wolkig",634
"12/13/2016 21:00","156",344,"7","6","wolkig",500
"12/13/2016 22:00","135",269,"7","7","wolkig",404
"12/13/2016 23:00","88",190,"7","11","wolkig",278
"12/14/2016 0:00","40",121,"7","0","wolkig",161
"12/14/2016 1:00","24",44,"7","4","wolkig",68
"12/14/2016 2:00","11",15,"7","0","wolkig",26
"12/14/2016 3:00","2",5,"7","4","Nebel",7
"12/14/2016 4:00","6",5,"7","6","Nebel",11
"12/14/2016 5:00","35",21,"7","6","wolkig",56
"12/14/2016 6:00","118",49,"7","6","wolkig",167
"12/14/2016 7:00","437",299,"7","4","wolkig",736
"12/14/2016 8:00","651",436,"7","0","wolkig",1087
"12/14/2016 9:00","529",495,"7","6","wolkig",1024
"12/14/2016 10:00","527",311,"7","6","Nebel",838
"12/14/2016 11:00","475",354,"8","6","Regen",829
"12/14/2016 12:00","586",366,"8","6","Regen",952
"12/14/2016 13:00","563",531,"8","4","wolkig",1094
"12/14/2016 14:00","575",385,"8","7","Nebel",960
"12/14/2016 15:00","511",642,"8","4","wolkig",1153
"12/14/2016 16:00","576",517,"8","6","wolkig",1093
"12/14/2016 17:00","629",648,"8","4","wolkig",1277
"12/14/2016 18:00","505",599,"8","4","Nebel",1104
"12/14/2016 19:00","454",539,"8","4","wolkig",993
"12/14/2016 20:00","288",432,"8","6","wolkig",720
"12/14/2016 21:00","211",286,"8","4","wolkig",497
"12/14/2016 22:00","185",336,"8","2","wolkig",521
"12/14/2016 23:00","157",205,"8","7","wolkig",362
"12/15/2016 0:00","128",150,"7","4","wolkig",278
"12/15/2016 1:00","47",107,"6","4","teilweise bewölkt",154
"12/15/2016 2:00","30",100,"6","6","teilweise bewölkt",130
"12/15/2016 3:00","4",76,"5","6","teilweise bewölkt",80
"12/15/2016 4:00","13",46,"5","6","teilweise bewölkt",59
"12/15/2016 5:00","31",32,"5","7","",63
"12/15/2016 6:00","115",50,"5","9","",165
"12/15/2016 7:00","389",304,"5","6","",693
"12/15/2016 8:00","635",455,"4","6","",1090
"12/15/2016 9:00","562",453,"5","9","teilweise bewölkt",1015
"12/15/2016 10:00","599",307,"5","11","wolkig",906
"12/15/2016 11:00","562",537,"6","11","wolkig",1099
"12/15/2016 12:00","534",496,"6","9","wolkig",1030
"12/15/2016 13:00","565",547,"6","9","wolkig",1112
"12/15/2016 14:00","581",466,"6","9","wolkig",1047
"12/15/2016 15:00","638",604,"6","7","wolkig",1242
"12/15/2016 16:00","635",540,"6","6","teilweise bewölkt",1175
"12/15/2016 17:00","750",673,"5","6","Klarer Himmel",1423
"12/15/2016 18:00","527",523,"5","7","Klarer Himmel",1050
"12/15/2016 19:00","325",563,"4","9","Klarer Himmel",888
"12/15/2016 20:00","274",441,"4","7","Klarer Himmel",715
"12/15/2016 21:00","171",310,"4","6","Klarer Himmel",481
"12/15/2016 22:00","146",294,"4","6","Klarer Himmel",440
"12/15/2016 23:00","130",217,"3","7","Klarer Himmel",347
"12/16/2016 0:00","77",128,"3","7","Klarer Himmel",205
"12/16/2016 1:00","54",113,"3","7","Klarer Himmel",167
"12/16/2016 2:00","29",78,"2","6","Klarer Himmel",107
"12/16/2016 3:00","7",42,"2","6","Klarer Himmel",49
"12/16/2016 4:00","15",58,"2","6","Klarer Himmel",73
"12/16/2016 5:00","25",34,"2","6","Klarer Himmel",59
"12/16/2016 6:00","89",56,"2","6","",145
"12/16/2016 7:00","391",246,"2","6","Nebel",637
"12/16/2016 8:00","513",370,"2","7","Nebel",883
"12/16/2016 9:00","448",418,"2","6","",866
"12/16/2016 10:00","498",305,"3","9","Klarer Himmel",803
"12/16/2016 11:00","524",388,"4","9","Klarer Himmel",912
"12/16/2016 12:00","564",361,"5","7","Klarer Himmel",925
"12/16/2016 13:00","617",500,"6","7","Klarer Himmel",1117
"12/16/2016 14:00","490",476,"6","7","Klarer Himmel",966
"12/16/2016 15:00","506",451,"5","2","Klarer Himmel",957
"12/16/2016 16:00","424",466,"3","4","Klarer Himmel",890
"12/16/2016 17:00","371",535,"1","2","Klarer Himmel",906
"12/16/2016 18:00","390",431,"1","4","Klarer Himmel",821
"12/16/2016 19:00","414",403,"1","6","Nebel",817
"12/16/2016 20:00","226",287,"1","7","",513
"12/16/2016 21:00","140",271,"1","7","",411
"12/16/2016 22:00","124",248,"0","4","",372
"12/16/2016 23:00","127",197,"0","4","",324
"12/17/2016 0:00","109",183,"-1","4","Nebel",292
"12/17/2016 1:00","88",157,"0","6","Nebel",245
"12/17/2016 2:00","50",136,"0","4","",186
"12/17/2016 3:00","26",115,"0","6","",141
"12/17/2016 4:00","19",90,"1","4","",109
"12/17/2016 5:00","17",58,"0","2","",75
"12/17/2016 6:00","21",24,"0","7","",45
"12/17/2016 7:00","65",24,"0","6","Nebel",89
"12/17/2016 8:00","128",69,"1","6","Nebel",197
"12/17/2016 9:00","262",70,"1","6","",332
"12/17/2016 10:00","358",100,"2","6","",458
"12/17/2016 11:00","309",146,"2","6","",455
"12/17/2016 12:00","344",199,"3","6","",543
"12/17/2016 13:00","311",242,"4","2","",553
"12/17/2016 14:00","308",275,"4","9","",583
"12/17/2016 15:00","271",290,"4","2","",561
"12/17/2016 16:00","268",286,"4","7","wolkig",554
"12/17/2016 17:00","245",279,"5","4","wolkig",524
"12/17/2016 18:00","222",301,"5","7","Regen",523
"12/17/2016 19:00","217",246,"5","7","Regen",463
"12/17/2016 20:00","151",230,"5","6","Regen",381
"12/17/2016 21:00","143",185,"5","7","Regen",328
"12/17/2016 22:00","89",165,"5","9","wolkig",254
"12/17/2016 23:00","94",135,"6","9","wolkig",229
"12/18/2016 0:00","89",156,"6","9","Regen",245
"12/18/2016 1:00","62",131,"6","13","Regen",193
"12/18/2016 2:00","41",94,"5","9","wolkig",135
"12/18/2016 3:00","20",62,"6","13","wolkig",82
"12/18/2016 4:00","14",71,"6","13","wolkig",85
"12/18/2016 5:00","6",51,"6","11","wolkig",57
"12/18/2016 6:00","10",25,"5","9","wolkig",35
"12/18/2016 7:00","21",25,"5","11","wolkig",46
"12/18/2016 8:00","36",15,"6","15","wolkig",51
"12/18/2016 9:00","123",51,"6","11","wolkig",174
"12/18/2016 10:00","177",70,"6","11","wolkig",247
"12/18/2016 11:00","158",80,"7","13","wolkig",238
"12/18/2016 12:00","179",124,"7","11","wolkig",303
"12/18/2016 13:00","168",133,"7","13","wolkig",301
"12/18/2016 14:00","224",184,"7","9","wolkig",408
"12/18/2016 15:00","251",174,"7","7","wolkig",425
"12/18/2016 16:00","218",231,"6","13","wolkig",449
"12/18/2016 17:00","238",256,"6","7","wolkig",494
"12/18/2016 18:00","196",199,"6","6","wolkig",395
"12/18/2016 19:00","161",231,"6","2","wolkig",392
"12/18/2016 20:00","85",244,"5","6","wolkig",329
"12/18/2016 21:00","46",126,"5","0","wolkig",172
"12/18/2016 22:00","51",139,"5","0","wolkig",190
"12/18/2016 23:00","40",95,"5","4","wolkig",135
"12/19/2016 0:00","30",52,"5","4","wolkig",82
"12/19/2016 1:00","9",19,"5","0","wolkig",28
"12/19/2016 2:00","3",8,"5","0","wolkig",11
"12/19/2016 3:00","1",8,"5","0","wolkig",9
"12/19/2016 4:00","8",11,"5","0","Regen",19
"12/19/2016 5:00","23",17,"5","0","wolkig",40
"12/19/2016 6:00","98",37,"4","0","Nebel",135
"12/19/2016 7:00","370",235,"5","4","wolkig",605
"12/19/2016 8:00","546",371,"4","6","wolkig",917
"12/19/2016 9:00","471",420,"4","4","wolkig",891
"12/19/2016 10:00","487",316,"4","7","wolkig",803
"12/19/2016 11:00","439",446,"5","4","teilweise bewölkt",885
"12/19/2016 12:00","519",368,"6","7","teilweise bewölkt",887
"12/19/2016 13:00","597",496,"7","7","teilweise bewölkt",1093
"12/19/2016 14:00","516",413,"6","9","teilweise bewölkt",929
"12/19/2016 15:00","624",556,"5","7","teilweise bewölkt",1180
"12/19/2016 16:00","655",513,"5","6","wolkig",1168
"12/19/2016 17:00","634",663,"5","9","wolkig",1297
"12/19/2016 18:00","570",524,"4","4","teilweise bewölkt",1094
"12/19/2016 19:00","426",576,"3","6","Klarer Himmel",1002
"12/19/2016 20:00","193",441,"3","7","Klarer Himmel",634
"12/19/2016 21:00","136",239,"1","6","Klarer Himmel",375
"12/19/2016 22:00","113",257,"1","6","Klarer Himmel",370
"12/19/2016 23:00","67",208,"0","4","Klarer Himmel",275
"12/20/2016 0:00","39",119,"0","4","Klarer Himmel",158
"12/20/2016 1:00","17",71,"-1","4","Klarer Himmel",88
"12/20/2016 2:00","26",26,"-1","4","",52
"12/20/2016 3:00","3",20,"0","6","Nebel",23
"12/20/2016 4:00","10",11,"-1","4","Nebel",21
"12/20/2016 5:00","27",20,"-1","4","Nebel",47
"12/20/2016 6:00","106",38,"-3","0","Nebel",144
"12/20/2016 7:00","365",341,"-3","6","Nebel",706
"12/20/2016 8:00","556",439,"-3","0","Nebel",995
"12/20/2016 9:00","502",477,"-2","6","Nebel",979
"12/20/2016 10:00","579",329,"1","0","Klarer Himmel",908
"12/20/2016 11:00","515",499,"3","6","Klarer Himmel",1014
"12/20/2016 12:00","641",451,"4","7","Klarer Himmel",1092
"12/20/2016 13:00","590",578,"3","13","Klarer Himmel",1168
"12/20/2016 14:00","622",433,"2","7","Klarer Himmel",1055
"12/20/2016 15:00","629",591,"1","9","Klarer Himmel",1220
"12/20/2016 16:00","650",596,"0","6","",1246
"12/20/2016 17:00","619",680,"-1","4","Nebel",1299
"12/20/2016 18:00","518",610,"-2","4","Nebel",1128
"12/20/2016 19:00","402",503,"-2","4","Nebel",905
"12/20/2016 20:00","225",374,"-3","2","Nebel",599
"12/20/2016 21:00","153",255,"-2","6","Nebel",408
"12/20/2016 22:00","120",298,"-2","7","Nebel",418
"12/20/2016 23:00","84",222,"-2","7","",306
"12/21/2016 0:00","63",147,"-2","9","",210
"12/21/2016 1:00","30",89,"-2","6","",119
"12/21/2016 2:00","10",45,"-2","7","Klarer Himmel",55
"12/21/2016 3:00","5",25,"0","7","wolkig",30
"12/21/2016 4:00","9",25,"0","9","wolkig",34
"12/21/2016 5:00","31",24,"0","7","wolkig",55
"12/21/2016 6:00","112",43,"0","4","teilweise bewölkt",155
"12/21/2016 7:00","338",318,"0","9","Klarer Himmel",656
"12/21/2016 8:00","551",384,"0","9","Klarer Himmel",935
"12/21/2016 9:00","505",419,"1","7","Klarer Himmel",924
"12/21/2016 10:00","552",353,"2","9","Klarer Himmel",905
"12/21/2016 11:00","561",393,"4","13","Klarer Himmel",954
"12/21/2016 12:00","581",428,"4","15","Klarer Himmel",1009
"12/21/2016 13:00","712",477,"6","17","Klarer Himmel",1189
"12/21/2016 14:00","530",512,"6","13","wolkig",1042
"12/21/2016 15:00","529",650,"5","13","wolkig",1179
"12/21/2016 16:00","556",586,"5","13","wolkig",1142
"12/21/2016 17:00","585",585,"5","17","Klarer Himmel",1170
"12/21/2016 18:00","517",513,"4","9","Klarer Himmel",1030
"12/21/2016 19:00","461",511,"4","13","wolkig",972
"12/21/2016 20:00","247",398,"4","17","Regen",645
"12/21/2016 21:00","124",340,"4","11","Regen",464
"12/21/2016 22:00","160",293,"3","7","Regen",453
"12/21/2016 23:00","137",243,"3","6","Regen",380
"12/22/2016 0:00","136",156,"3","6","Regen",292
"12/22/2016 1:00","71",176,"3","7","Regen",247
"12/22/2016 2:00","23",115,"4","13","Regen",138
"12/22/2016 3:00","10",89,"4","11","Regen",99
"12/22/2016 4:00","15",74,"4","11","Regen",89
"12/22/2016 5:00","19",47,"3","6","Regen",66
"12/22/2016 6:00","65",31,"3","7","Regen",96
"12/22/2016 7:00","214",157,"3","7","Regen",371
"12/22/2016 8:00","364",210,"4","11","Regen",574
"12/22/2016 9:00","372",289,"4","11","Regen",661
"12/22/2016 10:00","427",238,"4","4","wolkig",665
"12/22/2016 11:00","430",345,"4","9","wolkig",775
"12/22/2016 12:00","389",351,"5","7","wolkig",740
"12/22/2016 13:00","434",412,"5","7","Regen",846
"12/22/2016 14:00","413",335,"6","9","Regen",748
"12/22/2016 15:00","536",400,"5","9","wolkig",936
"12/22/2016 16:00","382",407,"6","9","wolkig",789
"12/22/2016 17:00","391",456,"5","11","wolkig",847
"12/22/2016 18:00","322",332,"5","9","wolkig",654
"12/22/2016 19:00","190",366,"5","15","wolkig",556
"12/22/2016 20:00","160",268,"5","19","Regen",428
"12/22/2016 21:00","90",145,"5","15","Regen",235
"12/22/2016 22:00","96",131,"6","15","wolkig",227
"12/22/2016 23:00","44",110,"5","11","teilweise bewölkt",154
"12/23/2016 0:00","45",104,"5","11","wolkig",149
"12/23/2016 1:00","30",92,"4","9","teilweise bewölkt",122
"12/23/2016 2:00","19",59,"4","7","wolkig",78
"12/23/2016 3:00","9",42,"4","9","teilweise bewölkt",51
"12/23/2016 4:00","10",30,"5","9","wolkig",40
"12/23/2016 5:00","19",21,"5","11","wolkig",40
"12/23/2016 6:00","54",28,"5","13","wolkig",82
"12/23/2016 7:00","128",94,"5","13","wolkig",222
"12/23/2016 8:00","177",97,"5","13","wolkig",274
"12/23/2016 9:00","218",110,"5","15","wolkig",328
"12/23/2016 10:00","251",128,"6","17","wolkig",379
"12/23/2016 11:00","260",166,"6","15","wolkig",426
"12/23/2016 12:00","268",217,"7","17","wolkig",485
"12/23/2016 13:00","284",256,"8","15","wolkig",540
"12/23/2016 14:00","242",212,"8","17","wolkig",454
"12/23/2016 15:00","224",240,"8","15","wolkig",464
"12/23/2016 16:00","224",209,"7","15","Klarer Himmel",433
"12/23/2016 17:00","175",183,"6","17","Klarer Himmel",358
"12/23/2016 18:00","136",171,"6","17","Klarer Himmel",307
"12/23/2016 19:00","111",137,"5","20","Klarer Himmel",248
"12/23/2016 20:00","88",99,"5","19","Klarer Himmel",187
"12/23/2016 21:00","72",79,"5","22","Klarer Himmel",151
"12/23/2016 22:00","32",55,"4","22","wolkig",87
"12/23/2016 23:00","42",77,"5","26","wolkig",119
"12/24/2016 0:00","12",78,"6","22","wolkig",90
"12/24/2016 1:00","16",81,"6","26","Regen",97
"12/24/2016 2:00","6",52,"6","22","Regen",58
"12/24/2016 3:00","11",43,"6","24","Regen",54
"12/24/2016 4:00","6",14,"7","20","Regen",20
"12/24/2016 5:00","5",21,"7","22","Regen",26
"12/24/2016 6:00","26",14,"7","20","wolkig",40
"12/24/2016 7:00","26",16,"7","20","wolkig",42
"12/24/2016 8:00","61",26,"7","19","wolkig",87
"12/24/2016 9:00","138",35,"7","19","wolkig",173
"12/24/2016 10:00","173",91,"8","24","wolkig",264
"12/24/2016 11:00","127",113,"8","32","wolkig",240
"12/24/2016 12:00","103",112,"8","30","wolkig",215
"12/24/2016 13:00","62",104,"8","30","wolkig",166
"12/24/2016 14:00","77",80,"8","28","wolkig",157
"12/24/2016 15:00","43",66,"7","28","wolkig",109
"12/24/2016 16:00","65",80,"7","24","wolkig",145
"12/24/2016 17:00","35",40,"7","24","wolkig",75
"12/24/2016 18:00","12",43,"7","26","wolkig",55
"12/24/2016 19:00","22",36,"8","26","wolkig",58
"12/24/2016 20:00","18",17,"8","24","wolkig",35
"12/24/2016 21:00","15",10,"8","30","wolkig",25
"12/24/2016 22:00","15",23,"8","32","wolkig",38
"12/24/2016 23:00","27",21,"8","35","wolkig",48
"12/25/2016 0:00","19",29,"8","26","wolkig",48
"12/25/2016 1:00","17",14,"8","30","Regen",31
"12/25/2016 2:00","3",6,"8","26","Regen",9
"12/25/2016 3:00","0",7,"8","28","Regen",7
"12/25/2016 4:00","0",4,"8","28","Regen",4
"12/25/2016 5:00","10",6,"9","28","wolkig",16
"12/25/2016 6:00","9",5,"9","26","wolkig",14
"12/25/2016 7:00","6",5,"9","28","Regen",11
"12/25/2016 8:00","6",6,"8","28","Regen",12
"12/25/2016 9:00","16",5,"9","30","Regen",21
"12/25/2016 10:00","20",15,"9","32","Regen",35
"12/25/2016 11:00","23",21,"9","26","Regen",44
"12/25/2016 12:00","18",25,"9","22","Regen",43
"12/25/2016 13:00","22",21,"9","20","Regen",43
"12/25/2016 14:00","18",19,"9","24","Regen",37
"12/25/2016 15:00","21",19,"9","24","Regen",40
"12/25/2016 16:00","19",24,"10","24","Regen",43
"12/25/2016 17:00","10",13,"10","26","Regen",23
"12/25/2016 18:00","23",22,"10","24","Regen",45
"12/25/2016 19:00","15",24,"10","30","Regen",39
"12/25/2016 20:00","24",16,"11","26","Regen",40
"12/25/2016 21:00","15",23,"11","24","wolkig",38
"12/25/2016 22:00","19",13,"11","24","Regen",32
"12/25/2016 23:00","16",13,"11","26","wolkig",29
"12/26/2016 0:00","9",8,"11","24","Regen",17
"12/26/2016 1:00","12",11,"11","26","wolkig",23
"12/26/2016 2:00","2",6,"11","30","Regen",8
"12/26/2016 3:00","2",3,"11","24","Regen",5
"12/26/2016 4:00","3",6,"11","24","Regen",9
"12/26/2016 5:00","2",9,"11","26","Regen",11
"12/26/2016 6:00","6",14,"10","26","Regen",20
"12/26/2016 7:00","9",4,"10","22","Regen",13
"12/26/2016 8:00","7",7,"9","33","Regen",14
"12/26/2016 9:00","22",5,"8","24","Regen",27
"12/26/2016 10:00","19",10,"8","24","Regen",29
"12/26/2016 11:00","20",22,"8","32","wolkig",42
"12/26/2016 12:00","55",31,"8","32","teilweise bewölkt",86
"12/26/2016 13:00","35",37,"8","28","teilweise bewölkt",72
"12/26/2016 14:00","57",32,"8","35","teilweise bewölkt",89
"12/26/2016 15:00","76",59,"7","33","teilweise bewölkt",135
"12/26/2016 16:00","47",28,"6","26","teilweise bewölkt",75
"12/26/2016 17:00","38",48,"6","32","teilweise bewölkt",86
"12/26/2016 18:00","54",42,"6","26","teilweise bewölkt",96
"12/26/2016 19:00","30",36,"5","28","teilweise bewölkt",66
"12/26/2016 20:00","26",41,"5","28","teilweise bewölkt",67
"12/26/2016 21:00","40",43,"4","28","Klarer Himmel",83
"12/26/2016 22:00","19",38,"5","30","Klarer Himmel",57
"12/26/2016 23:00","27",34,"5","32","Klarer Himmel",61
"12/27/2016 0:00","13",20,"4","32","Klarer Himmel",33
"12/27/2016 1:00","4",17,"5","30","Klarer Himmel",21
"12/27/2016 2:00","5",7,"5","22","teilweise bewölkt",12
"12/27/2016 3:00","5",21,"4","20","teilweise bewölkt",26
"12/27/2016 4:00","4",6,"4","19","teilweise bewölkt",10
"12/27/2016 5:00","16",13,"4","19","wolkig",29
"12/27/2016 6:00","43",21,"4","19","teilweise bewölkt",64
"12/27/2016 7:00","68",57,"5","20","wolkig",125
"12/27/2016 8:00","93",46,"5","17","wolkig",139
"12/27/2016 9:00","114",57,"5","17","wolkig",171
"12/27/2016 10:00","126",58,"6","26","Klarer Himmel",184
"12/27/2016 11:00","124",63,"7","26","Klarer Himmel",187
"12/27/2016 12:00","167",105,"8","24","teilweise bewölkt",272
"12/27/2016 13:00","132",113,"8","22","teilweise bewölkt",245
"12/27/2016 14:00","199",131,"8","22","wolkig",330
"12/27/2016 15:00","163",140,"8","19","wolkig",303
"12/27/2016 16:00","148",175,"8","17","wolkig",323
"12/27/2016 17:00","118",161,"7","15","teilweise bewölkt",279
"12/27/2016 18:00","87",147,"6","15","teilweise bewölkt",234
"12/27/2016 19:00","97",97,"6","15","teilweise bewölkt",194
"12/27/2016 20:00","42",91,"5","11","teilweise bewölkt",133
"12/27/2016 21:00","44",50,"4","11","teilweise bewölkt",94
"12/27/2016 22:00","35",46,"6","9","wolkig",81
"12/27/2016 23:00","14",36,"6","11","wolkig",50
"12/28/2016 0:00","11",31,"5","11","wolkig",42
"12/28/2016 1:00","12",47,"5","11","wolkig",59
"12/28/2016 2:00","0",14,"3","11","wolkig",14
"12/28/2016 3:00","3",8,"2","13","teilweise bewölkt",11
"12/28/2016 4:00","3",3,"2","7","Klarer Himmel",6
"12/28/2016 5:00","15",10,"2","6","",25
"12/28/2016 6:00","45",16,"0","0","Nebel",61
"12/28/2016 7:00","81",59,"3","11","Nebel",140
"12/28/2016 8:00","136",63,"3","9","Nebel",199
"12/28/2016 9:00","167",69,"3","9","Nebel",236
"12/28/2016 10:00","151",94,"3","9","wolkig",245
"12/28/2016 11:00","185",80,"4","6","wolkig",265
"12/28/2016 12:00","157",128,"4","7","wolkig",285
"12/28/2016 13:00","150",127,"5","7","wolkig",277
"12/28/2016 14:00","149",145,"5","6","wolkig",294
"12/28/2016 15:00","142",160,"5","7","wolkig",302
"12/28/2016 16:00","163",180,"4","4","wolkig",343
"12/28/2016 17:00","124",168,"4","6","wolkig",292
"12/28/2016 18:00","135",176,"4","6","wolkig",311
"12/28/2016 19:00","125",134,"4","2","wolkig",259
"12/28/2016 20:00","91",89,"4","0","wolkig",180
"12/28/2016 21:00","64",79,"5","4","wolkig",143
"12/28/2016 22:00","46",76,"4","4","wolkig",122
"12/28/2016 23:00","32",49,"3","4","wolkig",81
"12/29/2016 0:00","23",48,"3","4","wolkig",71
"12/29/2016 1:00","15",51,"0","2","teilweise bewölkt",66
"12/29/2016 2:00","7",47,"-1","0","Nebel",54
"12/29/2016 3:00","2",30,"-2","0","Nebel",32
"12/29/2016 4:00","6",20,"-3","0","Nebel",26
"12/29/2016 5:00","11",16,"-3","0","Nebel",27
"12/29/2016 6:00","36",24,"-3","0","Nebel",60
"12/29/2016 7:00","80",62,"-3","0","Nebel",142
"12/29/2016 8:00","115",48,"-4","2","Nebel",163
"12/29/2016 9:00","159",79,"-1","6","Klarer Himmel",238
"12/29/2016 10:00","146",85,"1","4","Klarer Himmel",231
"12/29/2016 11:00","156",91,"3","7","Klarer Himmel",247
"12/29/2016 12:00","198",118,"4","4","Klarer Himmel",316
"12/29/2016 13:00","182",154,"5","7","Klarer Himmel",336
"12/29/2016 14:00","212",149,"5","9","Klarer Himmel",361
"12/29/2016 15:00","190",162,"4","7","Klarer Himmel",352
"12/29/2016 16:00","177",204,"2","4","Klarer Himmel",381
"12/29/2016 17:00","141",219,"0","4","Klarer Himmel",360
"12/29/2016 18:00","111",200,"1","7","Klarer Himmel",311
"12/29/2016 19:00","128",138,"0","6","Klarer Himmel",266
"12/29/2016 20:00","45",115,"-2","2","Klarer Himmel",160
"12/29/2016 21:00","58",54,"-3","6","Nebel",112
"12/29/2016 22:00","33",113,"-3","4","Nebel",146
"12/29/2016 23:00","24",61,"-3","0","Nebel",85
"12/30/2016 0:00","25",57,"-3","0","Nebel",82
"12/30/2016 1:00","21",32,"-4","4","Nebel",53
"12/30/2016 2:00","5",17,"-4","0","Nebel",22
"12/30/2016 3:00","9",11,"-4","4","Nebel",20
"12/30/2016 4:00","4",4,"-5","0","Nebel",8
"12/30/2016 5:00","16",11,"-5","0","Nebel",27
"12/30/2016 6:00","33",21,"-5","0","Nebel",54
"12/30/2016 7:00","70",38,"-5","0","",108
"12/30/2016 8:00","103",62,"-3","9","Nebel",165
"12/30/2016 9:00","139",64,"-2","6","Klarer Himmel",203
"12/30/2016 10:00","159",79,"1","7","Klarer Himmel",238
"12/30/2016 11:00","167",107,"2","6","Klarer Himmel",274
"12/30/2016 12:00","194",157,"4","6","Klarer Himmel",351
"12/30/2016 13:00","194",161,"5","6","Klarer Himmel",355
"12/30/2016 14:00","191",165,"4","9","Klarer Himmel",356
"12/30/2016 15:00","190",164,"4","7","Klarer Himmel",354
"12/30/2016 16:00","162",171,"0","7","Klarer Himmel",333
"12/30/2016 17:00","121",202,"0","7","Klarer Himmel",323
"12/30/2016 18:00","121",143,"-1","7","Klarer Himmel",264
"12/30/2016 19:00","112",128,"-2","7","Nebel",240
"12/30/2016 20:00","62",90,"-3","6","Nebel",152
"12/30/2016 21:00","51",64,"-3","0","Nebel",115
"12/30/2016 22:00","44",111,"-4","0","Nebel",155
"12/30/2016 23:00","26",66,"-4","6","Nebel",92
"12/31/2016 0:00","17",76,"-4","4","Nebel",93
"12/31/2016 1:00","20",40,"-6","0","Nebel",60
"12/31/2016 2:00","6",20,"-5","6","Nebel",26
"12/31/2016 3:00","6",13,"-3","6","Nebel",19
"12/31/2016 4:00","3",16,"-1","6","Nebel",19
"12/31/2016 5:00","14",16,"-1","13","Nebel",30
"12/31/2016 6:00","12",9,"-1","13","Nebel",21
"12/31/2016 7:00","17",14,"-1","9","wolkig",31
"12/31/2016 8:00","45",31,"-1","9","wolkig",76
"12/31/2016 9:00","96",37,"0","7","Nebel",133
"12/31/2016 10:00","121",78,"0","11","Nebel",199
"12/31/2016 11:00","155",103,"0","11","Nebel",258
"12/31/2016 12:00","135",138,"0","11","wolkig",273
"12/31/2016 13:00","102",134,"0","9","wolkig",236
"12/31/2016 14:00","62",120,"0","11","wolkig",182
"12/31/2016 15:00","68",61,"0","7","wolkig",129
"12/31/2016 16:00","76",62,"0","11","wolkig",138
"12/31/2016 17:00","90",82,"1","7","wolkig",172
"12/31/2016 18:00","131",125,"1","6","wolkig",256
"12/31/2016 19:00","122",153,"1","7","wolkig",275
"12/31/2016 20:00","85",91,"2","7","wolkig",176
"12/31/2016 21:00","44",45,"3","13","wolkig",89
"12/31/2016 22:00","52",50,"3","11","wolkig",102
"12/31/2016 23:00","121",30,"3","15","wolkig",151
